tau_i,T_i,sim_i,subj_id,loc_id,exec_t,SS_start_diff,SS_end_diff,manSS_tau_i,manSS_T_i
5058,114,0.31158535506904,idabd0c53c,left_wrist,1.05698180198669,54,53,5112,113
5111,114,0.378596597547642,idabd0c53c,left_hip,0.990921020507812,1,0,5112,113
5111,114,0.669482951686357,idabd0c53c,left_ankle,0.991515159606934,1,0,5112,113
5113,116,0.602075780881914,idabd0c53c,right_ankle,0.984409809112549,-1,-4,5112,113
7155,58,0.200504949461782,idabd0c53c,left_wrist,1.05698180198669,-4,49,7151,111
7152,113,0.338145700085078,idabd0c53c,left_hip,0.990921020507812,-1,-3,7151,111
7152,110,0.641678117229539,idabd0c53c,left_ankle,0.991515159606934,-1,0,7151,111
7154,109,0.635694437838353,idabd0c53c,right_ankle,0.984409809112549,-3,-1,7151,111
10929,109,0.391167253555411,idabd0c53c,left_wrist,1.05698180198669,-3,-3,10926,109
10926,109,0.416002856982449,idabd0c53c,left_hip,0.990921020507812,0,0,10926,109
10925,109,0.744664890085554,idabd0c53c,left_ankle,0.991515159606934,1,1,10926,109
10925,109,0.646510736688287,idabd0c53c,right_ankle,0.984409809112549,1,1,10926,109
17244,108,0.444808891232116,idabd0c53c,left_wrist,1.05698180198669,-3,-3,17241,108
17244,105,0.432401151457825,idabd0c53c,left_hip,0.990921020507812,-3,0,17241,108
17241,107,0.673001886315117,idabd0c53c,left_ankle,0.991515159606934,0,1,17241,108
17241,108,0.694572910659406,idabd0c53c,right_ankle,0.984409809112549,0,0,17241,108
3798,115,0.40124627873971,idabd0c53c,left_wrist,1.05698180198669,54,54,3852,115
3851,117,0.367713084506441,idabd0c53c,left_hip,0.990921020507812,1,-1,3852,115
3850,117,0.636906749215652,idabd0c53c,left_ankle,0.991515159606934,2,0,3852,115
3856,113,0.632613521123369,idabd0c53c,right_ankle,0.984409809112549,-4,-2,3852,115
17033,107,0.434617055566744,idabd0c53c,left_wrist,1.05698180198669,-4,-4,17029,107
17030,106,0.463058058808721,idabd0c53c,left_hip,0.990921020507812,-1,0,17029,107
17030,106,0.767223146592494,idabd0c53c,left_ankle,0.991515159606934,-1,0,17029,107
17029,105,0.694540211127544,idabd0c53c,right_ankle,0.984409809112549,0,2,17029,107
17881,106,0.455558607762851,idabd0c53c,left_wrist,1.05698180198669,-3,-3,17878,106
17879,105,0.468777257027009,idabd0c53c,left_hip,0.990921020507812,-1,0,17878,106
17878,106,0.659001923064751,idabd0c53c,left_ankle,0.991515159606934,0,0,17878,106
17878,108,0.673775903087177,idabd0c53c,right_ankle,0.984409809112549,0,-2,17878,106
12567,57,0.200136508038893,idabd0c53c,left_wrist,1.05698180198669,-4,49,12563,110
12564,112,0.371119600357214,idabd0c53c,left_hip,0.990921020507812,-1,-3,12563,110
12562,111,0.665052228822704,idabd0c53c,left_ankle,0.991515159606934,1,0,12563,110
12564,109,0.659040836205436,idabd0c53c,right_ankle,0.984409809112549,-1,0,12563,110
12017,57,0.209741833255664,idabd0c53c,left_wrist,1.05698180198669,-3,51,12014,111
12015,111,0.420585953982392,idabd0c53c,left_hip,0.990921020507812,-1,-1,12014,111
12013,111,0.683846884115737,idabd0c53c,left_ankle,0.991515159606934,1,1,12014,111
12014,112,0.596583299693258,idabd0c53c,right_ankle,0.984409809112549,0,-1,12014,111
1227,108,0.388060493630485,idabd0c53c,left_wrist,1.05698180198669,50,50,1277,108
1277,107,0.366769565542256,idabd0c53c,left_hip,0.990921020507812,0,1,1277,108
1277,106,0.749648423088329,idabd0c53c,left_ankle,0.991515159606934,0,2,1277,108
1275,110,0.687274851944943,idabd0c53c,right_ankle,0.984409809112549,2,0,1277,108
3912,114,0.385358401679763,idabd0c53c,left_wrist,1.05698180198669,54,53,3966,113
3967,113,0.363271660201602,idabd0c53c,left_hip,0.990921020507812,-1,-1,3966,113
3966,113,0.729497492608656,idabd0c53c,left_ankle,0.991515159606934,0,0,3966,113
3968,115,0.620881308786323,idabd0c53c,right_ankle,0.984409809112549,-2,-4,3966,113
3346,112,0.398745069220794,idabd0c53c,left_wrist,1.05698180198669,51,52,3397,113
3397,113,0.375719420186405,idabd0c53c,left_hip,0.990921020507812,0,0,3397,113
3397,112,0.699948577993053,idabd0c53c,left_ankle,0.991515159606934,0,1,3397,113
3399,115,0.629871012732164,idabd0c53c,right_ankle,0.984409809112549,-2,-4,3397,113
13060,110,0.394075533219654,idabd0c53c,left_wrist,1.05698180198669,51,52,13111,111
13111,114,0.433295834932102,idabd0c53c,left_hip,0.990921020507812,0,-3,13111,111
13110,112,0.672253317847404,idabd0c53c,left_ankle,0.991515159606934,1,0,13111,111
13111,110,0.659187049743231,idabd0c53c,right_ankle,0.984409809112549,0,1,13111,111
7321,115,0.352415442886274,idabd0c53c,left_wrist,1.05698180198669,51,51,7372,115
7372,117,0.347559831244453,idabd0c53c,left_hip,0.990921020507812,0,-2,7372,115
7371,116,0.711960930937836,idabd0c53c,left_ankle,0.991515159606934,1,0,7372,115
7375,115,0.566589357358061,idabd0c53c,right_ankle,0.984409809112549,-3,-3,7372,115
14662,106,0.451592476605027,idabd0c53c,left_wrist,1.05698180198669,48,51,14710,109
14711,113,0.395327654856056,idabd0c53c,left_hip,0.990921020507812,-1,-5,14710,109
14710,107,0.640743403108519,idabd0c53c,left_ankle,0.991515159606934,0,2,14710,109
14711,105,0.665310410087556,idabd0c53c,right_ankle,0.984409809112549,-1,3,14710,109
9471,113,0.322633012507118,idabd0c53c,left_wrist,1.05698180198669,52,51,9523,112
9524,110,0.38335494321464,idabd0c53c,left_hip,0.990921020507812,-1,1,9523,112
9524,110,0.73036698482926,idabd0c53c,left_ankle,0.991515159606934,-1,1,9523,112
9525,112,0.665342700138131,idabd0c53c,right_ankle,0.984409809112549,-2,-2,9523,112
13607,108,0.406530622417511,idabd0c53c,left_wrist,1.05698180198669,50,47,13657,105
13659,104,0.488013025025424,idabd0c53c,left_hip,0.990921020507812,-2,-1,13657,105
13657,104,0.706046169612156,idabd0c53c,left_ankle,0.991515159606934,0,1,13657,105
13656,104,0.707500017093024,idabd0c53c,right_ankle,0.984409809112549,1,2,13657,105
18838,108,0.408991065668445,idabd0c53c,left_wrist,1.05698180198669,-2,-2,18836,108
18835,108,0.414012053975533,idabd0c53c,left_hip,0.990921020507812,1,1,18836,108
18835,108,0.703742635617295,idabd0c53c,left_ankle,0.991515159606934,1,1,18836,108
18835,108,0.712137827503466,idabd0c53c,right_ankle,0.984409809112549,1,1,18836,108
7212,110,0.390223265981427,idabd0c53c,left_wrist,1.05698180198669,49,51,7261,112
7264,109,0.391228056868457,idabd0c53c,left_hip,0.990921020507812,-3,0,7261,112
7261,111,0.670925160279306,idabd0c53c,left_ankle,0.991515159606934,0,1,7261,112
7262,114,0.599601791274048,idabd0c53c,right_ankle,0.984409809112549,-1,-3,7261,112
14662,106,0.451592476605027,idabd0c53c,left_wrist,1.05698180198669,48,51,14710,109
14711,113,0.395327654856056,idabd0c53c,left_hip,0.990921020507812,-1,-5,14710,109
14710,107,0.640743403108519,idabd0c53c,left_ankle,0.991515159606934,0,2,14710,109
14711,105,0.665310410087556,idabd0c53c,right_ankle,0.984409809112549,-1,3,14710,109
18058,95,0.279041179127488,id5993bf4a,left_wrist,1.06546497344971,-3,-7,18055,91
18061,94,0.505190477783125,id5993bf4a,left_hip,1.05766606330872,-6,-9,18055,91
18053,94,0.842043964750416,id5993bf4a,left_ankle,1.0471670627594,2,-1,18055,91
18053,92,0.733480488685487,id5993bf4a,right_ankle,1.04995799064636,2,1,18055,91
4112,98,0.234454695679083,id5993bf4a,left_wrist,1.06546497344971,0,-1,4112,97
4111,98,0.362636084514177,id5993bf4a,left_hip,1.05766606330872,1,0,4112,97
4108,98,0.769796267718092,id5993bf4a,left_ankle,1.0471670627594,4,3,4112,97
4108,99,0.732078949796543,id5993bf4a,right_ankle,1.04995799064636,4,2,4112,97
12551,98,0.214711375579865,id5993bf4a,left_wrist,1.06546497344971,0,-2,12551,96
12552,100,0.485493882885549,id5993bf4a,left_hip,1.05766606330872,-1,-5,12551,96
12549,97,0.772689951055458,id5993bf4a,left_ankle,1.0471670627594,2,1,12551,96
12550,96,0.745205504012356,id5993bf4a,right_ankle,1.04995799064636,1,1,12551,96
2485,122,0.22363375230507,id5993bf4a,left_wrist,1.06546497344971,2,-26,2487,94
2486,96,0.341997750233262,id5993bf4a,left_hip,1.05766606330872,1,-1,2487,94
2484,96,0.903028531870649,id5993bf4a,left_ankle,1.0471670627594,3,1,2487,94
2483,97,0.779603486551241,id5993bf4a,right_ankle,1.04995799064636,4,1,2487,94
5172,97,0.202623454356665,id5993bf4a,left_wrist,1.06546497344971,-1,-3,5171,95
5172,97,0.338170713417439,id5993bf4a,left_hip,1.05766606330872,-1,-3,5171,95
5168,95,0.864727521355074,id5993bf4a,left_ankle,1.0471670627594,3,3,5171,95
5169,95,0.669636627892883,id5993bf4a,right_ankle,1.04995799064636,2,2,5171,95
7464,98,0.22799105524485,id5993bf4a,left_wrist,1.06546497344971,-2,-2,7462,98
7463,98,0.382453685364391,id5993bf4a,left_hip,1.05766606330872,-1,-1,7462,98
7460,99,0.899143537712983,id5993bf4a,left_ankle,1.0471670627594,2,1,7462,98
7460,98,0.769949871298075,id5993bf4a,right_ankle,1.04995799064636,2,2,7462,98
392,95,0.234406922180193,id5993bf4a,left_wrist,1.06546497344971,-5,-4,387,96
392,95,0.441470231264995,id5993bf4a,left_hip,1.05766606330872,-5,-4,387,96
385,96,0.750523664801649,id5993bf4a,left_ankle,1.0471670627594,2,2,387,96
387,95,0.687887569206595,id5993bf4a,right_ankle,1.04995799064636,0,1,387,96
7367,98,0.208500002024842,id5993bf4a,left_wrist,1.06546497344971,-1,-2,7366,97
7368,96,0.369199049247533,id5993bf4a,left_hip,1.05766606330872,-2,-1,7366,97
7363,98,0.784452756400732,id5993bf4a,left_ankle,1.0471670627594,3,2,7366,97
7364,97,0.738277266794567,id5993bf4a,right_ankle,1.04995799064636,2,2,7366,97
16740,95,0.240378647470695,id5993bf4a,left_wrist,1.06546497344971,-3,-2,16737,96
16742,96,0.512270636332783,id5993bf4a,left_hip,1.05766606330872,-5,-5,16737,96
16735,96,0.779257325168357,id5993bf4a,left_ankle,1.0471670627594,2,2,16737,96
16735,95,0.786153330784897,id5993bf4a,right_ankle,1.04995799064636,2,3,16737,96
6606,97,0.274058477078413,id5993bf4a,left_wrist,1.06546497344971,-3,-2,6603,98
6606,96,0.413461885019937,id5993bf4a,left_hip,1.05766606330872,-3,-1,6603,98
6601,98,0.902110629853293,id5993bf4a,left_ankle,1.0471670627594,2,2,6603,98
6602,98,0.755073014861223,id5993bf4a,right_ankle,1.04995799064636,1,1,6603,98
9302,95,0.250690361351497,id5993bf4a,left_wrist,1.06546497344971,-5,-11,9297,89
9303,95,0.560422097009266,id5993bf4a,left_hip,1.05766606330872,-6,-12,9297,89
9296,88,0.88742421083561,id5993bf4a,left_ankle,1.0471670627594,1,2,9297,89
9298,90,0.794477551134352,id5993bf4a,right_ankle,1.04995799064636,-1,-2,9297,89
11584,98,0.240035429179778,id5993bf4a,left_wrist,1.06546497344971,-1,3,11583,102
11588,95,0.405038660562881,id5993bf4a,left_hip,1.05766606330872,-5,2,11583,102
11581,103,0.787591991729973,id5993bf4a,left_ankle,1.0471670627594,2,1,11583,102
11580,98,0.705118379027763,id5993bf4a,right_ankle,1.04995799064636,3,7,11583,102
9483,96,0.231555215522094,id5993bf4a,left_wrist,1.06546497344971,-5,-5,9478,96
9485,94,0.488697794026217,id5993bf4a,left_hip,1.05766606330872,-7,-5,9478,96
9477,100,0.857137616704705,id5993bf4a,left_ankle,1.0471670627594,1,-3,9478,96
9478,96,0.80430141173261,id5993bf4a,right_ankle,1.04995799064636,0,0,9478,96
3626,94,0.203844025737876,id5993bf4a,left_wrist,1.06546497344971,1,4,3627,97
3632,94,0.417671558507581,id5993bf4a,left_hip,1.05766606330872,-5,-2,3627,97
3626,96,0.73224477212862,id5993bf4a,left_ankle,1.0471670627594,1,2,3627,97
3626,96,0.719037667551589,id5993bf4a,right_ankle,1.04995799064636,1,2,3627,97
15881,98,0.29483256307344,id5993bf4a,left_wrist,1.06546497344971,-2,-1,15879,99
15884,96,0.493509810564295,id5993bf4a,left_hip,1.05766606330872,-5,-2,15879,99
15878,97,0.865292999485115,id5993bf4a,left_ankle,1.0471670627594,1,3,15879,99
15878,97,0.708174650615993,id5993bf4a,right_ankle,1.04995799064636,1,3,15879,99
12935,102,0.346895560265993,id5993bf4a,left_wrist,1.06546497344971,1,-4,12936,97
12939,98,0.508185986742864,id5993bf4a,left_hip,1.05766606330872,-3,-4,12936,97
12935,97,0.84339530355854,id5993bf4a,left_ankle,1.0471670627594,1,1,12936,97
12935,97,0.803415691338822,id5993bf4a,right_ankle,1.04995799064636,1,1,12936,97
15311,97,0.254960169325074,id5993bf4a,left_wrist,1.06546497344971,-1,-1,15310,97
15313,96,0.518771741017525,id5993bf4a,left_hip,1.05766606330872,-3,-2,15310,97
15306,98,0.85989177761233,id5993bf4a,left_ankle,1.0471670627594,4,3,15310,97
15306,97,0.770080852056251,id5993bf4a,right_ankle,1.04995799064636,4,4,15310,97
2191,103,0.219217433552733,id5993bf4a,left_wrist,1.06546497344971,5,-1,2196,97
2196,99,0.370211321475153,id5993bf4a,left_hip,1.05766606330872,0,-2,2196,97
2194,98,0.895665191716698,id5993bf4a,left_ankle,1.0471670627594,2,1,2196,97
2194,98,0.769554985710262,id5993bf4a,right_ankle,1.04995799064636,2,1,2196,97
13903,97,0.241405298867759,id5993bf4a,left_wrist,1.06546497344971,-4,-3,13899,98
13904,96,0.431710419851008,id5993bf4a,left_hip,1.05766606330872,-5,-3,13899,98
13898,97,0.77670186342449,id5993bf4a,left_ankle,1.0471670627594,1,2,13899,98
13899,97,0.734828087381774,id5993bf4a,right_ankle,1.04995799064636,0,1,13899,98
8027,125,0.213526051588639,id5993bf4a,left_wrist,1.06546497344971,1,-24,8028,100
8029,98,0.302690377066966,id5993bf4a,left_hip,1.05766606330872,-1,1,8028,100
8026,100,0.796297025382665,id5993bf4a,left_ankle,1.0471670627594,2,2,8028,100
8025,100,0.735569958041458,id5993bf4a,right_ankle,1.04995799064636,3,3,8028,100
13845,100,0.189761661159871,idd80ac2b4,left_wrist,0.863416910171509,-2,-1,13843,101
13841,100,0.354278881030617,idd80ac2b4,left_hip,0.830963850021362,2,3,13843,101
13841,101,0.799532357748926,idd80ac2b4,left_ankle,0.822322130203247,2,2,13843,101
13841,100,0.693077289977775,idd80ac2b4,right_ankle,0.838189840316772,2,3,13843,101
10917,96,0.185191671198929,idd80ac2b4,left_wrist,0.863416910171509,0,3,10917,99
10913,98,0.32114981001331,idd80ac2b4,left_hip,0.830963850021362,4,5,10917,99
10915,97,0.786795561545409,idd80ac2b4,left_ankle,0.822322130203247,2,4,10917,99
10915,97,0.76347827002061,idd80ac2b4,right_ankle,0.838189840316772,2,4,10917,99
13154,101,0.207357970144398,idd80ac2b4,left_wrist,0.863416910171509,0,-1,13154,100
13149,101,0.347163511280961,idd80ac2b4,left_hip,0.830963850021362,5,4,13154,100
13152,100,0.801080892171086,idd80ac2b4,left_ankle,0.822322130203247,2,2,13154,100
13151,99,0.713845687513312,idd80ac2b4,right_ankle,0.838189840316772,3,4,13154,100
9355,103,0.176176758051912,idd80ac2b4,left_wrist,0.863416910171509,6,2,9361,99
9356,99,0.267165854790771,idd80ac2b4,left_hip,0.830963850021362,5,5,9361,99
9358,99,0.819905287656557,idd80ac2b4,left_ankle,0.822322130203247,3,3,9361,99
9358,100,0.746789226233508,idd80ac2b4,right_ankle,0.838189840316772,3,2,9361,99
8865,105,0.140454406105969,idd80ac2b4,left_wrist,0.863416910171509,3,-3,8868,99
8862,101,0.31699103598935,idd80ac2b4,left_hip,0.830963850021362,6,4,8868,99
8866,100,0.707104727395328,idd80ac2b4,left_ankle,0.822322130203247,2,1,8868,99
8864,99,0.77161816775582,idd80ac2b4,right_ankle,0.838189840316772,4,4,8868,99
13254,54,0.153356581384398,idd80ac2b4,left_wrist,0.863416910171509,-1,43,13253,98
13249,97,0.341934110359494,idd80ac2b4,left_hip,0.830963850021362,4,5,13253,98
13251,98,0.764548825192707,idd80ac2b4,left_ankle,0.822322130203247,2,2,13253,98
13249,99,0.812169940064016,idd80ac2b4,right_ankle,0.838189840316772,4,3,13253,98
563,100,0.172805676055676,idd80ac2b4,left_wrist,0.863416910171509,6,4,569,98
562,98,0.310408526822481,idd80ac2b4,left_hip,0.830963850021362,7,7,569,98
565,98,0.700941016930924,idd80ac2b4,left_ankle,0.822322130203247,4,4,569,98
565,99,0.73652820450341,idd80ac2b4,right_ankle,0.838189840316772,4,3,569,98
8077,96,0.180748641067038,idd80ac2b4,left_wrist,0.863416910171509,4,7,8081,99
8075,98,0.237933813114674,idd80ac2b4,left_hip,0.830963850021362,6,7,8081,99
8078,98,0.796231370804738,idd80ac2b4,left_ankle,0.822322130203247,3,4,8081,99
8078,98,0.750820034933313,idd80ac2b4,right_ankle,0.838189840316772,3,4,8081,99
12375,96,0.199715286443393,idd80ac2b4,left_wrist,0.863416910171509,-2,-1,12373,97
12369,97,0.35548430025979,idd80ac2b4,left_hip,0.830963850021362,4,4,12373,97
12370,98,0.834563676994549,idd80ac2b4,left_ankle,0.822322130203247,3,2,12373,97
12371,97,0.825623326381575,idd80ac2b4,right_ankle,0.838189840316772,2,2,12373,97
11691,103,0.214381589722109,idd80ac2b4,left_wrist,0.863416910171509,4,0,11695,99
11690,98,0.30126016992538,idd80ac2b4,left_hip,0.830963850021362,5,6,11695,99
11693,97,0.734421103468018,idd80ac2b4,left_ankle,0.822322130203247,2,4,11695,99
11693,101,0.690355600220203,idd80ac2b4,right_ankle,0.838189840316772,2,0,11695,99
8077,96,0.180748641067038,idd80ac2b4,left_wrist,0.863416910171509,4,7,8081,99
8075,98,0.237933813114674,idd80ac2b4,left_hip,0.830963850021362,6,7,8081,99
8078,98,0.796231370804738,idd80ac2b4,left_ankle,0.822322130203247,3,4,8081,99
8078,98,0.750820034933313,idd80ac2b4,right_ankle,0.838189840316772,3,4,8081,99
14443,98,0.223968333295225,idd80ac2b4,left_wrist,0.863416910171509,-3,-1,14440,100
14437,100,0.310675029360551,idd80ac2b4,left_hip,0.830963850021362,3,3,14440,100
14438,99,0.69261249589897,idd80ac2b4,left_ankle,0.822322130203247,2,3,14440,100
14437,100,0.732019673387859,idd80ac2b4,right_ankle,0.838189840316772,3,3,14440,100
7503,87,0.124750254823764,idd80ac2b4,left_wrist,0.863416910171509,-7,6,7496,100
7489,99,0.220315291707791,idd80ac2b4,left_hip,0.830963850021362,7,8,7496,100
7492,100,0.6741038715892,idd80ac2b4,left_ankle,0.822322130203247,4,4,7496,100
7492,100,0.670310813120927,idd80ac2b4,right_ankle,0.838189840316772,4,4,7496,100
4182,92,0.18866405593515,idd80ac2b4,left_wrist,0.863416910171509,1,9,4183,100
4177,100,0.266037270639963,idd80ac2b4,left_hip,0.830963850021362,6,6,4183,100
4179,101,0.672278995460932,idd80ac2b4,left_ankle,0.822322130203247,4,3,4183,100
4178,101,0.64091807097194,idd80ac2b4,right_ankle,0.838189840316772,5,4,4183,100
1246,103,0.175110985982483,idd80ac2b4,left_wrist,0.863416910171509,9,4,1255,98
1247,100,0.295139744357129,idd80ac2b4,left_hip,0.830963850021362,8,6,1255,98
1251,99,0.710935189096371,idd80ac2b4,left_ankle,0.822322130203247,4,3,1255,98
1250,101,0.646951128200936,idd80ac2b4,right_ankle,0.838189840316772,5,2,1255,98
1739,99,0.168368775411054,idd80ac2b4,left_wrist,0.863416910171509,5,5,1744,99
1738,99,0.258421329205398,idd80ac2b4,left_hip,0.830963850021362,6,6,1744,99
1740,99,0.802276382354406,idd80ac2b4,left_ankle,0.822322130203247,4,4,1744,99
1741,99,0.676879684105137,idd80ac2b4,right_ankle,0.838189840316772,3,3,1744,99
5561,92,0.173079473123286,idd80ac2b4,left_wrist,0.863416910171509,-2,4,5559,98
5554,98,0.295894740361663,idd80ac2b4,left_hip,0.830963850021362,5,5,5559,98
5556,97,0.743114006499688,idd80ac2b4,left_ankle,0.822322130203247,3,4,5559,98
5557,97,0.75455911824205,idd80ac2b4,right_ankle,0.838189840316772,2,3,5559,98
8673,95,0.137318282971543,idd80ac2b4,left_wrist,0.863416910171509,-4,3,8669,102
8666,100,0.330889091242133,idd80ac2b4,left_hip,0.830963850021362,3,5,8669,102
8668,100,0.789397483716415,idd80ac2b4,left_ankle,0.822322130203247,1,3,8669,102
8667,100,0.750885397524274,idd80ac2b4,right_ankle,0.838189840316772,2,4,8669,102
11107,101,0.221026499521224,idd80ac2b4,left_wrist,0.863416910171509,6,3,11113,98
11108,98,0.295046980260531,idd80ac2b4,left_hip,0.830963850021362,5,5,11113,98
11110,98,0.728717083790841,idd80ac2b4,left_ankle,0.822322130203247,3,3,11113,98
11110,98,0.733279027544792,idd80ac2b4,right_ankle,0.838189840316772,3,3,11113,98
6811,98,0.208540315086374,idd80ac2b4,left_wrist,0.863416910171509,6,6,6817,98
6811,98,0.277238494466367,idd80ac2b4,left_hip,0.830963850021362,6,6,6817,98
6813,98,0.805363581339707,idd80ac2b4,left_ankle,0.822322130203247,4,4,6817,98
6813,98,0.735393242886889,idd80ac2b4,right_ankle,0.838189840316772,4,4,6817,98
16136,102,0.341982746777309,id82b9735c,left_wrist,0.852118968963623,1,2,16137,103
16138,102,0.481005343733662,id82b9735c,left_hip,0.833356857299805,-1,0,16137,103
16137,102,0.852823057136269,id82b9735c,left_ankle,0.859354972839355,0,1,16137,103
16135,102,0.845972284406461,id82b9735c,right_ankle,0.857507944107056,2,3,16137,103
5150,111,0.314810658249709,id82b9735c,left_wrist,0.852118968963623,4,1,5154,108
5152,109,0.361581326732736,id82b9735c,left_hip,0.833356857299805,2,1,5154,108
5150,108,0.724873223915947,id82b9735c,left_ankle,0.859354972839355,4,4,5154,108
5152,108,0.760948567096117,id82b9735c,right_ankle,0.857507944107056,2,2,5154,108
8042,105,0.309559960466338,id82b9735c,left_wrist,0.852118968963623,0,1,8042,106
8040,106,0.381396180896144,id82b9735c,left_hip,0.833356857299805,2,2,8042,106
8041,104,0.71460077000124,id82b9735c,left_ankle,0.859354972839355,1,3,8042,106
8038,107,0.792426208599995,id82b9735c,right_ankle,0.857507944107056,4,3,8042,106
5831,106,0.276801177259527,id82b9735c,left_wrist,0.852118968963623,0,2,5831,108
5830,108,0.372539478263898,id82b9735c,left_hip,0.833356857299805,1,1,5831,108
5831,108,0.750515529418549,id82b9735c,left_ankle,0.859354972839355,0,0,5831,108
5829,108,0.809672492825181,id82b9735c,right_ankle,0.857507944107056,2,2,5831,108
11481,105,0.270547373985367,id82b9735c,left_wrist,0.852118968963623,1,2,11482,106
11480,106,0.400696439132587,id82b9735c,left_hip,0.833356857299805,2,2,11482,106
11481,106,0.74756416792014,id82b9735c,left_ankle,0.859354972839355,1,1,11482,106
11479,104,0.694853569601904,id82b9735c,right_ankle,0.857507944107056,3,5,11482,106
4622,109,0.282226307312408,id82b9735c,left_wrist,0.852118968963623,4,4,4626,109
4624,108,0.366733233163312,id82b9735c,left_hip,0.833356857299805,2,3,4626,109
4625,108,0.74274629592367,id82b9735c,left_ankle,0.859354972839355,1,2,4626,109
4624,107,0.795608971810508,id82b9735c,right_ankle,0.857507944107056,2,4,4626,109
8471,98,0.23161136112571,id82b9735c,left_wrist,0.852118968963623,-2,7,8469,107
8469,106,0.405741052381722,id82b9735c,left_hip,0.833356857299805,0,1,8469,107
8468,108,0.837940571602605,id82b9735c,left_ankle,0.859354972839355,1,0,8469,107
8468,103,0.809611362107983,id82b9735c,right_ankle,0.857507944107056,1,5,8469,107
13429,102,0.297863781623548,id82b9735c,left_wrist,0.852118968963623,1,-2,13430,99
13429,102,0.473525896252408,id82b9735c,left_hip,0.833356857299805,1,-2,13430,99
13429,101,0.796861785153181,id82b9735c,left_ankle,0.859354972839355,1,-1,13430,99
13426,102,0.827049947490988,id82b9735c,right_ankle,0.857507944107056,4,1,13430,99
1521,111,0.348067971525263,id82b9735c,left_wrist,0.852118968963623,2,-2,1523,107
1520,108,0.397095924992713,id82b9735c,left_hip,0.833356857299805,3,2,1523,107
1522,104,0.742768483391711,id82b9735c,left_ankle,0.859354972839355,1,4,1523,107
1519,109,0.691358543414841,id82b9735c,right_ankle,0.857507944107056,4,2,1523,107
15330,101,0.427590378701802,id82b9735c,left_wrist,0.852118968963623,2,1,15332,100
15331,100,0.477986187198683,id82b9735c,left_hip,0.833356857299805,1,1,15332,100
15331,100,0.871087363695213,id82b9735c,left_ankle,0.859354972839355,1,1,15332,100
15328,102,0.823753401018524,id82b9735c,right_ankle,0.857507944107056,4,2,15332,100
5936,105,0.297022413084296,id82b9735c,left_wrist,0.852118968963623,2,4,5938,107
5937,107,0.376379486792352,id82b9735c,left_hip,0.833356857299805,1,1,5938,107
5938,107,0.796164717630093,id82b9735c,left_ankle,0.859354972839355,0,0,5938,107
5936,107,0.750764684332647,id82b9735c,right_ankle,0.857507944107056,2,2,5938,107
14727,103,0.392973586102339,id82b9735c,left_wrist,0.852118968963623,2,0,14729,101
14729,100,0.471901866351009,id82b9735c,left_hip,0.833356857299805,0,1,14729,101
14728,103,0.847902155039595,id82b9735c,left_ankle,0.859354972839355,1,-1,14729,101
14726,103,0.81786307580149,id82b9735c,right_ankle,0.857507944107056,3,1,14729,101
6147,108,0.286933382643581,id82b9735c,left_wrist,0.852118968963623,2,1,6149,107
6148,106,0.369232581710731,id82b9735c,left_hip,0.833356857299805,1,2,6149,107
6149,107,0.775391087675023,id82b9735c,left_ankle,0.859354972839355,0,0,6149,107
6147,106,0.818199492035485,id82b9735c,right_ankle,0.857507944107056,2,3,6149,107
5936,105,0.297022413084296,id82b9735c,left_wrist,0.852118968963623,2,4,5938,107
5937,107,0.376379486792352,id82b9735c,left_hip,0.833356857299805,1,1,5938,107
5938,107,0.796164717630093,id82b9735c,left_ankle,0.859354972839355,0,0,5938,107
5936,107,0.750764684332647,id82b9735c,right_ankle,0.857507944107056,2,2,5938,107
8361,111,0.332178105863093,id82b9735c,left_wrist,0.852118968963623,2,-1,8363,108
8361,109,0.386425093710026,id82b9735c,left_hip,0.833356857299805,2,1,8363,108
8362,107,0.647242945527981,id82b9735c,left_ankle,0.859354972839355,1,2,8363,108
8360,109,0.676416935083976,id82b9735c,right_ankle,0.857507944107056,3,2,8363,108
15733,103,0.386848771598747,id82b9735c,left_wrist,0.852118968963623,0,-1,15733,102
15734,101,0.471977400633789,id82b9735c,left_hip,0.833356857299805,-1,0,15733,102
15733,102,0.779764309011635,id82b9735c,left_ankle,0.859354972839355,0,0,15733,102
15728,106,0.770451830815923,id82b9735c,right_ankle,0.857507944107056,5,1,15733,102
15131,102,0.32755554032249,id82b9735c,left_wrist,0.852118968963623,0,0,15131,102
15132,101,0.493741498360726,id82b9735c,left_hip,0.833356857299805,-1,0,15131,102
15131,101,0.766672731356339,id82b9735c,left_ankle,0.859354972839355,0,1,15131,102
15129,98,0.832643964011277,id82b9735c,right_ankle,0.857507944107056,2,6,15131,102
6875,103,0.358331607262862,id82b9735c,left_wrist,0.852118968963623,2,5,6877,106
6875,106,0.367466081875691,id82b9735c,left_hip,0.833356857299805,2,2,6877,106
6877,106,0.817029340258699,id82b9735c,left_ankle,0.859354972839355,0,0,6877,106
6873,107,0.698807813513159,id82b9735c,right_ankle,0.857507944107056,4,3,6877,106
13731,101,0.25089006100942,id82b9735c,left_wrist,0.852118968963623,-1,-1,13730,101
13732,99,0.468826369956241,id82b9735c,left_hip,0.833356857299805,-2,0,13730,101
13729,102,0.819302770993375,id82b9735c,left_ankle,0.859354972839355,1,0,13730,101
13728,97,0.854653885985566,id82b9735c,right_ankle,0.857507944107056,2,6,13730,101
16836,103,0.370247580897961,id82b9735c,left_wrist,0.852118968963623,2,1,16838,102
16837,103,0.444149627092366,id82b9735c,left_hip,0.833356857299805,1,0,16838,102
16838,103,0.845314695795737,id82b9735c,left_ankle,0.859354972839355,0,-1,16838,102
16833,108,0.835038810218168,id82b9735c,right_ankle,0.857507944107056,5,-1,16838,102
8903,109,0.147134030977497,id8af5374b,left_wrist,1.03556990623474,-3,-4,8900,108
8894,105,0.181895400710411,id8af5374b,left_hip,1.07184100151062,6,9,8900,108
8899,106,0.672715900751504,id8af5374b,left_ankle,1.05354499816895,1,3,8900,108
8898,112,0.755705679225407,id8af5374b,right_ankle,1.04769206047058,2,-2,8900,108
14485,112,0.209290916301178,id8af5374b,left_wrist,1.03556990623474,-2,-5,14483,109
14475,111,0.272538622840408,id8af5374b,left_hip,1.07184100151062,8,6,14483,109
14481,110,0.69400187841545,id8af5374b,left_ankle,1.05354499816895,2,1,14483,109
14483,109,0.648886492386991,id8af5374b,right_ankle,1.04769206047058,0,0,14483,109
8127,113,0.161335301808559,id8af5374b,left_wrist,1.03556990623474,-3,-4,8124,112
8117,111,0.205028908440902,id8af5374b,left_hip,1.07184100151062,7,8,8124,112
8122,113,0.715224552771648,id8af5374b,left_ankle,1.05354499816895,2,1,8124,112
8123,112,0.787410729347704,id8af5374b,right_ankle,1.04769206047058,1,1,8124,112
6688,114,0.169462818469029,id8af5374b,left_wrist,1.03556990623474,-2,-4,6686,112
6677,114,0.26405894357819,id8af5374b,left_hip,1.07184100151062,9,7,6686,112
6684,113,0.719712973290656,id8af5374b,left_ankle,1.05354499816895,2,1,6686,112
6682,115,0.73682124619325,id8af5374b,right_ankle,1.04769206047058,4,1,6686,112
15372,111,0.227280209369764,id8af5374b,left_wrist,1.03556990623474,-5,-4,15367,112
15360,112,0.267148256864683,id8af5374b,left_hip,1.07184100151062,7,7,15367,112
15366,112,0.685607301290095,id8af5374b,left_ankle,1.05354499816895,1,1,15367,112
15365,113,0.679641036033878,id8af5374b,right_ankle,1.04769206047058,2,1,15367,112
4171,106,0.183732687668819,id8af5374b,left_wrist,1.03556990623474,-2,2,4169,110
4161,111,0.25492825691603,id8af5374b,left_hip,1.07184100151062,8,7,4169,110
4167,109,0.622511327304439,id8af5374b,left_ankle,1.05354499816895,2,3,4169,110
4168,109,0.708005098769567,id8af5374b,right_ankle,1.04769206047058,1,2,4169,110
14485,112,0.209290916301178,id8af5374b,left_wrist,1.03556990623474,-2,-5,14483,109
14475,111,0.272538622840408,id8af5374b,left_hip,1.07184100151062,8,6,14483,109
14481,110,0.69400187841545,id8af5374b,left_ankle,1.05354499816895,2,1,14483,109
14483,109,0.648886492386991,id8af5374b,right_ankle,1.04769206047058,0,0,14483,109
2525,112,0.176916615129725,id8af5374b,left_wrist,1.03556990623474,-3,-3,2522,112
2516,112,0.250516886895837,id8af5374b,left_hip,1.07184100151062,6,6,2522,112
2521,112,0.755946208148647,id8af5374b,left_ankle,1.05354499816895,1,1,2522,112
2522,109,0.77809461236097,id8af5374b,right_ankle,1.04769206047058,0,3,2522,112
5041,109,0.135679091406875,id8af5374b,left_wrist,1.03556990623474,0,-1,5041,108
5033,109,0.252372410434811,id8af5374b,left_hip,1.07184100151062,8,7,5041,108
5038,107,0.665277757185719,id8af5374b,left_ankle,1.05354499816895,3,4,5041,108
5039,110,0.794665562376802,id8af5374b,right_ankle,1.04769206047058,2,0,5041,108
2954,125,0.144790177627589,id8af5374b,left_wrist,1.03556990623474,10,-4,2964,111
2956,113,0.244892481076477,id8af5374b,left_hip,1.07184100151062,8,6,2964,111
2962,113,0.699961091882903,id8af5374b,left_ankle,1.05354499816895,2,0,2964,111
2963,111,0.80215548657187,id8af5374b,right_ankle,1.04769206047058,1,1,2964,111
4936,106,0.188714646343345,id8af5374b,left_wrist,1.03556990623474,-3,1,4933,110
4926,108,0.231140834787376,id8af5374b,left_hip,1.07184100151062,7,9,4933,110
4932,107,0.742049424594743,id8af5374b,left_ankle,1.05354499816895,1,4,4933,110
4931,109,0.669452999221401,id8af5374b,right_ankle,1.04769206047058,2,3,4933,110
1330,109,0.171464014239673,id8af5374b,left_wrist,1.03556990623474,-3,-3,1327,109
1320,109,0.245696043952586,id8af5374b,left_hip,1.07184100151062,7,7,1327,109
1325,109,0.688191399985264,id8af5374b,left_ankle,1.05354499816895,2,2,1327,109
1326,110,0.764877370147894,id8af5374b,right_ankle,1.04769206047058,1,0,1327,109
13037,114,0.200082737656279,id8af5374b,left_wrist,1.03556990623474,-6,-6,13031,114
13025,115,0.258782434245565,id8af5374b,left_hip,1.07184100151062,6,5,13031,114
13032,114,0.700568707018368,id8af5374b,left_ankle,1.05354499816895,-1,-1,13031,114
13031,114,0.785431773690567,id8af5374b,right_ankle,1.04769206047058,0,0,13031,114
17879,110,0.198955432229187,id8af5374b,left_wrist,1.03556990623474,-4,-3,17875,111
17868,111,0.270569235244077,id8af5374b,left_hip,1.07184100151062,7,7,17875,111
17874,111,0.6863650537159,id8af5374b,left_ankle,1.05354499816895,1,1,17875,111
17875,110,0.70710070122722,id8af5374b,right_ankle,1.04769206047058,0,1,17875,111
15809,110,0.222064481009822,id8af5374b,left_wrist,1.03556990623474,-4,-3,15805,111
15797,110,0.294168868945648,id8af5374b,left_hip,1.07184100151062,8,9,15805,111
15804,109,0.746422014613531,id8af5374b,left_ankle,1.05354499816895,1,3,15805,111
15804,111,0.725791359533514,id8af5374b,right_ankle,1.04769206047058,1,1,15805,111
16137,112,0.242221665732138,id8af5374b,left_wrist,1.03556990623474,-2,-5,16135,109
16127,110,0.286442917473208,id8af5374b,left_hip,1.07184100151062,8,7,16135,109
16133,110,0.683307011569286,id8af5374b,left_ankle,1.05354499816895,2,1,16135,109
16134,110,0.745907606661897,id8af5374b,right_ankle,1.04769206047058,1,0,16135,109
9233,118,0.166426540529864,id8af5374b,left_wrist,1.03556990623474,-2,-5,9231,115
9225,115,0.2348868492577,id8af5374b,left_hip,1.07184100151062,6,6,9231,115
9230,115,0.728349282349367,id8af5374b,left_ankle,1.05354499816895,1,1,9231,115
9226,118,0.780479453471156,id8af5374b,right_ankle,1.04769206047058,5,2,9231,115
8350,109,0.140938692408967,id8af5374b,left_wrist,1.03556990623474,-5,-3,8345,111
8338,111,0.213944914869509,id8af5374b,left_hip,1.07184100151062,7,7,8345,111
8344,110,0.646105396639514,id8af5374b,left_ankle,1.05354499816895,1,2,8345,111
8344,110,0.745519388313476,id8af5374b,right_ankle,1.04769206047058,1,2,8345,111
16466,111,0.263565854114639,id8af5374b,left_wrist,1.03556990623474,-3,-4,16463,110
16455,110,0.244657261362865,id8af5374b,left_hip,1.07184100151062,8,8,16463,110
16461,111,0.684966863933091,id8af5374b,left_ankle,1.05354499816895,2,1,16463,110
16462,111,0.695621447883104,id8af5374b,right_ankle,1.04769206047058,1,0,16463,110
12258,111,0.181135521703075,id8af5374b,left_wrist,1.03556990623474,-5,-6,12253,110
12246,111,0.240839533075678,id8af5374b,left_hip,1.07184100151062,7,6,12253,110
12252,111,0.761611042491226,id8af5374b,left_ankle,1.05354499816895,1,0,12253,110
12252,111,0.788041757473757,id8af5374b,right_ankle,1.04769206047058,1,0,12253,110
14704,109,0.247359439742571,id650857ca,left_wrist,1.31037020683289,-51,-52,14653,108
14653,107,0.244499420095764,id650857ca,left_hip,1.22800397872925,0,1,14653,108
14652,108,0.597774364124122,id650857ca,left_ankle,1.47546195983887,1,1,14653,108
14653,110,0.61016769595826,id650857ca,right_ankle,1.24061584472656,0,-2,14653,108
7856,111,0.189018276113729,id650857ca,left_wrist,1.31037020683289,54,53,7910,110
7913,107,0.260607372700718,id650857ca,left_hip,1.22800397872925,-3,0,7910,110
7910,109,0.570431613365807,id650857ca,left_ankle,1.47546195983887,0,1,7910,110
7913,107,0.583590188600181,id650857ca,right_ankle,1.24061584472656,-3,0,7910,110
6088,109,0.170159170018025,id650857ca,left_wrist,1.31037020683289,50,50,6138,109
6139,108,0.213244811559072,id650857ca,left_hip,1.22800397872925,-1,0,6138,109
6137,108,0.47631674907432,id650857ca,left_ankle,1.47546195983887,1,2,6138,109
6139,108,0.558915589518282,id650857ca,right_ankle,1.24061584472656,-1,0,6138,109
22100,110,0.218892635693266,id650857ca,left_wrist,1.31037020683289,49,53,22149,114
22156,109,0.196783261335646,id650857ca,left_hip,1.22800397872925,-7,-2,22149,114
22154,115,0.488864743273773,id650857ca,left_ankle,1.47546195983887,-5,-6,22149,114
22157,115,0.44379119904095,id650857ca,right_ankle,1.24061584472656,-8,-9,22149,114
14077,100,0.273458216376062,id650857ca,left_wrist,1.31037020683289,47,56,14124,109
14125,107,0.243337652884904,id650857ca,left_hip,1.22800397872925,-1,1,14124,109
14124,109,0.544960811629786,id650857ca,left_ankle,1.47546195983887,0,0,14124,109
14125,108,0.556467347942529,id650857ca,right_ankle,1.24061584472656,-1,0,14124,109
4820,113,0.139480990491408,id650857ca,left_wrist,1.31037020683289,-2,-4,4818,111
4817,113,0.208056675212459,id650857ca,left_hip,1.22800397872925,1,-1,4818,111
4815,113,0.53545429467813,id650857ca,left_ankle,1.47546195983887,3,1,4818,111
4820,110,0.502549326973294,id650857ca,right_ankle,1.24061584472656,-2,-1,4818,111
2985,110,0.183244196349814,id650857ca,left_wrist,1.31037020683289,-6,-4,2979,112
2976,114,0.254142567626158,id650857ca,left_hip,1.22800397872925,3,1,2979,112
2980,108,0.528741623598059,id650857ca,left_ankle,1.47546195983887,-1,3,2979,112
2981,108,0.600216878838342,id650857ca,right_ankle,1.24061584472656,-2,2,2979,112
10671,116,0.257174929677903,id650857ca,left_wrist,1.31037020683289,2,-6,10673,108
10672,111,0.269391596393505,id650857ca,left_hip,1.22800397872925,1,-2,10673,108
10672,110,0.590650482155583,id650857ca,left_ankle,1.47546195983887,1,-1,10673,108
10674,111,0.608562736909266,id650857ca,right_ankle,1.24061584472656,-1,-4,10673,108
20609,103,0.322582114704413,id650857ca,left_wrist,1.31037020683289,48,51,20657,106
20660,109,0.264616013069423,id650857ca,left_hip,1.22800397872925,-3,-6,20657,106
20656,107,0.592163047847244,id650857ca,left_ankle,1.47546195983887,1,0,20657,106
20654,109,0.543847492705065,id650857ca,right_ankle,1.24061584472656,3,0,20657,106
13396,99,0.419330314667202,id650857ca,left_wrist,1.31037020683289,-8,2,13388,109
13390,107,0.255592756250345,id650857ca,left_hip,1.22800397872925,-2,0,13388,109
13387,108,0.479614144441858,id650857ca,left_ankle,1.47546195983887,1,2,13388,109
13389,107,0.574053276514823,id650857ca,right_ankle,1.24061584472656,-1,1,13388,109
21777,108,0.248489012539382,id650857ca,left_wrist,1.31037020683289,52,51,21829,107
21830,108,0.243968401150077,id650857ca,left_hip,1.22800397872925,-1,-2,21829,107
21828,108,0.55048806263547,id650857ca,left_ankle,1.47546195983887,1,0,21829,107
21828,111,0.562996447658545,id650857ca,right_ankle,1.24061584472656,1,-3,21829,107
16333,109,0.162882415459283,id650857ca,left_wrist,1.31037020683289,49,48,16382,108
16384,109,0.236198511726755,id650857ca,left_hip,1.22800397872925,-2,-3,16382,108
16382,108,0.532567939413328,id650857ca,left_ankle,1.47546195983887,0,0,16382,108
16383,107,0.542894440878805,id650857ca,right_ankle,1.24061584472656,-1,0,16382,108
7966,107,0.296934064840248,id650857ca,left_wrist,1.31037020683289,53,51,8019,105
8072,103,0.293348971926837,id650857ca,left_wrist,1.31037020683289,-53,-51,8019,105
8019,105,0.291727970945373,id650857ca,left_hip,1.22800397872925,0,0,8019,105
8018,105,0.615639116395261,id650857ca,left_ankle,1.47546195983887,1,1,8019,105
8019,102,0.650713776833151,id650857ca,right_ankle,1.24061584472656,0,3,8019,105
9723,124,0.228194778132885,id650857ca,left_wrist,1.31037020683289,-52,-65,9671,111
9671,108,0.207026222691574,id650857ca,left_hip,1.22800397872925,0,3,9671,111
9671,108,0.512106124940238,id650857ca,left_ankle,1.47546195983887,0,3,9671,111
9671,117,0.483852323620032,id650857ca,right_ankle,1.24061584472656,0,-6,9671,111
3526,112,0.205140299021557,id650857ca,left_wrist,1.31037020683289,-6,-7,3520,111
3519,109,0.218583483725919,id650857ca,left_hip,1.22800397872925,1,3,3520,111
3519,112,0.525139956403159,id650857ca,left_ankle,1.47546195983887,1,0,3520,111
3522,111,0.475621395810964,id650857ca,right_ankle,1.24061584472656,-2,-2,3520,111
259,104,0.276916797959288,id650857ca,left_wrist,1.31037020683289,47,47,306,104
307,101,0.296941876466707,id650857ca,left_hip,1.22800397872925,-1,2,306,104
306,102,0.637482202509965,id650857ca,left_ankle,1.47546195983887,0,2,306,104
302,105,0.602564862680758,id650857ca,right_ankle,1.24061584472656,4,3,306,104
15918,103,0.210545901915564,id650857ca,left_wrist,1.31037020683289,48,49,15966,104
15968,103,0.283028507610641,id650857ca,left_hip,1.22800397872925,-2,-1,15966,104
15965,104,0.611290677228552,id650857ca,left_ankle,1.47546195983887,1,1,15966,104
15963,103,0.564887185592782,id650857ca,right_ankle,1.24061584472656,3,4,15966,104
2341,107,0.222584082536053,id650857ca,left_wrist,1.31037020683289,-6,-5,2335,108
2336,107,0.241493538091251,id650857ca,left_hip,1.22800397872925,-1,0,2335,108
2335,105,0.483673622369033,id650857ca,left_ankle,1.47546195983887,0,3,2335,108
2335,107,0.58197483309554,id650857ca,right_ankle,1.24061584472656,0,1,2335,108
10016,54,0.149564223207486,id650857ca,left_wrist,1.31037020683289,1,57,10017,110
10017,111,0.273640095765838,id650857ca,left_hip,1.22800397872925,0,-1,10017,110
10017,110,0.572472931369276,id650857ca,left_ankle,1.47546195983887,0,0,10017,110
10018,111,0.59662710403966,id650857ca,right_ankle,1.24061584472656,-1,-2,10017,110
14390,61,0.139333845710869,id650857ca,left_wrist,1.31037020683289,-51,-6,14339,106
14339,107,0.28301862852167,id650857ca,left_hip,1.22800397872925,0,-1,14339,106
14339,106,0.624225372315163,id650857ca,left_ankle,1.47546195983887,0,0,14339,106
14338,104,0.643375211000482,id650857ca,right_ankle,1.24061584472656,1,3,14339,106
20217,93,0.245819180925885,idff99de96,left_wrist,1.16274285316467,4,11,20221,100
20221,100,0.343859209213298,idff99de96,left_hip,1.35942506790161,0,0,20221,100
20218,99,0.70249376428695,idff99de96,left_ankle,1.07825088500977,3,4,20221,100
20218,102,0.794155072354112,idff99de96,right_ankle,1.10447907447815,3,1,20221,100
10143,137,0.386261665046152,idff99de96,left_wrist,1.16274285316467,-8,-46,10135,99
10142,93,0.389638940030435,idff99de96,left_hip,1.35942506790161,-7,-1,10135,99
10132,99,0.799080945429292,idff99de96,left_ankle,1.07825088500977,3,3,10135,99
10130,100,0.86294404620631,idff99de96,right_ankle,1.10447907447815,5,4,10135,99
9942,100,0.384137795680738,idff99de96,left_wrist,1.16274285316467,-12,-8,9930,104
9927,104,0.286834422126762,idff99de96,left_hip,1.35942506790161,3,3,9930,104
9927,103,0.7198174769872,idff99de96,left_ankle,1.07825088500977,3,4,9930,104
9928,103,0.786794494729902,idff99de96,right_ankle,1.10447907447815,2,3,9930,104
3586,109,0.29173821977334,idff99de96,left_wrist,1.16274285316467,6,7,3592,110
3592,113,0.403310303302942,idff99de96,left_hip,1.35942506790161,0,-3,3592,110
3591,109,0.611207501144252,idff99de96,left_ankle,1.07825088500977,1,2,3592,110
3593,109,0.778977583909572,idff99de96,right_ankle,1.10447907447815,-1,0,3592,110
15429,103,0.296046745253749,idff99de96,left_wrist,1.16274285316467,1,0,15430,102
15430,103,0.27676711744593,idff99de96,left_hip,1.35942506790161,0,-1,15430,102
15428,104,0.609608561361655,idff99de96,left_ankle,1.07825088500977,2,0,15430,102
15428,102,0.706526474403202,idff99de96,right_ankle,1.10447907447815,2,2,15430,102
9308,99,0.194607041473912,idff99de96,left_wrist,1.16274285316467,5,4,9313,98
9307,102,0.325083332936735,idff99de96,left_hip,1.35942506790161,6,2,9313,98
9309,101,0.729580465341081,idff99de96,left_ankle,1.07825088500977,4,1,9313,98
9308,104,0.735111973195098,idff99de96,right_ankle,1.10447907447815,5,-1,9313,98
10408,139,0.302990564690217,idff99de96,left_wrist,1.16274285316467,25,-10,10433,104
10432,106,0.350941788781257,idff99de96,left_hip,1.35942506790161,1,-1,10433,104
10432,102,0.742848836438445,idff99de96,left_ankle,1.07825088500977,1,3,10433,104
10433,103,0.858625397219171,idff99de96,right_ankle,1.10447907447815,0,1,10433,104
4371,118,0.427624523642729,idff99de96,left_wrist,1.16274285316467,-47,-60,4324,105
4322,110,0.355151334282731,idff99de96,left_hip,1.35942506790161,2,-3,4324,105
4322,104,0.772025338258979,idff99de96,left_ankle,1.07825088500977,2,3,4324,105
4324,101,0.801765626539294,idff99de96,right_ankle,1.10447907447815,0,4,4324,105
4735,54,0.0724581869268494,idff99de96,left_wrist,1.16274285316467,1,46,4736,99
4734,101,0.368563464011946,idff99de96,left_hip,1.35942506790161,2,0,4736,99
4733,101,0.644963471548597,idff99de96,left_ankle,1.07825088500977,3,1,4736,99
4732,102,0.888890638957389,idff99de96,right_ankle,1.10447907447815,4,1,4736,99
12157,100,0.284312635651677,idff99de96,left_wrist,1.16274285316467,-10,-8,12147,102
12145,103,0.349858649411896,idff99de96,left_hip,1.35942506790161,2,1,12147,102
12145,101,0.791750543645424,idff99de96,left_ankle,1.07825088500977,2,3,12147,102
12144,103,0.86812743245077,idff99de96,right_ankle,1.10447907447815,3,2,12147,102
11756,103,0.355792944042667,idff99de96,left_wrist,1.16274285316467,-13,-14,11743,102
11743,102,0.331685416290565,idff99de96,left_hip,1.35942506790161,0,0,11743,102
11742,102,0.627389834151056,idff99de96,left_ankle,1.07825088500977,1,1,11743,102
11743,100,0.880460251176592,idff99de96,right_ankle,1.10447907447815,0,2,11743,102
1743,101,0.215003125087818,idff99de96,left_wrist,1.16274285316467,-40,-41,1703,100
1700,102,0.376413878815316,idff99de96,left_hip,1.35942506790161,3,1,1703,100
1698,101,0.742497963642866,idff99de96,left_ankle,1.07825088500977,5,4,1703,100
1698,101,0.799546308086358,idff99de96,right_ankle,1.10447907447815,5,4,1703,100
874,108,0.266388268066515,idff99de96,left_wrist,1.16274285316467,2,6,876,112
875,113,0.312988032976521,idff99de96,left_hip,1.35942506790161,1,0,876,112
870,116,0.704854778991816,idff99de96,left_ankle,1.07825088500977,6,2,876,112
880,107,0.746735997214543,idff99de96,right_ankle,1.10447907447815,-4,1,876,112
13141,105,0.323698402011207,idff99de96,left_wrist,1.16274285316467,3,1,13144,103
13142,103,0.378532381370681,idff99de96,left_hip,1.35942506790161,2,2,13144,103
13142,103,0.74909274436414,idff99de96,left_ankle,1.07825088500977,2,2,13144,103
13143,101,0.820466302262722,idff99de96,right_ankle,1.10447907447815,1,3,13144,103
18931,94,0.177681205374146,idff99de96,left_wrist,1.16274285316467,2,4,18933,96
18937,97,0.322745804579818,idff99de96,left_hip,1.35942506790161,-4,-5,18933,96
18930,99,0.716452122202887,idff99de96,left_ankle,1.07825088500977,3,0,18933,96
18931,97,0.740657191120731,idff99de96,right_ankle,1.10447907447815,2,1,18933,96
12256,102,0.296527232206611,idff99de96,left_wrist,1.16274285316467,-8,-6,12248,104
12247,101,0.334275090812022,idff99de96,left_hip,1.35942506790161,1,4,12248,104
12245,103,0.754174366052467,idff99de96,left_ankle,1.07825088500977,3,4,12248,104
12246,102,0.827508316048114,idff99de96,right_ankle,1.10447907447815,2,4,12248,104
11456,95,0.325925649226863,idff99de96,left_wrist,1.16274285316467,-11,-5,11445,101
11445,99,0.390313889539367,idff99de96,left_hip,1.35942506790161,0,2,11445,101
11444,99,0.65789311055289,idff99de96,left_ankle,1.07825088500977,1,3,11445,101
11442,99,0.914398792972305,idff99de96,right_ankle,1.10447907447815,3,5,11445,101
10758,97,0.418872041279579,idff99de96,left_wrist,1.16274285316467,-19,-8,10739,108
10740,105,0.344527643677374,idff99de96,left_hip,1.35942506790161,-1,2,10739,108
10740,104,0.776589628506456,idff99de96,left_ankle,1.07825088500977,-1,3,10739,108
10743,101,0.843462880497045,idff99de96,right_ankle,1.10447907447815,-4,3,10739,108
20018,103,0.328692111138006,idff99de96,left_wrist,1.16274285316467,2,1,20020,102
20021,101,0.364715829750648,idff99de96,left_hip,1.35942506790161,-1,0,20020,102
20018,102,0.742412497912018,idff99de96,left_ankle,1.07825088500977,2,2,20020,102
20017,103,0.931571469722049,idff99de96,right_ankle,1.10447907447815,3,2,20020,102
10322,86,0.251389258460945,idff99de96,left_wrist,1.16274285316467,10,26,10332,102
10328,105,0.382966914787206,idff99de96,left_hip,1.35942506790161,4,1,10332,102
10327,106,0.711549554615582,idff99de96,left_ankle,1.07825088500977,5,1,10332,102
10329,105,0.887040739523726,idff99de96,right_ankle,1.10447907447815,3,0,10332,102
12547,93,0.180488393618197,id4ea159a8,left_wrist,0.991466999053955,-1,0,12546,94
12545,96,0.35900047367272,id4ea159a8,left_hip,1.03305602073669,1,-1,12546,94
12544,96,0.84601573205221,id4ea159a8,left_ankle,1.01072096824646,2,0,12546,94
12544,96,0.769200788234222,id4ea159a8,right_ankle,1.0507960319519,2,0,12546,94
11019,96,0.207540268779394,id4ea159a8,left_wrist,0.991466999053955,-4,-1,11015,99
11016,98,0.340312883686248,id4ea159a8,left_hip,1.03305602073669,-1,0,11015,99
11015,98,0.784609847221659,id4ea159a8,left_ankle,1.01072096824646,0,1,11015,99
11014,97,0.743903801495109,id4ea159a8,right_ankle,1.0507960319519,1,3,11015,99
4380,92,0.203445360014303,id4ea159a8,left_wrist,0.991466999053955,0,4,4380,96
4381,95,0.439304381471274,id4ea159a8,left_hip,1.03305602073669,-1,0,4380,96
4379,96,0.923035231814172,id4ea159a8,left_ankle,1.01072096824646,1,1,4380,96
4377,96,0.789869559629783,id4ea159a8,right_ankle,1.0507960319519,3,3,4380,96
4758,97,0.179455670799866,id4ea159a8,left_wrist,0.991466999053955,0,0,4758,97
4759,97,0.424765054670682,id4ea159a8,left_hip,1.03305602073669,-1,-1,4758,97
4756,98,0.875155011408317,id4ea159a8,left_ankle,1.01072096824646,2,1,4758,97
4756,96,0.733759013484091,id4ea159a8,right_ankle,1.0507960319519,2,3,4758,97
13398,91,0.20405818496081,id4ea159a8,left_wrist,0.991466999053955,-4,0,13394,95
13396,94,0.385464451052382,id4ea159a8,left_hip,1.03305602073669,-2,-1,13394,95
13393,97,0.794647797156192,id4ea159a8,left_ankle,1.01072096824646,1,-1,13394,95
13393,95,0.720775520820309,id4ea159a8,right_ankle,1.0507960319519,1,1,13394,95
8356,95,0.280550903392843,id4ea159a8,left_wrist,0.991466999053955,1,1,8357,95
8357,95,0.380444518300081,id4ea159a8,left_hip,1.03305602073669,0,0,8357,95
8356,96,0.790818995543205,id4ea159a8,left_ankle,1.01072096824646,1,0,8357,95
8353,96,0.640559531065394,id4ea159a8,right_ankle,1.0507960319519,4,3,8357,95
3242,97,0.189618336955821,id4ea159a8,left_wrist,0.991466999053955,2,-3,3244,92
3243,95,0.37921394680106,id4ea159a8,left_hip,1.03305602073669,1,-2,3244,92
3243,93,0.874661409494728,id4ea159a8,left_ankle,1.01072096824646,1,0,3244,92
3242,94,0.820734654622877,id4ea159a8,right_ankle,1.0507960319519,2,0,3244,92
13684,175,0.202757799811634,id4ea159a8,left_wrist,0.991466999053955,-7,-88,13677,94
13679,93,0.377734245506014,id4ea159a8,left_hip,1.03305602073669,-2,-1,13677,94
13676,94,0.802590844265511,id4ea159a8,left_ankle,1.01072096824646,1,1,13677,94
13676,95,0.795713355354729,id4ea159a8,right_ankle,1.0507960319519,1,0,13677,94
2002,104,0.239661609316481,id4ea159a8,left_wrist,0.991466999053955,7,-2,2009,95
2007,97,0.396540002214152,id4ea159a8,left_hip,1.03305602073669,2,0,2009,95
2007,95,0.820422157626296,id4ea159a8,left_ankle,1.01072096824646,2,2,2009,95
2007,95,0.801359222315692,id4ea159a8,right_ankle,1.0507960319519,2,2,2009,95
15873,92,0.114956890442578,id4ea159a8,left_wrist,0.991466999053955,-3,1,15870,96
15871,96,0.402713206758466,id4ea159a8,left_hip,1.03305602073669,-1,-1,15870,96
15869,96,0.84877788508173,id4ea159a8,left_ankle,1.01072096824646,1,1,15870,96
15869,97,0.799044855126109,id4ea159a8,right_ankle,1.0507960319519,1,0,15870,96
11304,98,0.20464739979816,id4ea159a8,left_wrist,0.991466999053955,2,-1,11306,95
11303,97,0.331732438986878,id4ea159a8,left_hip,1.03305602073669,3,1,11306,95
11304,96,0.804012437455797,id4ea159a8,left_ankle,1.01072096824646,2,1,11306,95
11303,96,0.733172697468764,id4ea159a8,right_ankle,1.0507960319519,3,2,11306,95
10349,97,0.184755986589599,id4ea159a8,left_wrist,0.991466999053955,-3,-3,10346,97
10346,97,0.364009103930797,id4ea159a8,left_hip,1.03305602073669,0,0,10346,97
10345,97,0.793425734770295,id4ea159a8,left_ankle,1.01072096824646,1,1,10346,97
10345,96,0.799763802845803,id4ea159a8,right_ankle,1.0507960319519,1,2,10346,97
6091,95,0.200763324186105,id4ea159a8,left_wrist,0.991466999053955,2,1,6093,94
6093,94,0.381139965820517,id4ea159a8,left_hip,1.03305602073669,0,0,6093,94
6091,95,0.882757714629314,id4ea159a8,left_ankle,1.01072096824646,2,1,6093,94
6091,95,0.827596866007732,id4ea159a8,right_ankle,1.0507960319519,2,1,6093,94
8450,97,0.237315822226189,id4ea159a8,left_wrist,0.991466999053955,1,0,8451,96
8451,96,0.346692961406949,id4ea159a8,left_hip,1.03305602073669,0,0,8451,96
8451,95,0.717402250803135,id4ea159a8,left_ankle,1.01072096824646,0,1,8451,96
8448,97,0.724668195445209,id4ea159a8,right_ankle,1.0507960319519,3,2,8451,96
9213,96,0.179554032965786,id4ea159a8,left_wrist,0.991466999053955,-1,1,9212,98
9215,95,0.332754185714015,id4ea159a8,left_hip,1.03305602073669,-3,0,9212,98
9212,97,0.762346723884086,id4ea159a8,left_ankle,1.01072096824646,0,1,9212,98
9211,97,0.7547959080258,id4ea159a8,right_ankle,1.0507960319519,1,2,9212,98
3338,92,0.218942293513671,id4ea159a8,left_wrist,0.991466999053955,-3,1,3335,96
3337,93,0.390310748943676,id4ea159a8,left_hip,1.03305602073669,-2,1,3335,96
3335,95,0.833576841370385,id4ea159a8,left_ankle,1.01072096824646,0,1,3335,96
3335,94,0.795467941875011,id4ea159a8,right_ankle,1.0507960319519,0,2,3335,96
9688,100,0.184747048325157,id4ea159a8,left_wrist,0.991466999053955,-1,-5,9687,96
9688,96,0.382842512431155,id4ea159a8,left_hip,1.03305602073669,-1,-1,9687,96
9687,95,0.786952009169479,id4ea159a8,left_ankle,1.01072096824646,0,1,9687,96
9687,94,0.786608868699011,id4ea159a8,right_ankle,1.0507960319519,0,2,9687,96
1443,97,0.187482565077736,id4ea159a8,left_wrist,0.991466999053955,0,-1,1443,96
1443,96,0.397652241465945,id4ea159a8,left_hip,1.03305602073669,0,0,1443,96
1442,96,0.864126584469974,id4ea159a8,left_ankle,1.01072096824646,1,1,1443,96
1442,95,0.798527222024322,id4ea159a8,right_ankle,1.0507960319519,1,2,1443,96
5234,94,0.194239855419731,id4ea159a8,left_wrist,0.991466999053955,-1,0,5233,95
5233,95,0.409743360292959,id4ea159a8,left_hip,1.03305602073669,0,0,5233,95
5232,95,0.800839764030499,id4ea159a8,left_ankle,1.01072096824646,1,1,5233,95
5230,96,0.884217731261521,id4ea159a8,right_ankle,1.0507960319519,3,2,5233,95
4001,95,0.187136733513771,id4ea159a8,left_wrist,0.991466999053955,-2,-1,3999,96
4000,95,0.346998510369218,id4ea159a8,left_hip,1.03305602073669,-1,0,3999,96
3997,97,0.798885910117899,id4ea159a8,left_ankle,1.01072096824646,2,1,3999,96
3997,96,0.842554953785408,id4ea159a8,right_ankle,1.0507960319519,2,2,3999,96
6022,116,0.262981022483725,idc91a49d0,left_wrist,1.07398891448975,1,0,6023,115
6024,113,0.265989537278674,idc91a49d0,left_hip,1.08154296875,-1,1,6023,115
6022,114,0.559697657347585,idc91a49d0,left_ankle,1.11053204536438,1,2,6023,115
6018,115,0.59955293081678,idc91a49d0,right_ankle,1.11793398857117,5,5,6023,115
18683,110,0.208838704143667,idc91a49d0,left_wrist,1.07398891448975,-3,-4,18680,109
18680,110,0.315229286338295,idc91a49d0,left_hip,1.08154296875,0,-1,18680,109
18681,109,0.617733871948152,idc91a49d0,left_ankle,1.11053204536438,-1,-1,18680,109
18681,108,0.729423001748011,idc91a49d0,right_ankle,1.11793398857117,-1,0,18680,109
9342,115,0.201140764213275,idc91a49d0,left_wrist,1.07398891448975,2,5,9344,118
9345,117,0.240361657741549,idc91a49d0,left_hip,1.08154296875,-1,0,9344,118
9342,117,0.536884447135968,idc91a49d0,left_ankle,1.11053204536438,2,3,9344,118
9342,114,0.614229643371724,idc91a49d0,right_ankle,1.11793398857117,2,6,9344,118
16279,108,0.223320095782573,idc91a49d0,left_wrist,1.07398891448975,-5,-2,16274,111
16274,111,0.304583106039853,idc91a49d0,left_hip,1.08154296875,0,0,16274,111
16273,112,0.736133003386941,idc91a49d0,left_ankle,1.11053204536438,1,0,16274,111
16275,108,0.739330038688616,idc91a49d0,right_ankle,1.11793398857117,-1,2,16274,111
18465,110,0.243687639177049,idc91a49d0,left_wrist,1.07398891448975,-4,-3,18461,111
18462,110,0.299967711860934,idc91a49d0,left_hip,1.08154296875,-1,0,18461,111
18462,110,0.692108262014007,idc91a49d0,left_ankle,1.11053204536438,-1,0,18461,111
18462,109,0.661776312535263,idc91a49d0,right_ankle,1.11793398857117,-1,1,18461,111
8681,110,0.265889687104933,idc91a49d0,left_wrist,1.07398891448975,-2,-1,8679,111
8679,111,0.275459862257485,idc91a49d0,left_hip,1.08154296875,0,0,8679,111
8677,112,0.68222402088934,idc91a49d0,left_ankle,1.11053204536438,2,1,8679,111
8677,111,0.656402299958846,idc91a49d0,right_ankle,1.11793398857117,2,2,8679,111
1379,109,0.203216069263775,idc91a49d0,left_wrist,1.07398891448975,0,5,1379,114
1379,113,0.275045094948496,idc91a49d0,left_hip,1.08154296875,0,1,1379,114
1377,113,0.634312175906495,idc91a49d0,left_ankle,1.11053204536438,2,3,1379,114
1377,112,0.690205499729568,idc91a49d0,right_ankle,1.11793398857117,2,4,1379,114
7037,112,0.173647020381198,idc91a49d0,left_wrist,1.07398891448975,-1,-2,7036,111
7036,111,0.285370052390237,idc91a49d0,left_hip,1.08154296875,0,0,7036,111
7034,112,0.649421185442978,idc91a49d0,left_ankle,1.11053204536438,2,1,7036,111
7035,111,0.669262812776339,idc91a49d0,right_ankle,1.11793398857117,1,1,7036,111
15088,110,0.236961175390409,idc91a49d0,left_wrist,1.07398891448975,-4,-3,15084,111
15086,109,0.309821353235653,idc91a49d0,left_hip,1.08154296875,-2,0,15084,111
15085,110,0.649148893609718,idc91a49d0,left_ankle,1.11053204536438,-1,0,15084,111
15084,110,0.668594280472465,idc91a49d0,right_ankle,1.11793398857117,0,1,15084,111
7037,112,0.173647020381198,idc91a49d0,left_wrist,1.07398891448975,-1,-2,7036,111
7036,111,0.285370052390237,idc91a49d0,left_hip,1.08154296875,0,0,7036,111
7034,112,0.649421185442978,idc91a49d0,left_ankle,1.11053204536438,2,1,7036,111
7035,111,0.669262812776339,idc91a49d0,right_ankle,1.11793398857117,1,1,7036,111
13218,111,0.250982527698612,idc91a49d0,left_wrist,1.07398891448975,-3,-3,13215,111
13216,110,0.293319174931105,idc91a49d0,left_hip,1.08154296875,-1,0,13215,111
13215,109,0.640823873306128,idc91a49d0,left_ankle,1.11053204536438,0,2,13215,111
13214,111,0.662619440760374,idc91a49d0,right_ankle,1.11793398857117,1,1,13215,111
17592,111,0.215841865634664,idc91a49d0,left_wrist,1.07398891448975,-2,-5,17590,108
17590,109,0.3080349292055,idc91a49d0,left_hip,1.08154296875,0,-1,17590,108
17590,110,0.633723550894666,idc91a49d0,left_ankle,1.11053204536438,0,-2,17590,108
17590,110,0.721265135847126,idc91a49d0,right_ankle,1.11793398857117,0,-2,17590,108
17919,111,0.250389021011187,idc91a49d0,left_wrist,1.07398891448975,-2,-3,17917,110
17917,110,0.324429128185077,idc91a49d0,left_hip,1.08154296875,0,0,17917,110
17916,110,0.732932027129476,idc91a49d0,left_ankle,1.11053204536438,1,1,17917,110
17916,112,0.732771732444842,idc91a49d0,right_ankle,1.11793398857117,1,-1,17917,110
8241,111,0.25241759018775,idc91a49d0,left_wrist,1.07398891448975,-1,-2,8240,110
8240,110,0.305212527675282,idc91a49d0,left_hip,1.08154296875,0,0,8240,110
8239,110,0.671034933595402,idc91a49d0,left_ankle,1.11053204536438,1,1,8240,110
8238,111,0.747415295642249,idc91a49d0,right_ankle,1.11793398857117,2,1,8240,110
8022,111,0.217671381144003,idc91a49d0,left_wrist,1.07398891448975,-2,-2,8020,111
8020,111,0.288374267818747,idc91a49d0,left_hip,1.08154296875,0,0,8020,111
8017,113,0.652009656592243,idc91a49d0,left_ankle,1.11053204536438,3,1,8020,111
8018,111,0.65008139830642,idc91a49d0,right_ankle,1.11793398857117,2,2,8020,111
18683,110,0.208838704143667,idc91a49d0,left_wrist,1.07398891448975,-3,-4,18680,109
18680,110,0.315229286338295,idc91a49d0,left_hip,1.08154296875,0,-1,18680,109
18681,109,0.617733871948152,idc91a49d0,left_ankle,1.11053204536438,-1,-1,18680,109
18681,108,0.729423001748011,idc91a49d0,right_ankle,1.11793398857117,-1,0,18680,109
13437,112,0.234294097439687,idc91a49d0,left_wrist,1.07398891448975,-1,-3,13436,110
13436,111,0.292134647514442,idc91a49d0,left_hip,1.08154296875,0,-1,13436,110
13436,110,0.646046616900552,idc91a49d0,left_ankle,1.11053204536438,0,0,13436,110
13434,111,0.710668905280127,idc91a49d0,right_ankle,1.11793398857117,2,1,13436,110
15524,107,0.221866523126796,idc91a49d0,left_wrist,1.07398891448975,-5,-4,15519,108
15519,109,0.320905039566355,idc91a49d0,left_hip,1.08154296875,0,-1,15519,108
15519,109,0.692210486408487,idc91a49d0,left_ankle,1.11053204536438,0,-1,15519,108
15518,110,0.737168346464344,idc91a49d0,right_ankle,1.11793398857117,1,-1,15519,108
12668,111,0.220786877870377,idc91a49d0,left_wrist,1.07398891448975,-2,-1,12666,112
12667,111,0.264867679967729,idc91a49d0,left_hip,1.08154296875,-1,0,12666,112
12663,115,0.641141131975422,idc91a49d0,left_ankle,1.11053204536438,3,0,12666,112
12664,113,0.712896694490439,idc91a49d0,right_ankle,1.11793398857117,2,1,12666,112
18900,110,0.249082236381938,idc91a49d0,left_wrist,1.07398891448975,-4,-4,18896,110
18897,110,0.309180056328544,idc91a49d0,left_hip,1.08154296875,-1,-1,18896,110
18896,111,0.673093793840429,idc91a49d0,left_ankle,1.11053204536438,0,-1,18896,110
18897,110,0.701920576573176,idc91a49d0,right_ankle,1.11793398857117,-1,-1,18896,110
6992,104,0.244627645317374,id1c7e64ad,left_wrist,1.66272592544556,-1,-1,6991,104
6990,104,0.273894200117219,id1c7e64ad,left_hip,1.45523190498352,1,1,6991,104
6989,104,0.637381102679657,id1c7e64ad,left_ankle,1.43537092208862,2,2,6991,104
6987,106,0.620475187114509,id1c7e64ad,right_ankle,1.45198488235474,4,2,6991,104
4632,106,0.237720134445272,id1c7e64ad,left_wrist,1.66272592544556,-2,-2,4630,106
4630,105,0.257672250988643,id1c7e64ad,left_hip,1.45523190498352,0,1,4630,106
4629,106,0.625848284327123,id1c7e64ad,left_ankle,1.43537092208862,1,1,4630,106
4630,106,0.672589436066653,id1c7e64ad,right_ankle,1.45198488235474,0,0,4630,106
21124,105,0.273392243395752,id1c7e64ad,left_wrist,1.66272592544556,-1,-5,21123,101
21126,101,0.300644508644807,id1c7e64ad,left_hip,1.45523190498352,-3,-3,21123,101
21124,101,0.694083211154237,id1c7e64ad,left_ankle,1.43537092208862,-1,-1,21123,101
21123,101,0.711331046939163,id1c7e64ad,right_ankle,1.45198488235474,0,0,21123,101
12085,101,0.270103198193485,id1c7e64ad,left_wrist,1.66272592544556,-1,-2,12084,100
12086,98,0.281753334684514,id1c7e64ad,left_hip,1.45523190498352,-2,0,12084,100
12084,101,0.698620993590598,id1c7e64ad,left_ankle,1.43537092208862,0,-1,12084,100
12082,102,0.692545893429548,id1c7e64ad,right_ankle,1.45198488235474,2,0,12084,100
20927,99,0.291455065735596,id1c7e64ad,left_wrist,1.66272592544556,-3,-2,20924,100
20927,100,0.293806666556692,id1c7e64ad,left_hip,1.45523190498352,-3,-3,20924,100
20923,101,0.706352792501736,id1c7e64ad,left_ankle,1.43537092208862,1,0,20924,100
20921,102,0.710588173113269,id1c7e64ad,right_ankle,1.45198488235474,3,1,20924,100
4632,106,0.237720134445272,id1c7e64ad,left_wrist,1.66272592544556,-2,-2,4630,106
4630,105,0.257672250988643,id1c7e64ad,left_hip,1.45523190498352,0,1,4630,106
4629,106,0.625848284327123,id1c7e64ad,left_ankle,1.43537092208862,1,1,4630,106
4630,106,0.672589436066653,id1c7e64ad,right_ankle,1.45198488235474,0,0,4630,106
18049,102,0.236226787063678,id1c7e64ad,left_wrist,1.66272592544556,-2,-2,18047,102
18051,100,0.283844115105165,id1c7e64ad,left_hip,1.45523190498352,-4,-2,18047,102
18048,101,0.68378961439202,id1c7e64ad,left_ankle,1.43537092208862,-1,0,18047,102
18047,103,0.660881336447435,id1c7e64ad,right_ankle,1.45198488235474,0,-1,18047,102
17345,100,0.272982406208906,id1c7e64ad,left_wrist,1.66272592544556,-3,-3,17342,100
17345,101,0.306103891954887,id1c7e64ad,left_hip,1.45523190498352,-3,-4,17342,100
17342,100,0.666533882199145,id1c7e64ad,left_ankle,1.43537092208862,0,0,17342,100
17341,99,0.702298650725703,id1c7e64ad,right_ankle,1.45198488235474,1,2,17342,100
22531,100,0.24873981032777,id1c7e64ad,left_wrist,1.66272592544556,-3,-3,22528,100
22531,100,0.293744787948618,id1c7e64ad,left_hip,1.45523190498352,-3,-3,22528,100
22528,99,0.747399013022109,id1c7e64ad,left_ankle,1.43537092208862,0,1,22528,100
22528,97,0.714667982686301,id1c7e64ad,right_ankle,1.45198488235474,0,3,22528,100
13085,99,0.222411035475209,id1c7e64ad,left_wrist,1.66272592544556,-2,0,13083,101
13084,101,0.280869835514889,id1c7e64ad,left_hip,1.45523190498352,-1,-1,13083,101
13082,102,0.725118114585961,id1c7e64ad,left_ankle,1.43537092208862,1,0,13083,101
13082,101,0.614369898894162,id1c7e64ad,right_ankle,1.45198488235474,1,1,13083,101
17046,103,0.298474133851177,id1c7e64ad,left_wrist,1.66272592544556,-3,-5,17043,101
17046,101,0.289725992406312,id1c7e64ad,left_hip,1.45523190498352,-3,-3,17043,101
17044,101,0.635650903945138,id1c7e64ad,left_ankle,1.43537092208862,-1,-1,17043,101
17043,100,0.702065982776246,id1c7e64ad,right_ankle,1.45198488235474,0,1,17043,101
9350,104,0.256755820122972,id1c7e64ad,left_wrist,1.66272592544556,0,-3,9350,101
9348,103,0.274524544357516,id1c7e64ad,left_hip,1.45523190498352,2,0,9350,101
9348,103,0.691843308417554,id1c7e64ad,left_ankle,1.43537092208862,2,0,9350,101
9348,102,0.678424779757625,id1c7e64ad,right_ankle,1.45198488235474,2,1,9350,101
2546,107,0.249248626821729,id1c7e64ad,left_wrist,1.66272592544556,-2,-3,2544,106
2544,107,0.263790742868828,id1c7e64ad,left_hip,1.45523190498352,0,-1,2544,106
2544,105,0.575508809793306,id1c7e64ad,left_ankle,1.43537092208862,0,1,2544,106
2542,107,0.676696372340406,id1c7e64ad,right_ankle,1.45198488235474,2,1,2544,106
22130,101,0.239554014923963,id1c7e64ad,left_wrist,1.66272592544556,-3,-3,22127,101
22130,100,0.292333536504083,id1c7e64ad,left_hip,1.45523190498352,-3,-2,22127,101
22128,101,0.624669311525505,id1c7e64ad,left_ankle,1.43537092208862,-1,-1,22127,101
22126,102,0.67469137762547,id1c7e64ad,right_ankle,1.45198488235474,1,0,22127,101
6786,103,0.229992543733933,id1c7e64ad,left_wrist,1.66272592544556,-2,0,6784,105
6783,105,0.274258492386292,id1c7e64ad,left_hip,1.45523190498352,1,1,6784,105
6783,104,0.630958343401092,id1c7e64ad,left_ankle,1.43537092208862,1,2,6784,105
6781,106,0.74079231429914,id1c7e64ad,right_ankle,1.45198488235474,3,2,6784,105
14098,104,0.223806343131749,id1c7e64ad,left_wrist,1.66272592544556,-1,-2,14097,103
14097,104,0.249054217697375,id1c7e64ad,left_hip,1.45523190498352,0,-1,14097,103
14097,102,0.707983168119437,id1c7e64ad,left_ankle,1.43537092208862,0,1,14097,103
14096,103,0.659596059922299,id1c7e64ad,right_ankle,1.45198488235474,1,1,14097,103
2755,105,0.23519465827894,id1c7e64ad,left_wrist,1.66272592544556,-1,-3,2754,103
2753,105,0.242523338751969,id1c7e64ad,left_hip,1.45523190498352,1,-1,2754,103
2753,104,0.603036874759863,id1c7e64ad,left_ankle,1.43537092208862,1,0,2754,103
2752,106,0.630792868765547,id1c7e64ad,right_ankle,1.45198488235474,2,-1,2754,103
20112,57,0.161890121699294,id1c7e64ad,left_wrist,1.66272592544556,-2,45,20110,104
20111,105,0.287219578840038,id1c7e64ad,left_hip,1.45523190498352,-1,-2,20110,104
20110,103,0.621924677362245,id1c7e64ad,left_ankle,1.43537092208862,0,1,20110,104
20111,102,0.641996286776951,id1c7e64ad,right_ankle,1.45198488235474,-1,1,20110,104
7617,101,0.235051032742387,id1c7e64ad,left_wrist,1.66272592544556,-4,-2,7613,103
7613,102,0.258484300068658,id1c7e64ad,left_hip,1.45523190498352,0,1,7613,103
7614,103,0.686746235870276,id1c7e64ad,left_ankle,1.43537092208862,-1,-1,7613,103
7614,102,0.686888788945927,id1c7e64ad,right_ankle,1.45198488235474,-1,0,7613,103
18670,104,0.283512849412558,id1c7e64ad,left_wrist,1.66272592544556,-1,-2,18669,103
18671,103,0.254223159220303,id1c7e64ad,left_hip,1.45523190498352,-2,-2,18669,103
18668,105,0.674770953349377,id1c7e64ad,left_ankle,1.43537092208862,1,-1,18669,103
18669,104,0.593256587762904,id1c7e64ad,right_ankle,1.45198488235474,0,-1,18669,103
5115,95,0.175193168463763,id8e66893c,left_wrist,1.22859120368958,13,14,5128,96
5127,96,0.390261978872258,id8e66893c,left_hip,1.00575304031372,1,1,5128,96
5128,96,0.532876300237529,id8e66893c,left_ankle,0.995562076568604,0,0,5128,96
5125,99,0.659020396206943,id8e66893c,right_ankle,0.994385957717896,3,0,5128,96
4251,97,0.150482431608365,id8e66893c,left_wrist,1.22859120368958,12,13,4263,98
4263,97,0.371719339399806,id8e66893c,left_hip,1.00575304031372,0,1,4263,98
4264,97,0.640457106149863,id8e66893c,left_ankle,0.995562076568604,-1,0,4263,98
4263,97,0.614531448848311,id8e66893c,right_ankle,0.994385957717896,0,1,4263,98
5021,95,0.180563959274531,id8e66893c,left_wrist,1.22859120368958,12,13,5033,96
5032,96,0.397627369887569,id8e66893c,left_hip,1.00575304031372,1,1,5033,96
5033,96,0.616786204557814,id8e66893c,left_ankle,0.995562076568604,0,0,5033,96
5031,95,0.56511074963015,id8e66893c,right_ankle,0.994385957717896,2,3,5033,96
7070,97,0.184997671662459,id8e66893c,left_wrist,1.22859120368958,-7,-7,7063,97
7068,97,0.354627752525505,id8e66893c,left_hip,1.00575304031372,-5,-5,7063,97
7069,96,0.533977893743402,id8e66893c,left_ankle,0.995562076568604,-6,-5,7063,97
7066,99,0.594232938226365,id8e66893c,right_ankle,0.994385957717896,-3,-5,7063,97
10886,95,0.304822644772168,id8e66893c,left_wrist,1.22859120368958,-5,-3,10881,97
10887,99,0.263445518083853,id8e66893c,left_hip,1.00575304031372,-6,-8,10881,97
10887,96,0.510790806494444,id8e66893c,left_ankle,0.995562076568604,-6,-5,10881,97
10884,102,0.474666663821749,id8e66893c,right_ankle,0.994385957717896,-3,-8,10881,97
17187,100,0.358756459030095,id8e66893c,left_wrist,1.22859120368958,-5,-7,17182,98
17188,98,0.3518935174586,id8e66893c,left_hip,1.00575304031372,-6,-6,17182,98
17187,99,0.605503086454045,id8e66893c,left_ankle,0.995562076568604,-5,-6,17182,98
17187,99,0.678770948494812,id8e66893c,right_ankle,0.994385957717896,-5,-6,17182,98
4069,100,0.190290369176762,id8e66893c,left_wrist,1.22859120368958,-5,-6,4064,99
4068,98,0.336747274340429,id8e66893c,left_hip,1.00575304031372,-4,-3,4064,99
4070,98,0.576193370782367,id8e66893c,left_ankle,0.995562076568604,-6,-5,4064,99
4070,99,0.554202842558667,id8e66893c,right_ankle,0.994385957717896,-6,-6,4064,99
17091,97,0.259236820339448,id8e66893c,left_wrist,1.22859120368958,-4,-5,17087,96
17090,99,0.361810415151314,id8e66893c,left_hip,1.00575304031372,-3,-6,17087,96
17090,98,0.588039818286887,id8e66893c,left_ankle,0.995562076568604,-3,-5,17087,96
17090,98,0.656595939222878,id8e66893c,right_ankle,0.994385957717896,-3,-5,17087,96
17869,99,0.285508205801833,id8e66893c,left_wrist,1.22859120368958,-6,-7,17863,98
17869,98,0.402255976859044,id8e66893c,left_hip,1.00575304031372,-6,-6,17863,98
17869,98,0.665191293299137,id8e66893c,left_ankle,0.995562076568604,-6,-6,17863,98
17869,98,0.637328499603933,id8e66893c,right_ankle,0.994385957717896,-6,-6,17863,98
12541,97,0.152937607285783,id8e66893c,left_wrist,1.22859120368958,-7,-6,12534,98
12539,98,0.339875987634412,id8e66893c,left_hip,1.00575304031372,-5,-5,12534,98
12540,97,0.626836628036225,id8e66893c,left_ankle,0.995562076568604,-6,-5,12534,98
12539,99,0.647029632551662,id8e66893c,right_ankle,0.994385957717896,-5,-6,12534,98
11949,95,0.174101280398056,id8e66893c,left_wrist,1.22859120368958,2,5,11951,98
11956,98,0.343169950712401,id8e66893c,left_hip,1.00575304031372,-5,-5,11951,98
11957,97,0.57888738742826,id8e66893c,left_ankle,0.995562076568604,-6,-5,11951,98
11956,98,0.626589132471819,id8e66893c,right_ankle,0.994385957717896,-5,-5,11951,98
1257,66,0.130365963611455,id8e66893c,left_wrist,1.22859120368958,-6,25,1251,97
1255,97,0.36333370213786,id8e66893c,left_hip,1.00575304031372,-4,-4,1251,97
1256,96,0.596542507933848,id8e66893c,left_ankle,0.995562076568604,-5,-4,1251,97
1255,96,0.634551088743739,id8e66893c,right_ankle,0.994385957717896,-4,-3,1251,97
4069,100,0.190290369176762,id8e66893c,left_wrist,1.22859120368958,-5,-6,4064,99
4068,98,0.336747274340429,id8e66893c,left_hip,1.00575304031372,-4,-3,4064,99
4070,98,0.576193370782367,id8e66893c,left_ankle,0.995562076568604,-6,-5,4064,99
4070,99,0.554202842558667,id8e66893c,right_ankle,0.994385957717896,-6,-6,4064,99
3392,98,0.191297496283553,id8e66893c,left_wrist,1.22859120368958,-1,-3,3391,96
3390,99,0.310162927882061,id8e66893c,left_hip,1.00575304031372,1,-2,3391,96
3391,99,0.526213011901474,id8e66893c,left_ankle,0.995562076568604,0,-3,3391,96
3391,99,0.606295309031887,id8e66893c,right_ankle,0.994385957717896,0,-3,3391,96
13023,88,0.158376152695505,id8e66893c,left_wrist,1.22859120368958,-6,4,13017,98
13022,96,0.358659140275717,id8e66893c,left_hip,1.00575304031372,-5,-3,13017,98
13022,96,0.629071411253646,id8e66893c,left_ankle,0.995562076568604,-5,-3,13017,98
13020,96,0.564712703594154,id8e66893c,right_ankle,0.994385957717896,-3,-1,13017,98
7263,99,0.201778192784116,id8e66893c,left_wrist,1.22859120368958,-6,-7,7257,98
7261,99,0.335933720476769,id8e66893c,left_hip,1.00575304031372,-4,-5,7257,98
7263,98,0.584510999670985,id8e66893c,left_ankle,0.995562076568604,-6,-6,7257,98
7262,98,0.577652337607502,id8e66893c,right_ankle,0.994385957717896,-5,-5,7257,98
14659,98,0.301277968287173,id8e66893c,left_wrist,1.22859120368958,-3,-6,14656,95
14660,97,0.40948534488265,id8e66893c,left_hip,1.00575304031372,-4,-6,14656,95
14659,98,0.642836578454874,id8e66893c,left_ankle,0.995562076568604,-3,-6,14656,95
14657,100,0.639743304146628,id8e66893c,right_ankle,0.994385957717896,-1,-6,14656,95
9420,100,0.327927535813821,id8e66893c,left_wrist,1.22859120368958,-7,-6,9413,101
9419,100,0.294521028134982,id8e66893c,left_hip,1.00575304031372,-6,-5,9413,101
9420,98,0.55735232746321,id8e66893c,left_ankle,0.995562076568604,-7,-4,9413,101
9420,101,0.515371539336796,id8e66893c,right_ankle,0.994385957717896,-7,-7,9413,101
13600,99,0.243137385032733,id8e66893c,left_wrist,1.22859120368958,-5,-3,13595,101
13601,98,0.360579175149887,id8e66893c,left_hip,1.00575304031372,-6,-3,13595,101
13601,98,0.611770463841006,id8e66893c,left_ankle,0.995562076568604,-6,-3,13595,101
13600,98,0.628068760015933,id8e66893c,right_ankle,0.994385957717896,-5,-2,13595,101
18743,88,0.211945954127235,id8e66893c,left_wrist,1.22859120368958,-1,5,18742,94
18742,99,0.351319016854069,id8e66893c,left_hip,1.00575304031372,0,-5,18742,94
18743,98,0.591203031343726,id8e66893c,left_ankle,0.995562076568604,-1,-5,18742,94
18742,97,0.621821013711703,id8e66893c,right_ankle,0.994385957717896,0,-3,18742,94
7263,99,0.201778192784116,id8e66893c,left_wrist,1.22859120368958,-6,-7,7257,98
7261,99,0.335933720476769,id8e66893c,left_hip,1.00575304031372,-4,-5,7257,98
7263,98,0.584510999670985,id8e66893c,left_ankle,0.995562076568604,-6,-6,7257,98
7262,98,0.577652337607502,id8e66893c,right_ankle,0.994385957717896,-5,-5,7257,98
14659,98,0.301277968287173,id8e66893c,left_wrist,1.22859120368958,-3,-6,14656,95
14660,97,0.40948534488265,id8e66893c,left_hip,1.00575304031372,-4,-6,14656,95
14659,98,0.642836578454874,id8e66893c,left_ankle,0.995562076568604,-3,-6,14656,95
14657,100,0.639743304146628,id8e66893c,right_ankle,0.994385957717896,-1,-6,14656,95
20853,94,0.287054003040094,id34e056c8,left_wrist,1.3908360004425,-2,-3,20851,93
20858,93,0.350375461157787,id34e056c8,left_hip,1.43991208076477,-7,-7,20851,93
20850,95,0.747841694233468,id34e056c8,left_ankle,1.61925292015076,1,-1,20851,93
20852,93,0.669886030880823,id34e056c8,right_ankle,1.40685200691223,-1,-1,20851,93
4747,94,0.295411444504968,id34e056c8,left_wrist,1.3908360004425,3,3,4750,94
4750,95,0.357087914779407,id34e056c8,left_hip,1.43991208076477,0,-1,4750,94
4748,94,0.780002381412143,id34e056c8,left_ankle,1.61925292015076,2,2,4750,94
4749,93,0.697160451192571,id34e056c8,right_ankle,1.40685200691223,1,2,4750,94
14531,88,0.22501776382018,id34e056c8,left_wrist,1.3908360004425,1,3,14532,90
14534,91,0.36527273065644,id34e056c8,left_hip,1.43991208076477,-2,-3,14532,90
14530,91,0.779869933146941,id34e056c8,left_ankle,1.61925292015076,2,1,14532,90
14529,92,0.745983889428475,id34e056c8,right_ankle,1.40685200691223,3,1,14532,90
2809,91,0.320982825199454,id34e056c8,left_wrist,1.3908360004425,1,3,2810,93
2812,92,0.359534130732736,id34e056c8,left_hip,1.43991208076477,-2,-1,2810,93
2809,91,0.69890187164873,id34e056c8,left_ankle,1.61925292015076,1,3,2810,93
2808,94,0.77540072887184,id34e056c8,right_ankle,1.40685200691223,2,1,2810,93
6041,93,0.258122244301651,id34e056c8,left_wrist,1.3908360004425,0,0,6041,93
6038,99,0.328809813568957,id34e056c8,left_hip,1.43991208076477,3,-3,6041,93
6039,93,0.809162239695876,id34e056c8,left_ankle,1.61925292015076,2,2,6041,93
6040,94,0.671076739262023,id34e056c8,right_ankle,1.40685200691223,1,0,6041,93
8612,89,0.167874732996034,id34e056c8,left_wrist,1.3908360004425,-8,1,8604,98
8603,98,0.238232711008487,id34e056c8,left_hip,1.43991208076477,1,1,8604,98
8604,95,0.68618423329748,id34e056c8,left_ankle,1.61925292015076,0,3,8604,98
8605,96,0.597366100056258,id34e056c8,right_ankle,1.40685200691223,-1,1,8604,98
371,89,0.213904093971626,id34e056c8,left_wrist,1.3908360004425,2,2,373,89
376,88,0.339954600924629,id34e056c8,left_hip,1.43991208076477,-3,-2,373,89
370,91,0.850616067061343,id34e056c8,left_ankle,1.61925292015076,3,1,373,89
370,90,0.734633830064079,id34e056c8,right_ankle,1.40685200691223,3,2,373,89
8513,96,0.250057472008715,id34e056c8,left_wrist,1.3908360004425,0,-4,8513,92
8517,87,0.20687780140537,id34e056c8,left_hip,1.43991208076477,-4,1,8513,92
8513,92,0.778278273771842,id34e056c8,left_ankle,1.61925292015076,0,0,8513,92
8513,93,0.587580041865682,id34e056c8,right_ankle,1.40685200691223,0,-1,8513,92
19344,93,0.23145714522061,id34e056c8,left_wrist,1.3908360004425,-7,1,19337,101
19348,88,0.271446319608251,id34e056c8,left_hip,1.43991208076477,-11,2,19337,101
19340,97,0.792428433762075,id34e056c8,left_ankle,1.61925292015076,-3,1,19337,101
19342,98,0.652339626778727,id34e056c8,right_ankle,1.40685200691223,-5,-2,19337,101
7596,93,0.283965336440528,id34e056c8,left_wrist,1.3908360004425,3,3,7599,93
7600,93,0.308234833204615,id34e056c8,left_hip,1.43991208076477,-1,-1,7599,93
7597,93,0.845191731616485,id34e056c8,left_ankle,1.61925292015076,2,2,7599,93
7598,93,0.731792225454117,id34e056c8,right_ankle,1.40685200691223,1,1,7599,93
10799,96,0.213200766399663,id34e056c8,left_wrist,1.3908360004425,3,-1,10802,92
10804,92,0.346956876546921,id34e056c8,left_hip,1.43991208076477,-2,-2,10802,92
10801,91,0.72226161430376,id34e056c8,left_ankle,1.61925292015076,1,2,10802,92
10800,92,0.747782533668361,id34e056c8,right_ankle,1.40685200691223,2,2,10802,92
13352,90,0.293014057173648,id34e056c8,left_wrist,1.3908360004425,1,3,13353,92
13357,90,0.359328066308765,id34e056c8,left_hip,1.43991208076477,-4,-2,13353,92
13352,92,0.800781247098918,id34e056c8,left_ankle,1.61925292015076,1,1,13353,92
13352,92,0.763468547702141,id34e056c8,right_ankle,1.40685200691223,1,1,13353,92
10984,94,0.266626681460274,id34e056c8,left_wrist,1.3908360004425,-1,-5,10983,90
10987,93,0.369287248909838,id34e056c8,left_hip,1.43991208076477,-4,-7,10983,90
10982,90,0.765548907427419,id34e056c8,left_ankle,1.61925292015076,1,1,10983,90
10982,91,0.762595277443828,id34e056c8,right_ankle,1.40685200691223,1,0,10983,90
4189,95,0.310715851096889,id34e056c8,left_wrist,1.3908360004425,5,3,4194,93
4193,92,0.363314114931731,id34e056c8,left_hip,1.43991208076477,1,2,4194,93
4191,93,0.819723770859005,id34e056c8,left_ankle,1.61925292015076,3,3,4194,93
4192,93,0.688277932549884,id34e056c8,right_ankle,1.40685200691223,2,2,4194,93
18397,95,0.312020918047951,id34e056c8,left_wrist,1.3908360004425,-2,-2,18395,95
18401,95,0.362871345143174,id34e056c8,left_hip,1.43991208076477,-6,-6,18395,95
18394,95,0.731241829233881,id34e056c8,left_ankle,1.61925292015076,1,1,18395,95
18396,95,0.678265666860183,id34e056c8,right_ankle,1.40685200691223,-1,-1,18395,95
14892,94,0.262358056673429,id34e056c8,left_wrist,1.3908360004425,3,2,14895,93
14900,90,0.303031940940922,id34e056c8,left_hip,1.43991208076477,-5,-2,14895,93
14894,92,0.839508918951642,id34e056c8,left_ankle,1.61925292015076,1,2,14895,93
14894,91,0.662681055760196,id34e056c8,right_ankle,1.40685200691223,1,3,14895,93
17736,93,0.289908153107286,id34e056c8,left_wrist,1.3908360004425,0,2,17736,95
17742,95,0.398733571725052,id34e056c8,left_hip,1.43991208076477,-6,-6,17736,95
17734,95,0.786278329073471,id34e056c8,left_ankle,1.61925292015076,2,2,17736,95
17736,95,0.687691430039864,id34e056c8,right_ankle,1.40685200691223,0,0,17736,95
2441,92,0.229992454464913,id34e056c8,left_wrist,1.3908360004425,1,3,2442,94
2442,93,0.332972721272322,id34e056c8,left_hip,1.43991208076477,0,1,2442,94
2441,92,0.668487168682892,id34e056c8,left_ankle,1.61925292015076,1,3,2442,94
2441,94,0.701154340334151,id34e056c8,right_ankle,1.40685200691223,1,1,2442,94
16173,92,0.236545672035428,id34e056c8,left_wrist,1.3908360004425,0,0,16173,92
16177,93,0.341880766048561,id34e056c8,left_hip,1.43991208076477,-4,-5,16173,92
16172,93,0.825037837311996,id34e056c8,left_ankle,1.61925292015076,1,0,16173,92
16173,93,0.68865459404294,id34e056c8,right_ankle,1.40685200691223,0,-1,16173,92
9162,97,0.203362827969088,id34e056c8,left_wrist,1.3908360004425,3,1,9165,95
9164,97,0.302898534209656,id34e056c8,left_hip,1.43991208076477,1,-1,9165,95
9164,93,0.77548659211179,id34e056c8,left_ankle,1.61925292015076,1,3,9165,95
9164,94,0.692253128235771,id34e056c8,right_ankle,1.40685200691223,1,2,9165,95
14330,107,0.341541594774739,idc735fc09,left_wrist,0.907870054244995,0,-3,14330,104
14331,105,0.337508487217045,idc735fc09,left_hip,0.82825493812561,-1,-2,14330,104
14330,105,0.678750972319651,idc735fc09,left_ankle,0.84850287437439,0,-1,14330,104
14330,103,0.728529298929406,idc735fc09,right_ankle,0.842411041259766,0,1,14330,104
11333,109,0.157171679592069,idc735fc09,left_wrist,0.907870054244995,1,-3,11334,105
11333,105,0.343101841762708,idc735fc09,left_hip,0.82825493812561,1,1,11334,105
11332,105,0.709414772089148,idc735fc09,left_ankle,0.84850287437439,2,2,11334,105
11331,105,0.903649133248495,idc735fc09,right_ankle,0.842411041259766,3,3,11334,105
13810,105,0.316724803734796,idc735fc09,left_wrist,0.907870054244995,-2,-2,13808,105
13810,105,0.379005011525526,idc735fc09,left_hip,0.82825493812561,-2,-2,13808,105
13809,105,0.63136718554249,idc735fc09,left_ankle,0.84850287437439,-1,-1,13808,105
13808,105,0.780043090854662,idc735fc09,right_ankle,0.842411041259766,0,0,13808,105
9678,105,0.286071479539842,idc735fc09,left_wrist,0.907870054244995,2,1,9680,104
9680,103,0.381070266405028,idc735fc09,left_hip,0.82825493812561,0,1,9680,104
9679,103,0.708365485330908,idc735fc09,left_ankle,0.84850287437439,1,2,9680,104
9678,102,0.907916387487551,idc735fc09,right_ankle,0.842411041259766,2,4,9680,104
9269,103,0.314930513626154,idc735fc09,left_wrist,0.907870054244995,-2,-2,9267,103
9268,104,0.395791270172048,idc735fc09,left_hip,0.82825493812561,-1,-2,9267,103
9266,104,0.666685151847358,idc735fc09,left_ankle,0.84850287437439,1,0,9267,103
9266,104,0.839092220485399,idc735fc09,right_ankle,0.842411041259766,1,0,9267,103
13709,102,0.287710310355167,idc735fc09,left_wrist,0.907870054244995,-2,-2,13707,102
13708,103,0.373359673304863,idc735fc09,left_hip,0.82825493812561,-1,-2,13707,102
13705,105,0.687108078301661,idc735fc09,left_ankle,0.84850287437439,2,-1,13707,102
13706,103,0.876839286187502,idc735fc09,right_ankle,0.842411041259766,1,0,13707,102
576,106,0.281665199800974,idc735fc09,left_wrist,0.907870054244995,0,0,576,106
575,107,0.307070957311422,idc735fc09,left_hip,0.82825493812561,1,0,576,106
574,108,0.721975858767223,idc735fc09,left_ankle,0.84850287437439,2,0,576,106
575,105,0.710617790609518,idc735fc09,right_ankle,0.842411041259766,1,2,576,106
8335,104,0.283983424844032,idc735fc09,left_wrist,0.907870054244995,-1,-1,8334,104
8335,104,0.359716106305929,idc735fc09,left_hip,0.82825493812561,-1,-1,8334,104
8333,105,0.679207643999312,idc735fc09,left_ankle,0.84850287437439,1,0,8334,104
8330,109,0.900874504998897,idc735fc09,right_ankle,0.842411041259766,4,-1,8334,104
12783,105,0.299332129751554,idc735fc09,left_wrist,0.907870054244995,-2,0,12781,107
12783,106,0.35178564483252,idc735fc09,left_hip,0.82825493812561,-2,-1,12781,107
12782,105,0.630603787036781,idc735fc09,left_ankle,0.84850287437439,-1,1,12781,107
12783,105,0.774613246218441,idc735fc09,right_ankle,0.842411041259766,-2,0,12781,107
12157,104,0.181154959096339,idc735fc09,left_wrist,0.907870054244995,2,2,12159,104
12159,104,0.325772019513673,idc735fc09,left_hip,0.82825493812561,0,0,12159,104
12158,105,0.657271545774326,idc735fc09,left_ankle,0.84850287437439,1,0,12159,104
12158,104,0.939201996970651,idc735fc09,right_ankle,0.842411041259766,1,1,12159,104
8335,104,0.283983424844032,idc735fc09,left_wrist,0.907870054244995,-1,-1,8334,104
8335,104,0.359716106305929,idc735fc09,left_hip,0.82825493812561,-1,-1,8334,104
8333,105,0.679207643999312,idc735fc09,left_ankle,0.84850287437439,1,0,8334,104
8330,109,0.900874504998897,idc735fc09,right_ankle,0.842411041259766,4,-1,8334,104
14957,106,0.410521266066358,idc735fc09,left_wrist,0.907870054244995,-1,-2,14956,105
14957,104,0.387058884856475,idc735fc09,left_hip,0.82825493812561,-1,0,14956,105
14955,105,0.623506092634411,idc735fc09,left_ankle,0.84850287437439,1,1,14956,105
14955,105,0.789370563320349,idc735fc09,right_ankle,0.842411041259766,1,1,14956,105
7598,105,0.260764915624149,idc735fc09,left_wrist,0.907870054244995,2,2,7600,105
7600,105,0.325779593841561,idc735fc09,left_hip,0.82825493812561,0,0,7600,105
7598,107,0.755676316901941,idc735fc09,left_ankle,0.84850287437439,2,0,7600,105
7599,103,0.925221753413809,idc735fc09,right_ankle,0.842411041259766,1,3,7600,105
4273,106,0.222578406605236,idc735fc09,left_wrist,0.907870054244995,3,2,4276,105
4276,105,0.297851554324863,idc735fc09,left_hip,0.82825493812561,0,0,4276,105
4274,106,0.738636375353815,idc735fc09,left_ankle,0.84850287437439,2,1,4276,105
4273,106,0.877673188961224,idc735fc09,right_ankle,0.842411041259766,3,2,4276,105
1311,108,0.27656114217099,idc735fc09,left_wrist,0.907870054244995,2,1,1313,107
1312,108,0.290025717534355,idc735fc09,left_hip,0.82825493812561,1,0,1313,107
1312,107,0.659856826328158,idc735fc09,left_ankle,0.84850287437439,1,1,1313,107
1311,107,0.784270187194937,idc735fc09,right_ankle,0.842411041259766,2,2,1313,107
1735,108,0.230562004064206,idc735fc09,left_wrist,0.907870054244995,4,4,1739,108
1738,108,0.289744228572084,idc735fc09,left_hip,0.82825493812561,1,1,1739,108
1735,108,0.716339593861792,idc735fc09,left_ankle,0.84850287437439,4,4,1739,108
1737,107,0.800017142993236,idc735fc09,right_ankle,0.842411041259766,2,3,1739,108
5532,106,0.239556673920034,idc735fc09,left_wrist,0.907870054244995,2,2,5534,106
5534,106,0.283047022163199,idc735fc09,left_hip,0.82825493812561,0,0,5534,106
5531,107,0.712901379352768,idc735fc09,left_ankle,0.84850287437439,3,2,5534,106
5532,105,0.767363233505257,idc735fc09,right_ankle,0.842411041259766,2,3,5534,106
9061,105,0.297319358969021,idc735fc09,left_wrist,0.907870054244995,2,-1,9063,102
9062,105,0.374394017705458,idc735fc09,left_hip,0.82825493812561,1,-2,9063,102
9060,105,0.636709124884352,idc735fc09,left_ankle,0.84850287437439,3,0,9063,102
9061,103,0.844294916642085,idc735fc09,right_ankle,0.842411041259766,2,1,9063,102
11540,100,0.190305528406278,idc735fc09,left_wrist,0.907870054244995,1,-2,11541,97
11540,104,0.35497616939341,idc735fc09,left_hip,0.82825493812561,1,-6,11541,97
11539,101,0.725217889925872,idc735fc09,left_ankle,0.84850287437439,2,-2,11541,97
11538,101,0.702882025022434,idc735fc09,right_ankle,0.842411041259766,3,-1,11541,97
7079,104,0.268563716621085,idc735fc09,left_wrist,0.907870054244995,2,3,7081,105
7081,105,0.320647866228283,idc735fc09,left_hip,0.82825493812561,0,0,7081,105
7080,105,0.767779348275298,idc735fc09,left_ankle,0.84850287437439,1,1,7081,105
7078,106,0.835783333690093,idc735fc09,right_ankle,0.842411041259766,3,2,7081,105
18595,105,0.330168416376871,id86237981,left_wrist,1.37950491905212,-3,-2,18592,106
18596,105,0.355263252927055,id86237981,left_hip,1.21322298049927,-4,-3,18592,106
18592,106,0.792762251134504,id86237981,left_ankle,1.16198801994324,0,0,18592,106
18593,104,0.751336679642614,id86237981,right_ankle,1.12553691864014,-1,1,18592,106
6002,104,0.297383748606789,id86237981,left_wrist,1.37950491905212,-1,0,6001,105
6001,105,0.345309426009366,id86237981,left_hip,1.21322298049927,0,0,6001,105
5999,106,0.767970006667979,id86237981,left_ankle,1.16198801994324,2,1,6001,105
5999,105,0.725499599205761,id86237981,right_ankle,1.12553691864014,2,2,6001,105
9334,106,0.290732245705141,id86237981,left_wrist,1.37950491905212,0,0,9334,106
9335,107,0.353018312161775,id86237981,left_hip,1.21322298049927,-1,-2,9334,106
9334,106,0.77747033655401,id86237981,left_ankle,1.16198801994324,0,0,9334,106
9332,107,0.836927894088146,id86237981,right_ankle,1.12553691864014,2,1,9334,106
6840,105,0.302122323550078,id86237981,left_wrist,1.37950491905212,0,-1,6840,104
6842,105,0.353111386296637,id86237981,left_hip,1.21322298049927,-2,-3,6840,104
6840,104,0.71803874552553,id86237981,left_ankle,1.16198801994324,0,0,6840,104
6837,108,0.810893422349851,id86237981,right_ankle,1.12553691864014,3,-1,6840,104
13270,105,0.287323512293683,id86237981,left_wrist,1.37950491905212,0,-1,13270,104
13274,104,0.352908062367833,id86237981,left_hip,1.21322298049927,-4,-4,13270,104
13270,102,0.688683056673528,id86237981,left_ankle,1.16198801994324,0,2,13270,104
13270,103,0.773146566484086,id86237981,right_ankle,1.12553691864014,0,1,13270,104
5275,105,0.293330667275767,id86237981,left_wrist,1.37950491905212,-3,-2,5272,106
5274,104,0.363831856788436,id86237981,left_hip,1.21322298049927,-2,0,5272,106
5272,104,0.693141305986469,id86237981,left_ankle,1.16198801994324,0,2,5272,106
5270,106,0.881502089002804,id86237981,right_ankle,1.12553691864014,2,2,5272,106
9750,105,0.296274336747432,id86237981,left_wrist,1.37950491905212,0,-2,9750,103
9754,103,0.36854341769898,id86237981,left_hip,1.21322298049927,-4,-4,9750,103
9750,103,0.719718431769536,id86237981,left_ankle,1.16198801994324,0,0,9750,103
9749,103,0.855286378122621,id86237981,right_ankle,1.12553691864014,1,1,9750,103
15565,105,0.321927262369778,id86237981,left_wrist,1.37950491905212,-5,-5,15560,105
15564,105,0.376481224570083,id86237981,left_hip,1.21322298049927,-4,-4,15560,105
15561,105,0.733089649973391,id86237981,left_ankle,1.16198801994324,-1,-1,15560,105
15560,103,0.796629395023226,id86237981,right_ankle,1.12553691864014,0,2,15560,105
1728,105,0.280404643415357,id86237981,left_wrist,1.37950491905212,-2,-1,1726,106
1725,105,0.331970388023004,id86237981,left_hip,1.21322298049927,1,2,1726,106
1723,108,0.780925258791906,id86237981,left_ankle,1.16198801994324,3,1,1726,106
1724,108,0.838300703017422,id86237981,right_ankle,1.12553691864014,2,0,1726,106
17760,102,0.328003794392528,id86237981,left_wrist,1.37950491905212,-5,-2,17755,105
17759,105,0.378552030761341,id86237981,left_hip,1.21322298049927,-4,-4,17755,105
17755,105,0.778251621587358,id86237981,left_ankle,1.16198801994324,0,0,17755,105
17756,104,0.786407422324217,id86237981,right_ankle,1.12553691864014,-1,0,17755,105
6944,107,0.324051699472461,id86237981,left_wrist,1.37950491905212,-1,-2,6943,106
6946,105,0.374355402045563,id86237981,left_hip,1.21322298049927,-3,-2,6943,106
6943,106,0.774995926995576,id86237981,left_ankle,1.16198801994324,0,0,6943,106
6944,104,0.74271590346357,id86237981,right_ankle,1.12553691864014,-1,1,6943,106
17126,105,0.319002578774013,id86237981,left_wrist,1.37950491905212,-2,-1,17124,106
17127,105,0.381085944546121,id86237981,left_hip,1.21322298049927,-3,-2,17124,106
17124,106,0.738957168229155,id86237981,left_ankle,1.16198801994324,0,0,17124,106
17123,106,0.763619487011137,id86237981,right_ankle,1.12553691864014,1,1,17124,106
7050,105,0.328556381510506,id86237981,left_wrist,1.37950491905212,-2,-2,7048,105
7050,106,0.359122127356279,id86237981,left_hip,1.21322298049927,-2,-3,7048,105
7048,105,0.73672575833117,id86237981,left_ankle,1.16198801994324,0,0,7048,105
7047,106,0.823999848255525,id86237981,right_ankle,1.12553691864014,1,0,7048,105
6840,105,0.302122323550078,id86237981,left_wrist,1.37950491905212,0,-1,6840,104
6842,105,0.353111386296637,id86237981,left_hip,1.21322298049927,-2,-3,6840,104
6840,104,0.71803874552553,id86237981,left_ankle,1.16198801994324,0,0,6840,104
6837,108,0.810893422349851,id86237981,right_ankle,1.12553691864014,3,-1,6840,104
9750,105,0.296274336747432,id86237981,left_wrist,1.37950491905212,0,-2,9750,103
9754,103,0.36854341769898,id86237981,left_hip,1.21322298049927,-4,-4,9750,103
9750,103,0.719718431769536,id86237981,left_ankle,1.16198801994324,0,0,9750,103
9749,103,0.855286378122621,id86237981,right_ankle,1.12553691864014,1,1,9750,103
18177,105,0.269988398879355,id86237981,left_wrist,1.37950491905212,-2,-2,18175,105
18176,107,0.396266405168196,id86237981,left_hip,1.21322298049927,-1,-3,18175,105
18175,106,0.752253388594287,id86237981,left_ankle,1.16198801994324,0,-1,18175,105
18173,105,0.815081778933018,id86237981,right_ankle,1.12553691864014,2,2,18175,105
17550,108,0.308497584130514,id86237981,left_wrist,1.37950491905212,-4,-5,17546,107
17547,108,0.378059403008448,id86237981,left_hip,1.21322298049927,-1,-2,17546,107
17546,107,0.746421884692596,id86237981,left_ankle,1.16198801994324,0,0,17546,107
17546,106,0.822558448337686,id86237981,right_ankle,1.12553691864014,0,1,17546,107
7980,105,0.255343920742161,id86237981,left_wrist,1.37950491905212,-1,-2,7979,104
7982,103,0.347684010002294,id86237981,left_hip,1.21322298049927,-3,-2,7979,104
7979,105,0.819077209148003,id86237981,left_ankle,1.16198801994324,0,-1,7979,104
7978,105,0.839454103500598,id86237981,right_ankle,1.12553691864014,1,0,7979,104
15876,105,0.281753019132006,id86237981,left_wrist,1.37950491905212,-3,-2,15873,106
15877,105,0.35865814338834,id86237981,left_hip,1.21322298049927,-4,-3,15873,106
15874,105,0.70630591353523,id86237981,left_ankle,1.16198801994324,-1,0,15873,106
15874,104,0.810413037219347,id86237981,right_ankle,1.12553691864014,-1,1,15873,106
19539,106,0.349208630813942,id86237981,left_wrist,1.37950491905212,-3,-2,19536,107
19538,106,0.412002291877708,id86237981,left_hip,1.21322298049927,-2,-1,19536,107
19536,108,0.777120604326939,id86237981,left_ankle,1.16198801994324,0,-1,19536,107
19536,104,0.82846075743993,id86237981,right_ankle,1.12553691864014,0,3,19536,107
8582,121,0.145692194814892,idf5e3678b,left_wrist,1.04426789283752,9,-4,8591,108
8591,108,0.318583717277753,idf5e3678b,left_hip,1.03005409240723,0,0,8591,108
8590,109,0.655613498489365,idf5e3678b,left_ankle,1.02351307868958,1,0,8591,108
8590,106,0.757716830413452,idf5e3678b,right_ankle,1.01639103889465,1,3,8591,108
14151,110,0.15692786836966,idf5e3678b,left_wrist,1.04426789283752,-9,-11,14142,108
14144,107,0.310602527319134,idf5e3678b,left_hip,1.03005409240723,-2,-1,14142,108
14143,108,0.67449103658352,idf5e3678b,left_ankle,1.02351307868958,-1,-1,14142,108
14143,108,0.689130608782301,idf5e3678b,right_ankle,1.01639103889465,-1,-1,14142,108
7940,106,0.139408874418209,idf5e3678b,left_wrist,1.04426789283752,8,10,7948,108
7948,108,0.313599437853996,idf5e3678b,left_hip,1.03005409240723,0,0,7948,108
7947,108,0.65508653487974,idf5e3678b,left_ankle,1.02351307868958,1,1,7948,108
7946,110,0.732746180272632,idf5e3678b,right_ankle,1.01639103889465,2,0,7948,108
6453,115,0.134017562912898,idf5e3678b,left_wrist,1.04426789283752,-5,-14,6448,106
6448,110,0.276987262139404,idf5e3678b,left_hip,1.03005409240723,0,-4,6448,106
6447,110,0.631973363516703,idf5e3678b,left_ankle,1.02351307868958,1,-3,6448,106
6448,109,0.654932518064884,idf5e3678b,right_ankle,1.01639103889465,0,-3,6448,106
14997,106,0.16566010610111,idf5e3678b,left_wrist,1.04426789283752,-7,-7,14990,106
14992,106,0.3462139200355,idf5e3678b,left_hip,1.03005409240723,-2,-2,14990,106
14991,106,0.689509501075097,idf5e3678b,left_ankle,1.02351307868958,-1,-1,14990,106
14989,105,0.757868371387517,idf5e3678b,right_ankle,1.01639103889465,1,2,14990,106
4038,108,0.190632488938206,idf5e3678b,left_wrist,1.04426789283752,-5,-3,4033,110
4035,109,0.309986166705609,idf5e3678b,left_hip,1.03005409240723,-2,-1,4033,110
4033,109,0.612869547745097,idf5e3678b,left_ankle,1.02351307868958,0,1,4033,110
4033,108,0.63699791029369,idf5e3678b,right_ankle,1.01639103889465,0,2,4033,110
14151,110,0.15692786836966,idf5e3678b,left_wrist,1.04426789283752,-9,-11,14142,108
14144,107,0.310602527319134,idf5e3678b,left_hip,1.03005409240723,-2,-1,14142,108
14143,108,0.67449103658352,idf5e3678b,left_ankle,1.02351307868958,-1,-1,14142,108
14143,108,0.689130608782301,idf5e3678b,right_ankle,1.01639103889465,-1,-1,14142,108
2485,114,0.184352523449625,idf5e3678b,left_wrist,1.04426789283752,-2,-3,2483,113
2483,114,0.265643490391172,idf5e3678b,left_hip,1.03005409240723,0,-1,2483,113
2481,115,0.590752962213932,idf5e3678b,left_ankle,1.02351307868958,2,0,2483,113
2484,113,0.672185538698181,idf5e3678b,right_ankle,1.01639103889465,-1,-1,2483,113
4908,111,0.158781853801889,idf5e3678b,left_wrist,1.04426789283752,-9,-8,4899,112
4901,111,0.286843878734929,idf5e3678b,left_hip,1.03005409240723,-2,-1,4899,112
4899,112,0.611098007608702,idf5e3678b,left_ankle,1.02351307868958,0,0,4899,112
4900,112,0.624809148438764,idf5e3678b,right_ankle,1.01639103889465,-1,-1,4899,112
2933,113,0.193904362020043,idf5e3678b,left_wrist,1.04426789283752,-3,-5,2930,111
2931,111,0.335723727517891,idf5e3678b,left_hip,1.03005409240723,-1,-1,2930,111
2929,111,0.609007101981589,idf5e3678b,left_ankle,1.02351307868958,1,1,2930,111
2929,113,0.667779199452962,idf5e3678b,right_ankle,1.01639103889465,1,-1,2930,111
4794,115,0.150316372107927,idf5e3678b,left_wrist,1.04426789283752,-5,-9,4789,111
4791,111,0.301271645338913,idf5e3678b,left_hip,1.03005409240723,-2,-2,4789,111
4789,111,0.571839301820185,idf5e3678b,left_ankle,1.02351307868958,0,0,4789,111
4790,111,0.670469982307402,idf5e3678b,right_ankle,1.01639103889465,-1,-1,4789,111
1254,111,0.144034852409949,idf5e3678b,left_wrist,1.04426789283752,-4,-4,1250,111
1251,111,0.268369333041242,idf5e3678b,left_hip,1.03005409240723,-1,-1,1250,111
1250,110,0.627763914050507,idf5e3678b,left_ankle,1.02351307868958,0,1,1250,111
1250,111,0.682153692001585,idf5e3678b,right_ankle,1.01639103889465,0,0,1250,111
12740,107,0.139947152927711,idf5e3678b,left_wrist,1.04426789283752,-10,-9,12730,108
12730,110,0.303723736310691,idf5e3678b,left_hip,1.03005409240723,0,-2,12730,108
12731,108,0.647388950405631,idf5e3678b,left_ankle,1.02351307868958,-1,-1,12730,108
12730,108,0.725795245023578,idf5e3678b,right_ankle,1.01639103889465,0,0,12730,108
17425,108,0.227180494368538,idf5e3678b,left_wrist,1.04426789283752,-4,-5,17421,107
17422,108,0.34076166296532,idf5e3678b,left_hip,1.03005409240723,-1,-2,17421,107
17421,108,0.653905968076458,idf5e3678b,left_ankle,1.02351307868958,0,-1,17421,107
17421,108,0.702034838319587,idf5e3678b,right_ankle,1.01639103889465,0,-1,17421,107
15416,104,0.180994848986768,idf5e3678b,left_wrist,1.04426789283752,-10,-6,15406,108
15410,106,0.301593193091514,idf5e3678b,left_hip,1.03005409240723,-4,-2,15406,108
15408,107,0.656496777119725,idf5e3678b,left_ankle,1.02351307868958,-2,-1,15406,108
15406,106,0.704098938286094,idf5e3678b,right_ankle,1.01639103889465,0,2,15406,108
15834,104,0.217645117521931,idf5e3678b,left_wrist,1.04426789283752,-5,-4,15829,105
15830,106,0.346393850477203,idf5e3678b,left_hip,1.03005409240723,-1,-2,15829,105
15830,104,0.623603503811187,idf5e3678b,left_ankle,1.02351307868958,-1,0,15829,105
15827,106,0.73359260352999,idf5e3678b,right_ankle,1.01639103889465,2,1,15829,105
9017,118,0.135442581705694,idf5e3678b,left_wrist,1.04426789283752,-1,-11,9016,108
9016,109,0.274080003743039,idf5e3678b,left_hip,1.03005409240723,0,-1,9016,108
9017,107,0.594694680802743,idf5e3678b,left_ankle,1.02351307868958,-1,0,9016,108
9014,109,0.64294736651313,idf5e3678b,right_ankle,1.01639103889465,2,1,9016,108
8153,108,0.139957339939368,idf5e3678b,left_wrist,1.04426789283752,9,10,8162,109
8163,108,0.305870345483303,idf5e3678b,left_hip,1.03005409240723,-1,0,8162,109
8163,108,0.667436964099262,idf5e3678b,left_ankle,1.02351307868958,-1,0,8162,109
8160,109,0.750288502533869,idf5e3678b,right_ankle,1.01639103889465,2,2,8162,109
16045,106,0.209176828113166,idf5e3678b,left_wrist,1.04426789283752,-7,-4,16038,109
16041,107,0.329210250584452,idf5e3678b,left_hip,1.03005409240723,-3,-1,16038,109
16039,107,0.604202440002853,idf5e3678b,left_ankle,1.02351307868958,-1,1,16038,109
16039,106,0.685889883624375,idf5e3678b,right_ankle,1.01639103889465,-1,2,16038,109
12092,107,0.111538195991035,idf5e3678b,left_wrist,1.04426789283752,-9,-8,12083,108
12084,108,0.324057264793741,idf5e3678b,left_hip,1.03005409240723,-1,-1,12083,108
12082,109,0.657784544942479,idf5e3678b,left_ankle,1.02351307868958,1,0,12083,108
12082,109,0.735801574766723,idf5e3678b,right_ankle,1.01639103889465,1,0,12083,108
14694,104,0.104096228744141,id37a54bbf,left_wrist,1.3121349811554,-4,-4,14690,104
14687,104,0.243817324942348,id37a54bbf,left_hip,1.3357949256897,3,3,14690,104
14689,103,0.748207384029493,id37a54bbf,left_ankle,1.51358389854431,1,2,14690,104
14689,105,0.675783610108585,id37a54bbf,right_ankle,1.32058906555176,1,0,14690,104
7988,101,0.15920826148041,id37a54bbf,left_wrist,1.3121349811554,-4,-3,7984,102
7981,103,0.248360589708015,id37a54bbf,left_hip,1.3357949256897,3,2,7984,102
7979,105,0.638231289827403,id37a54bbf,left_ankle,1.51358389854431,5,2,7984,102
7982,104,0.672687881055497,id37a54bbf,right_ankle,1.32058906555176,2,0,7984,102
6135,102,0.133233596852129,id37a54bbf,left_wrist,1.3121349811554,8,8,6143,102
6139,102,0.254764044466215,id37a54bbf,left_hip,1.3357949256897,4,4,6143,102
6141,101,0.737852675419876,id37a54bbf,left_ankle,1.51358389854431,2,3,6143,102
6138,103,0.654428017889674,id37a54bbf,right_ankle,1.32058906555176,5,4,6143,102
22286,103,0.121254079710245,id37a54bbf,left_wrist,1.3121349811554,-5,-4,22281,104
22278,104,0.253011824722794,id37a54bbf,left_hip,1.3357949256897,3,3,22281,104
22279,105,0.800757042562947,id37a54bbf,left_ankle,1.51358389854431,2,1,22281,104
22279,104,0.573162568902319,id37a54bbf,right_ankle,1.32058906555176,2,2,22281,104
14179,112,0.107393512390055,id37a54bbf,left_wrist,1.3121349811554,3,-6,14182,103
14178,103,0.226963140927588,id37a54bbf,left_hip,1.3357949256897,4,4,14182,103
14180,104,0.805019999817309,id37a54bbf,left_ankle,1.51358389854431,2,1,14182,103
14179,104,0.663008986051553,id37a54bbf,right_ankle,1.32058906555176,3,2,14182,103
4835,88,0.0900097099821467,id37a54bbf,left_wrist,1.3121349811554,-5,8,4830,101
4826,102,0.252960317104612,id37a54bbf,left_hip,1.3357949256897,4,3,4830,101
4826,104,0.745367446710325,id37a54bbf,left_ankle,1.51358389854431,4,1,4830,101
4828,99,0.681449180923559,id37a54bbf,right_ankle,1.32058906555176,2,4,4830,101
3004,101,0.128542230979077,id37a54bbf,left_wrist,1.3121349811554,8,8,3012,101
3007,102,0.253899551772339,id37a54bbf,left_hip,1.3357949256897,5,4,3012,101
3010,102,0.69957904459177,id37a54bbf,left_ankle,1.51358389854431,2,1,3012,101
3007,102,0.634877155977429,id37a54bbf,right_ankle,1.32058906555176,5,4,3012,101
10742,101,0.0964351394306371,id37a54bbf,left_wrist,1.3121349811554,-6,-6,10736,101
10732,103,0.260070138745367,id37a54bbf,left_hip,1.3357949256897,4,2,10736,101
10735,101,0.829196909884852,id37a54bbf,left_ankle,1.51358389854431,1,1,10736,101
10735,103,0.726074299506708,id37a54bbf,right_ankle,1.32058906555176,1,-1,10736,101
20660,104,0.119982345414941,id37a54bbf,left_wrist,1.3121349811554,-5,-6,20655,103
20656,99,0.221221706502395,id37a54bbf,left_hip,1.3357949256897,-1,3,20655,103
20653,104,0.713164938336407,id37a54bbf,left_ankle,1.51358389854431,2,1,20655,103
20656,99,0.582620909935553,id37a54bbf,right_ankle,1.32058906555176,-1,3,20655,103
13465,111,0.134149182925392,id37a54bbf,left_wrist,1.3121349811554,7,-1,13472,103
13468,103,0.235302379130146,id37a54bbf,left_hip,1.3357949256897,4,4,13472,103
13470,103,0.715439258285884,id37a54bbf,left_ankle,1.51358389854431,2,2,13472,103
13469,101,0.560573233066437,id37a54bbf,right_ankle,1.32058906555176,3,5,13472,103
21876,103,0.105520953188295,id37a54bbf,left_wrist,1.3121349811554,-4,-5,21872,102
21869,101,0.246746242291094,id37a54bbf,left_hip,1.3357949256897,3,4,21872,102
21868,104,0.78552153579652,id37a54bbf,left_ankle,1.51358389854431,4,2,21872,102
21869,104,0.628506666231442,id37a54bbf,right_ankle,1.32058906555176,3,1,21872,102
16457,57,0.200301771925211,id37a54bbf,left_wrist,1.3121349811554,-45,1,16412,103
16408,103,0.22611254190891,id37a54bbf,left_hip,1.3357949256897,4,4,16412,103
16411,102,0.795401902996676,id37a54bbf,left_ankle,1.51358389854431,1,2,16412,103
16410,102,0.677694434209882,id37a54bbf,right_ankle,1.32058906555176,2,3,16412,103
8088,105,0.13430734260178,id37a54bbf,left_wrist,1.3121349811554,-3,-5,8085,103
8083,100,0.257469648789423,id37a54bbf,left_hip,1.3357949256897,2,5,8085,103
8083,103,0.735326653220369,id37a54bbf,left_ankle,1.51358389854431,2,2,8085,103
8085,100,0.690821595510685,id37a54bbf,right_ankle,1.32058906555176,0,3,8085,103
9716,101,0.108971040156724,id37a54bbf,left_wrist,1.3121349811554,-4,-2,9712,103
9709,103,0.25256258934539,id37a54bbf,left_hip,1.3357949256897,3,3,9712,103
9711,99,0.567466863239157,id37a54bbf,left_ankle,1.51358389854431,1,5,9712,103
9709,104,0.642188316223536,id37a54bbf,right_ankle,1.32058906555176,3,2,9712,103
3410,111,0.136428982626487,id37a54bbf,left_wrist,1.3121349811554,7,-1,3417,103
3414,102,0.238219868250339,id37a54bbf,left_hip,1.3357949256897,3,4,3417,103
3413,105,0.780277858381485,id37a54bbf,left_ankle,1.51358389854431,4,2,3417,103
3414,102,0.64267901873302,id37a54bbf,right_ankle,1.32058906555176,3,4,3417,103
401,93,0.102313929716476,id37a54bbf,left_wrist,1.3121349811554,-10,-5,391,98
392,93,0.296015113127004,id37a54bbf,left_hip,1.3357949256897,-1,4,391,98
387,100,0.859109944092327,id37a54bbf,left_ankle,1.51358389854431,4,2,391,98
387,101,0.82838974127597,id37a54bbf,right_ankle,1.32058906555176,4,1,391,98
15961,155,0.258347217567085,id37a54bbf,left_wrist,1.3121349811554,48,-6,16009,101
16005,102,0.240751130459682,id37a54bbf,left_hip,1.3357949256897,4,3,16009,101
16008,102,0.724431897356015,id37a54bbf,left_ankle,1.51358389854431,1,0,16009,101
16006,105,0.644288601234479,id37a54bbf,right_ankle,1.32058906555176,3,-1,16009,101
2404,94,0.109022812338744,id37a54bbf,left_wrist,1.3121349811554,0,7,2404,101
2400,102,0.254765630974394,id37a54bbf,left_hip,1.3357949256897,4,3,2404,101
2400,102,0.673865946895753,id37a54bbf,left_ankle,1.51358389854431,4,3,2404,101
2400,102,0.659584517029324,id37a54bbf,right_ankle,1.32058906555176,4,3,2404,101
10026,103,0.100471488065276,id37a54bbf,left_wrist,1.3121349811554,-6,-4,10020,105
10017,105,0.235631717907903,id37a54bbf,left_hip,1.3357949256897,3,3,10020,105
10020,104,0.800833700219374,id37a54bbf,left_ankle,1.51358389854431,0,1,10020,105
10019,105,0.668650770758229,id37a54bbf,right_ankle,1.32058906555176,1,1,10020,105
14389,101,0.104027629274527,id37a54bbf,left_wrist,1.3121349811554,-3,-3,14386,101
14383,102,0.227886780459724,id37a54bbf,left_hip,1.3357949256897,3,2,14386,101
14381,105,0.632245920609487,id37a54bbf,left_ankle,1.51358389854431,5,1,14386,101
14383,104,0.659466482614927,id37a54bbf,right_ankle,1.32058906555176,3,0,14386,101
17387,96,0.232988010753648,id3e3e50c7,left_wrist,0.929702997207642,1,-2,17388,93
17390,94,0.374808287613084,id3e3e50c7,left_hip,0.931777954101562,-2,-3,17388,93
17386,95,0.673346854704673,id3e3e50c7,left_ankle,1.19900393486023,2,0,17388,93
17387,94,0.735115746697243,id3e3e50c7,right_ankle,0.910501003265381,1,0,17388,93
8649,94,0.221949185421646,id3e3e50c7,left_wrist,0.929702997207642,1,1,8650,94
8652,93,0.363411276322833,id3e3e50c7,left_hip,0.931777954101562,-2,-1,8650,94
8649,94,0.686389556040811,id3e3e50c7,left_ankle,1.19900393486023,1,1,8650,94
8647,93,0.763286821001773,id3e3e50c7,right_ankle,0.910501003265381,3,4,8650,94
8465,93,0.20862660169801,id3e3e50c7,left_wrist,0.929702997207642,2,1,8467,92
8468,93,0.360820289541525,id3e3e50c7,left_hip,0.931777954101562,-1,-2,8467,92
8465,94,0.744991678423077,id3e3e50c7,left_ankle,1.19900393486023,2,0,8467,92
8463,93,0.782748369137762,id3e3e50c7,right_ankle,0.910501003265381,4,3,8467,92
3095,95,0.189789317033172,id3e3e50c7,left_wrist,0.929702997207642,3,2,3098,94
3098,94,0.360697094095151,id3e3e50c7,left_hip,0.931777954101562,0,0,3098,94
3096,95,0.720851833810676,id3e3e50c7,left_ankle,1.19900393486023,2,1,3098,94
3092,95,0.763629180385131,id3e3e50c7,right_ankle,0.910501003265381,6,5,3098,94
13112,87,0.200996712086095,id3e3e50c7,left_wrist,0.929702997207642,-1,3,13111,91
13114,91,0.404663909429254,id3e3e50c7,left_hip,0.931777954101562,-3,-3,13111,91
13110,90,0.689210732010358,id3e3e50c7,left_ankle,1.19900393486023,1,2,13111,91
13108,94,0.787800084295389,id3e3e50c7,right_ankle,0.910501003265381,3,0,13111,91
7910,90,0.193338533950964,id3e3e50c7,left_wrist,0.929702997207642,1,4,7911,93
7913,93,0.324012845743692,id3e3e50c7,left_hip,0.931777954101562,-2,-2,7911,93
7909,93,0.664317813648438,id3e3e50c7,left_ankle,1.19900393486023,2,2,7911,93
7908,94,0.758113669831544,id3e3e50c7,right_ankle,0.910501003265381,3,2,7911,93
8929,90,0.256082312301455,id3e3e50c7,left_wrist,0.929702997207642,0,2,8929,92
8931,91,0.38561447913915,id3e3e50c7,left_hip,0.931777954101562,-2,-1,8929,92
8926,92,0.732321461447617,id3e3e50c7,left_ankle,1.19900393486023,3,3,8929,92
8926,91,0.762366938411012,id3e3e50c7,right_ankle,0.910501003265381,3,4,8929,92
3661,90,0.195647211424955,id3e3e50c7,left_wrist,0.929702997207642,0,4,3661,94
3662,93,0.387968729890126,id3e3e50c7,left_hip,0.931777954101562,-1,0,3661,94
3660,93,0.789245598204579,id3e3e50c7,left_ankle,1.19900393486023,1,2,3661,94
3657,94,0.781712334935055,id3e3e50c7,right_ankle,0.910501003265381,4,4,3661,94
4032,98,0.221026872436954,id3e3e50c7,left_wrist,0.929702997207642,3,-1,4035,94
4035,94,0.392272031851494,id3e3e50c7,left_hip,0.931777954101562,0,0,4035,94
4033,95,0.724329318413388,id3e3e50c7,left_ankle,1.19900393486023,2,1,4035,94
4029,93,0.745889641370276,id3e3e50c7,right_ankle,0.910501003265381,6,7,4035,94
10382,90,0.207675880652516,id3e3e50c7,left_wrist,0.929702997207642,-1,2,10381,93
10383,92,0.401187431412331,id3e3e50c7,left_hip,0.931777954101562,-2,-1,10381,93
10380,92,0.721667958135658,id3e3e50c7,left_ankle,1.19900393486023,1,2,10381,93
10379,91,0.801552744858987,id3e3e50c7,right_ankle,0.910501003265381,2,4,10381,93
10104,93,0.20487277744772,id3e3e50c7,left_wrist,0.929702997207642,0,0,10104,93
10106,93,0.385316425056288,id3e3e50c7,left_hip,0.931777954101562,-2,-2,10104,93
10103,93,0.663828571300127,id3e3e50c7,left_ankle,1.19900393486023,1,1,10104,93
10101,95,0.759345445910982,id3e3e50c7,right_ankle,0.910501003265381,3,1,10104,93
1405,94,0.173465997207496,id3e3e50c7,left_wrist,0.929702997207642,1,2,1406,95
1407,94,0.404592155715532,id3e3e50c7,left_hip,0.931777954101562,-1,0,1406,95
1406,95,0.804274888912304,id3e3e50c7,left_ankle,1.19900393486023,0,0,1406,95
1404,93,0.758615718682081,id3e3e50c7,right_ankle,0.910501003265381,2,4,1406,95
649,95,0.202638808749479,id3e3e50c7,left_wrist,0.929702997207642,2,1,651,94
652,95,0.355010091977225,id3e3e50c7,left_hip,0.931777954101562,-1,-2,651,94
649,95,0.642030059410458,id3e3e50c7,left_ankle,1.19900393486023,2,1,651,94
647,96,0.735406268097312,id3e3e50c7,right_ankle,0.910501003265381,4,2,651,94
11196,89,0.230587673651707,id3e3e50c7,left_wrist,0.929702997207642,1,2,11197,90
11198,91,0.385509063800379,id3e3e50c7,left_hip,0.931777954101562,-1,-2,11197,90
11195,90,0.694922306078916,id3e3e50c7,left_ankle,1.19900393486023,2,2,11197,90
11194,92,0.802806416306012,id3e3e50c7,right_ankle,0.910501003265381,3,1,11197,90
16110,92,0.224162092360085,id3e3e50c7,left_wrist,0.929702997207642,1,0,16111,91
16113,91,0.418014901254277,id3e3e50c7,left_hip,0.931777954101562,-2,-2,16111,91
16109,91,0.665327966461466,id3e3e50c7,left_ankle,1.19900393486023,2,2,16111,91
16110,91,0.795847343876762,id3e3e50c7,right_ankle,0.910501003265381,1,1,16111,91
10471,91,0.220068729563753,id3e3e50c7,left_wrist,0.929702997207642,2,3,10473,92
10474,92,0.390597975788699,id3e3e50c7,left_hip,0.931777954101562,-1,-1,10473,92
10471,92,0.661017487982443,id3e3e50c7,left_ankle,1.19900393486023,2,2,10473,92
10469,95,0.793781261919246,id3e3e50c7,right_ankle,0.910501003265381,4,1,10473,92
9740,95,0.218246151928749,id3e3e50c7,left_wrist,0.929702997207642,2,-2,9742,91
9744,91,0.387895112034391,id3e3e50c7,left_hip,0.931777954101562,-2,-2,9742,91
9740,92,0.789025849473052,id3e3e50c7,left_ankle,1.19900393486023,2,1,9742,91
9738,92,0.777125634164228,id3e3e50c7,right_ankle,0.910501003265381,4,3,9742,91
9199,92,0.186891459961517,id3e3e50c7,left_wrist,0.929702997207642,1,1,9200,92
9203,91,0.401405057228239,id3e3e50c7,left_hip,0.931777954101562,-3,-2,9200,92
9197,93,0.757851638156704,id3e3e50c7,left_ankle,1.19900393486023,3,2,9200,92
9199,91,0.704042458873482,id3e3e50c7,right_ankle,0.910501003265381,1,2,9200,92
17112,92,0.179929542484083,id3e3e50c7,left_wrist,0.929702997207642,1,0,17113,91
17115,92,0.391437999456206,id3e3e50c7,left_hip,0.931777954101562,-2,-3,17113,91
17112,91,0.681060070176796,id3e3e50c7,left_ankle,1.19900393486023,1,1,17113,91
17112,91,0.75559828282178,id3e3e50c7,right_ankle,0.910501003265381,1,1,17113,91
8929,90,0.256082312301455,id3e3e50c7,left_wrist,0.929702997207642,0,2,8929,92
8931,91,0.38561447913915,id3e3e50c7,left_hip,0.931777954101562,-2,-1,8929,92
8926,92,0.732321461447617,id3e3e50c7,left_ankle,1.19900393486023,3,3,8929,92
8926,91,0.762366938411012,id3e3e50c7,right_ankle,0.910501003265381,3,4,8929,92
15082,97,0.170610288887069,idf1ce9a0f,left_wrist,1.34137392044067,-3,-5,15079,95
15076,98,0.255196323202677,idf1ce9a0f,left_hip,1.32478284835815,3,0,15079,95
15077,98,0.94518600838198,idf1ce9a0f,left_ankle,1.31767106056213,2,-1,15079,95
15079,97,0.761722460364759,idf1ce9a0f,right_ankle,1.3390839099884,0,-2,15079,95
13358,96,0.151776188138,idf1ce9a0f,left_wrist,1.34137392044067,-5,-3,13353,98
13352,96,0.255658927045649,idf1ce9a0f,left_hip,1.32478284835815,1,3,13353,98
13352,98,0.985195549349174,idf1ce9a0f,left_ankle,1.31767106056213,1,1,13353,98
13354,97,0.813812605719422,idf1ce9a0f,right_ankle,1.3390839099884,-1,0,13353,98
5316,97,0.0986208632874256,idf1ce9a0f,left_wrist,1.34137392044067,-5,-6,5311,96
5309,98,0.238208368509593,idf1ce9a0f,left_hip,1.32478284835815,2,0,5311,96
5309,98,0.877597825939419,idf1ce9a0f,left_ankle,1.31767106056213,2,0,5311,96
5311,98,0.718325147812659,idf1ce9a0f,right_ankle,1.3390839099884,0,-2,5311,96
5804,101,0.139985806123355,idf1ce9a0f,left_wrist,1.34137392044067,-6,-9,5798,98
5796,100,0.225206906724608,idf1ce9a0f,left_hip,1.32478284835815,2,0,5798,98
5796,100,0.965098680095394,idf1ce9a0f,left_ankle,1.31767106056213,2,0,5798,98
5799,100,0.646999294484951,idf1ce9a0f,right_ankle,1.3390839099884,-1,-3,5798,98
16134,95,0.257207936396796,idf1ce9a0f,left_wrist,1.34137392044067,-7,-6,16127,96
16126,96,0.305061426685979,idf1ce9a0f,left_hip,1.32478284835815,1,1,16127,96
16128,95,0.891723314391447,idf1ce9a0f,left_ankle,1.31767106056213,-1,0,16127,96
16128,96,0.78405894915383,idf1ce9a0f,right_ankle,1.3390839099884,-1,-1,16127,96
10084,96,0.255523922289143,idf1ce9a0f,left_wrist,1.34137392044067,2,3,10086,97
10085,96,0.255255511938734,idf1ce9a0f,left_hip,1.32478284835815,1,2,10086,97
10086,97,0.909646026077721,idf1ce9a0f,left_ankle,1.31767106056213,0,0,10086,97
10087,97,0.725433667444757,idf1ce9a0f,right_ankle,1.3390839099884,-1,-1,10086,97
3950,87,0.126700918379092,idf1ce9a0f,left_wrist,1.34137392044067,-9,2,3941,98
3941,98,0.257187526346973,idf1ce9a0f,left_hip,1.32478284835815,0,0,3941,98
3940,98,0.972979950405452,idf1ce9a0f,left_ankle,1.31767106056213,1,1,3941,98
3942,99,0.737045405563211,idf1ce9a0f,right_ankle,1.3390839099884,-1,-2,3941,98
16508,99,0.211629917882837,idf1ce9a0f,left_wrist,1.34137392044067,-6,-10,16502,95
16503,94,0.287949946354153,idf1ce9a0f,left_hip,1.32478284835815,-1,0,16502,95
16504,95,0.905255517513011,idf1ce9a0f,left_ankle,1.31767106056213,-2,-2,16502,95
16506,94,0.801073842509235,idf1ce9a0f,right_ankle,1.3390839099884,-4,-3,16502,95
2397,96,0.133267717055779,idf1ce9a0f,left_wrist,1.34137392044067,-6,-6,2391,96
2391,95,0.256812721750491,idf1ce9a0f,left_hip,1.32478284835815,0,1,2391,96
2391,96,1.01658360181648,idf1ce9a0f,left_ankle,1.31767106056213,0,0,2391,96
2391,98,0.799724205279147,idf1ce9a0f,right_ankle,1.3390839099884,0,-2,2391,96
19146,71,0.225811365802003,idf1ce9a0f,left_wrist,1.34137392044067,-24,-2,19122,93
19120,95,0.307825908821937,idf1ce9a0f,left_hip,1.32478284835815,2,0,19122,93
19123,95,0.935047724375136,idf1ce9a0f,left_ankle,1.31767106056213,-1,-3,19122,93
19123,95,0.79686161799232,idf1ce9a0f,right_ankle,1.3390839099884,-1,-3,19122,93
13647,96,0.19477444294757,idf1ce9a0f,left_wrist,1.34137392044067,-8,-5,13639,99
13641,96,0.264721340376231,idf1ce9a0f,left_hip,1.32478284835815,-2,1,13639,99
13641,97,0.865628936514519,idf1ce9a0f,left_ankle,1.31767106056213,-2,0,13639,99
13644,95,0.729242730551798,idf1ce9a0f,right_ankle,1.3390839099884,-5,-1,13639,99
12392,97,0.242713864214501,idf1ce9a0f,left_wrist,1.34137392044067,-6,-4,12386,99
12385,97,0.26472753403812,idf1ce9a0f,left_hip,1.32478284835815,1,3,12386,99
12386,97,0.884634230718936,idf1ce9a0f,left_ankle,1.31767106056213,0,2,12386,99
12387,97,0.717129329525777,idf1ce9a0f,right_ankle,1.3390839099884,-1,1,12386,99
7374,98,0.134636488046005,idf1ce9a0f,left_wrist,1.34137392044067,-6,-5,7368,99
7368,99,0.230623476703545,idf1ce9a0f,left_hip,1.32478284835815,0,0,7368,99
7369,98,0.919815826607433,idf1ce9a0f,left_ankle,1.31767106056213,-1,0,7368,99
7370,100,0.752338350416302,idf1ce9a0f,right_ankle,1.3390839099884,-2,-3,7368,99
10084,96,0.255523922289143,idf1ce9a0f,left_wrist,1.34137392044067,2,3,10086,97
10085,96,0.255255511938734,idf1ce9a0f,left_hip,1.32478284835815,1,2,10086,97
10086,97,0.909646026077721,idf1ce9a0f,left_ankle,1.31767106056213,0,0,10086,97
10087,97,0.725433667444757,idf1ce9a0f,right_ankle,1.3390839099884,-1,-1,10086,97
11207,86,0.310896155184672,idf1ce9a0f,left_wrist,1.34137392044067,-61,-49,11146,98
11143,98,0.238472666070437,idf1ce9a0f,left_hip,1.32478284835815,3,3,11146,98
11144,98,0.906626006862681,idf1ce9a0f,left_ankle,1.31767106056213,2,2,11146,98
11147,97,0.784415305172029,idf1ce9a0f,right_ankle,1.3390839099884,-1,0,11146,98
4047,99,0.153205894293437,idf1ce9a0f,left_wrist,1.34137392044067,-9,-8,4038,100
4038,100,0.247159965931202,idf1ce9a0f,left_hip,1.32478284835815,0,0,4038,100
4037,101,0.815749167481246,idf1ce9a0f,left_ankle,1.31767106056213,1,0,4038,100
4040,101,0.767385397755052,idf1ce9a0f,right_ankle,1.3390839099884,-2,-3,4038,100
11723,100,0.261255488346114,idf1ce9a0f,left_wrist,1.34137392044067,-4,-7,11719,97
11718,96,0.266429906510005,idf1ce9a0f,left_hip,1.32478284835815,1,2,11719,97
11719,96,0.919926629300851,idf1ce9a0f,left_ankle,1.31767106056213,0,1,11719,97
11721,97,0.74130158255374,idf1ce9a0f,right_ankle,1.3390839099884,-2,-2,11719,97
1717,100,0.152193754112379,idf1ce9a0f,left_wrist,1.34137392044067,-7,-10,1710,97
1708,99,0.22252438905974,idf1ce9a0f,left_hip,1.32478284835815,2,0,1710,97
1709,99,0.881367178697208,idf1ce9a0f,left_ankle,1.31767106056213,1,-1,1710,97
1711,98,0.719706823206476,idf1ce9a0f,right_ankle,1.3390839099884,-1,-2,1710,97
6193,100,0.147036366721068,idf1ce9a0f,left_wrist,1.34137392044067,-4,-6,6189,98
6187,99,0.229652415532631,idf1ce9a0f,left_hip,1.32478284835815,2,1,6189,98
6187,99,0.873884758269407,idf1ce9a0f,left_ankle,1.31767106056213,2,1,6189,98
6188,100,0.637681944170554,idf1ce9a0f,right_ankle,1.3390839099884,1,-1,6189,98
4734,95,0.118828473329198,idf1ce9a0f,left_wrist,1.34137392044067,-6,-2,4728,99
4727,97,0.279994265244363,idf1ce9a0f,left_hip,1.32478284835815,1,3,4728,99
4727,97,0.883139962375623,idf1ce9a0f,left_ankle,1.31767106056213,1,3,4728,99
4729,97,0.760357194899285,idf1ce9a0f,right_ankle,1.3390839099884,-1,1,4728,99
6145,117,0.150383043761146,idecc9265e,left_wrist,1.11506295204163,6,3,6151,114
6149,115,0.236479205955004,idecc9265e,left_hip,1.08955097198486,2,1,6151,114
6146,115,0.615781210276147,idecc9265e,left_ankle,1.07569479942322,5,4,6151,114
6145,115,0.676248301263822,idecc9265e,right_ankle,1.0824830532074,6,5,6151,114
18996,113,0.185944331348646,idecc9265e,left_wrist,1.11506295204163,-8,-9,18988,112
18995,112,0.260478911350946,idecc9265e,left_hip,1.08955097198486,-7,-7,18988,112
18992,112,0.62584793127871,idecc9265e,left_ankle,1.07569479942322,-4,-4,18988,112
18992,112,0.729565362774577,idecc9265e,right_ankle,1.0824830532074,-4,-4,18988,112
9602,58,0.138431235342649,idecc9265e,left_wrist,1.11506295204163,-14,49,9588,121
9593,123,0.18939262593496,idecc9265e,left_hip,1.08955097198486,-5,-7,9588,121
9594,118,0.594188381608933,idecc9265e,left_ankle,1.07569479942322,-6,-3,9588,121
9588,122,0.552707819135141,idecc9265e,right_ankle,1.0824830532074,0,-1,9588,121
16638,117,0.229747892026756,idecc9265e,left_wrist,1.11506295204163,-10,-14,16628,113
16635,113,0.232658943054036,idecc9265e,left_hip,1.08955097198486,-7,-7,16628,113
16631,119,0.633416070410138,idecc9265e,left_ankle,1.07569479942322,-3,-9,16628,113
16631,114,0.756211878107195,idecc9265e,right_ankle,1.0824830532074,-3,-4,16628,113
18886,111,0.231839264169228,idecc9265e,left_wrist,1.11506295204163,-9,-8,18877,112
18883,113,0.254561220755087,idecc9265e,left_hip,1.08955097198486,-6,-7,18877,112
18880,113,0.643296368576191,idecc9265e,left_ankle,1.07569479942322,-3,-4,18877,112
18880,113,0.636068085400074,idecc9265e,right_ankle,1.0824830532074,-3,-4,18877,112
8887,123,0.212724781449225,idecc9265e,left_wrist,1.11506295204163,-2,-8,8885,117
8889,118,0.228323669706094,idecc9265e,left_hip,1.08955097198486,-4,-5,8885,117
8889,117,0.659512589615256,idecc9265e,left_ankle,1.07569479942322,-4,-4,8885,117
8887,117,0.695955414488225,idecc9265e,right_ankle,1.0824830532074,-2,-2,8885,117
1374,112,0.176540647620918,idecc9265e,left_wrist,1.11506295204163,-13,-10,1361,115
1367,116,0.220264826025,idecc9265e,left_hip,1.08955097198486,-6,-7,1361,115
1365,115,0.61881409547206,idecc9265e,left_ankle,1.07569479942322,-4,-4,1361,115
1366,114,0.696740512396449,idecc9265e,right_ankle,1.0824830532074,-5,-4,1361,115
7185,117,0.154007352714994,idecc9265e,left_wrist,1.11506295204163,-9,-11,7176,115
7183,114,0.236600777674882,idecc9265e,left_hip,1.08955097198486,-7,-6,7176,115
7179,116,0.63768031542747,idecc9265e,left_ankle,1.07569479942322,-3,-4,7176,115
7179,115,0.732631119518155,idecc9265e,right_ankle,1.0824830532074,-3,-3,7176,115
15502,115,0.206704937552178,idecc9265e,left_wrist,1.11506295204163,-9,-9,15493,115
15499,117,0.244890728009624,idecc9265e,left_hip,1.08955097198486,-6,-8,15493,115
15497,115,0.649245950334659,idecc9265e,left_ankle,1.07569479942322,-4,-4,15493,115
15496,116,0.732806108293748,idecc9265e,right_ankle,1.0824830532074,-3,-4,15493,115
7301,115,0.132937676249919,idecc9265e,left_wrist,1.11506295204163,-11,-11,7290,115
7296,116,0.204892404574267,idecc9265e,left_hip,1.08955097198486,-6,-7,7290,115
7294,116,0.622567105655291,idecc9265e,left_ankle,1.07569479942322,-4,-5,7290,115
7293,116,0.707384240643767,idecc9265e,right_ankle,1.0824830532074,-3,-4,7290,115
13593,111,0.192487266976136,idecc9265e,left_wrist,1.11506295204163,-11,-7,13582,115
13587,116,0.224657019361832,idecc9265e,left_hip,1.08955097198486,-5,-6,13582,115
13586,115,0.654787486226319,idecc9265e,left_ankle,1.07569479942322,-4,-4,13582,115
13584,115,0.647649830357275,idecc9265e,right_ankle,1.0824830532074,-2,-2,13582,115
17875,114,0.221543292533438,idecc9265e,left_wrist,1.11506295204163,-8,-9,17867,113
17874,113,0.262385278619003,idecc9265e,left_hip,1.08955097198486,-7,-7,17867,113
17870,113,0.661429733863582,idecc9265e,left_ankle,1.07569479942322,-3,-3,17867,113
17871,113,0.718858815024851,idecc9265e,right_ankle,1.0824830532074,-4,-4,17867,113
18209,116,0.171375791933132,idecc9265e,left_wrist,1.11506295204163,-7,-9,18202,114
18209,112,0.245764134525332,idecc9265e,left_hip,1.08955097198486,-7,-5,18202,114
18205,117,0.635766676901507,idecc9265e,left_ankle,1.07569479942322,-3,-6,18202,114
18206,113,0.722020461498981,idecc9265e,right_ankle,1.0824830532074,-4,-3,18202,114
8325,110,0.177616150559059,idecc9265e,left_wrist,1.11506295204163,-9,-5,8316,114
8321,116,0.246036648119792,idecc9265e,left_hip,1.08955097198486,-5,-7,8316,114
8319,114,0.570857693039994,idecc9265e,left_ankle,1.07569479942322,-3,-3,8316,114
8319,114,0.629699388829295,idecc9265e,right_ankle,1.0824830532074,-3,-3,8316,114
8208,118,0.141802159725817,idecc9265e,left_wrist,1.11506295204163,-7,-9,8201,116
8207,115,0.22318377632173,idecc9265e,left_hip,1.08955097198486,-6,-5,8201,116
8205,115,0.640527796567639,idecc9265e,left_ankle,1.07569479942322,-4,-3,8201,116
8203,117,0.724596883958256,idecc9265e,right_ankle,1.0824830532074,-2,-3,8201,116
19108,118,0.201532277536324,idecc9265e,left_wrist,1.11506295204163,-9,-11,19099,116
19106,115,0.23304365404803,idecc9265e,left_hip,1.08955097198486,-7,-6,19099,116
19103,116,0.603200766897485,idecc9265e,left_ankle,1.07569479942322,-4,-4,19099,116
19103,114,0.640396342435639,idecc9265e,right_ankle,1.0824830532074,-4,-2,19099,116
13703,109,0.145851487801049,idecc9265e,left_wrist,1.11506295204163,-7,-4,13696,112
13702,112,0.229408038590417,idecc9265e,left_hip,1.08955097198486,-6,-6,13696,112
13700,110,0.596328818356302,idecc9265e,left_ankle,1.07569479942322,-4,-2,13696,112
13698,114,0.702827893265045,idecc9265e,right_ankle,1.0824830532074,-2,-4,13696,112
15841,115,0.198696588578764,idecc9265e,left_wrist,1.11506295204163,-9,-10,15832,114
15840,114,0.239550752889384,idecc9265e,left_hip,1.08955097198486,-8,-8,15832,114
15836,114,0.60327999406563,idecc9265e,left_ankle,1.07569479942322,-4,-4,15832,114
15836,115,0.693426855676059,idecc9265e,right_ankle,1.0824830532074,-4,-5,15832,114
12910,116,0.161708026476602,idecc9265e,left_wrist,1.11506295204163,-11,-11,12899,116
12907,114,0.230845236597386,idecc9265e,left_hip,1.08955097198486,-8,-6,12899,116
12903,116,0.625195790024861,idecc9265e,left_ankle,1.07569479942322,-4,-4,12899,116
12903,116,0.665268664353804,idecc9265e,right_ankle,1.0824830532074,-4,-4,12899,116
19225,113,0.174327672368182,idecc9265e,left_wrist,1.11506295204163,-11,-10,19214,114
19220,114,0.246053883823764,idecc9265e,left_hip,1.08955097198486,-6,-6,19214,114
19218,113,0.639932851749414,idecc9265e,left_ankle,1.07569479942322,-4,-3,19214,114
19216,115,0.686089477624005,idecc9265e,right_ankle,1.0824830532074,-2,-3,19214,114
5804,102,0.129494269229894,id687ab496,left_wrist,1.08503293991089,-4,-4,5800,102
5791,109,0.279590949989038,id687ab496,left_hip,1.04882907867432,9,2,5800,102
5796,103,0.744875438107,id687ab496,left_ankle,1.07943415641785,4,3,5800,102
5797,103,0.722156542251772,id687ab496,right_ankle,1.07231712341309,3,2,5800,102
3786,104,0.121876044435017,id687ab496,left_wrist,1.08503293991089,4,1,3790,101
3787,103,0.281171201859502,id687ab496,left_hip,1.04882907867432,3,1,3790,101
3784,103,0.757231501511161,id687ab496,left_ankle,1.07943415641785,6,4,3790,101
3787,100,0.656521516168474,id687ab496,right_ankle,1.07231712341309,3,4,3790,101
17425,106,0.310474696206877,id687ab496,left_wrist,1.08503293991089,45,40,17470,101
17469,102,0.27691983756351,id687ab496,left_hip,1.04882907867432,1,0,17470,101
17469,102,0.737085581780159,id687ab496,left_ankle,1.07943415641785,1,0,17470,101
17469,101,0.684596824794506,id687ab496,right_ankle,1.07231712341309,1,1,17470,101
9959,99,0.187531674028809,id687ab496,left_wrist,1.08503293991089,-3,-1,9956,101
9956,100,0.32221008116868,id687ab496,left_hip,1.04882907867432,0,1,9956,101
9952,104,0.71586494769523,id687ab496,left_ankle,1.07943415641785,4,1,9956,101
9954,99,0.606567949882385,id687ab496,right_ankle,1.07231712341309,2,4,9956,101
17276,56,0.161309299192092,id687ab496,left_wrist,1.08503293991089,-4,39,17272,99
17271,101,0.328884808046159,id687ab496,left_hip,1.04882907867432,1,-1,17272,99
17271,100,0.754872416817849,id687ab496,left_ankle,1.07943415641785,1,0,17272,99
17270,98,0.679921266266059,id687ab496,right_ankle,1.07231712341309,2,3,17272,99
3786,104,0.121876044435017,id687ab496,left_wrist,1.08503293991089,3,1,3789,102
3787,103,0.281171201859502,id687ab496,left_hip,1.04882907867432,2,1,3789,102
3784,103,0.757231501511161,id687ab496,left_ankle,1.07943415641785,5,4,3789,102
3787,100,0.656521516168474,id687ab496,right_ankle,1.07231712341309,2,4,3789,102
14916,99,0.247199147797739,id687ab496,left_wrist,1.08503293991089,44,45,14960,100
14961,99,0.30820051387488,id687ab496,left_hip,1.04882907867432,-1,0,14960,100
14959,101,0.663339428104948,id687ab496,left_ankle,1.07943415641785,1,0,14960,100
14957,100,0.701662746368906,id687ab496,right_ankle,1.07231712341309,3,3,14960,100
14264,105,0.189322726759814,id687ab496,left_wrist,1.08503293991089,2,-4,14266,99
14265,100,0.290527346950326,id687ab496,left_hip,1.04882907867432,1,0,14266,99
14265,101,0.792089048576777,id687ab496,left_ankle,1.07943415641785,1,-1,14266,99
14262,99,0.670958018316659,id687ab496,right_ankle,1.07231712341309,4,4,14266,99
18524,100,0.239690113111819,id687ab496,left_wrist,1.08503293991089,45,46,18569,101
18569,101,0.330947075393692,id687ab496,left_hip,1.04882907867432,0,0,18569,101
18569,100,0.790834076418048,id687ab496,left_ankle,1.07943415641785,0,1,18569,101
18566,101,0.592659846420271,id687ab496,right_ankle,1.07231712341309,3,3,18569,101
10858,106,0.186379442207368,id687ab496,left_wrist,1.08503293991089,2,-2,10860,102
10858,102,0.257702755133097,id687ab496,left_hip,1.04882907867432,2,2,10860,102
10858,101,0.681244956716309,id687ab496,left_ankle,1.07943415641785,2,3,10860,102
10856,103,0.638909743753634,id687ab496,right_ankle,1.07231712341309,4,3,10860,102
14072,99,0.138626985323351,id687ab496,left_wrist,1.08503293991089,-3,-2,14069,100
14069,99,0.300692556825903,id687ab496,left_hip,1.04882907867432,0,1,14069,100
14069,99,0.775105318416625,id687ab496,left_ankle,1.07943415641785,0,1,14069,100
14065,99,0.673920774899401,id687ab496,right_ankle,1.07231712341309,4,5,14069,100
7710,77,0.177303566001782,id687ab496,left_wrist,1.08503293991089,15,40,7725,102
7725,102,0.300588740585935,id687ab496,left_hip,1.04882907867432,0,0,7725,102
7722,102,0.776055180204678,id687ab496,left_ankle,1.07943415641785,3,3,7725,102
7723,101,0.593088559167277,id687ab496,right_ankle,1.07231712341309,2,3,7725,102
2176,104,0.176764373203958,id687ab496,left_wrist,1.08503293991089,1,0,2177,103
2176,102,0.284136025753987,id687ab496,left_hip,1.04882907867432,1,2,2177,103
2173,102,0.711111038755604,id687ab496,left_ankle,1.07943415641785,4,5,2177,103
2174,101,0.605947051905412,id687ab496,right_ankle,1.07231712341309,3,5,2177,103
18277,99,0.227012593138267,id687ab496,left_wrist,1.08503293991089,-4,-4,18273,99
18272,101,0.304039037873172,id687ab496,left_hip,1.04882907867432,1,-1,18273,99
18271,101,0.754734595731125,id687ab496,left_ankle,1.07943415641785,2,0,18273,99
18268,102,0.697195064145829,id687ab496,right_ankle,1.07231712341309,5,2,18273,99
5652,109,0.137899791133511,id687ab496,left_wrist,1.08503293991089,45,40,5697,104
5688,104,0.250251576174654,id687ab496,left_hip,1.04882907867432,9,9,5697,104
5693,104,0.798019425007482,id687ab496,left_ankle,1.07943415641785,4,4,5697,104
5696,102,0.653876965456892,id687ab496,right_ankle,1.07231712341309,1,3,5697,104
11756,60,0.112659722297519,id687ab496,left_wrist,1.08503293991089,2,44,11758,102
11758,102,0.261381290534131,id687ab496,left_hip,1.04882907867432,0,0,11758,102
11758,101,0.767485425600649,id687ab496,left_ankle,1.07943415641785,0,1,11758,102
11756,102,0.58918023536658,id687ab496,right_ankle,1.07231712341309,2,2,11758,102
2176,104,0.176764373203958,id687ab496,left_wrist,1.08503293991089,-5,-7,2171,102
2176,102,0.284136025753987,id687ab496,left_hip,1.04882907867432,-5,-5,2171,102
2173,102,0.711111038755604,id687ab496,left_ankle,1.07943415641785,-2,-2,2171,102
2174,101,0.605947051905412,id687ab496,right_ankle,1.07231712341309,-3,-2,2171,102
16568,101,0.215324958427291,id687ab496,left_wrist,1.08503293991089,-5,-3,16563,103
16564,102,0.275912651437373,id687ab496,left_hip,1.04882907867432,-1,0,16563,103
16560,103,0.734538242253998,id687ab496,left_ankle,1.07943415641785,3,3,16563,103
16561,103,0.683701197162365,id687ab496,right_ankle,1.07231712341309,2,2,16563,103
6265,105,0.27229813651834,id687ab496,left_wrist,1.08503293991089,50,46,6315,101
6312,103,0.297136142455773,id687ab496,left_hip,1.04882907867432,3,1,6315,101
6313,99,0.746805381814799,id687ab496,left_ankle,1.07943415641785,2,4,6315,101
6311,101,0.654005630301034,id687ab496,right_ankle,1.07231712341309,4,4,6315,101
15457,105,0.18251400553063,id687ab496,left_wrist,1.08503293991089,1,1,15458,105
15458,104,0.263836484126575,id687ab496,left_hip,1.04882907867432,0,1,15458,105
15455,105,0.664765061623294,id687ab496,left_ankle,1.07943415641785,3,3,15458,105
15458,100,0.648965108116895,id687ab496,right_ankle,1.07231712341309,0,5,15458,105
6046,103,0.199014084327428,id1f372081,left_wrist,1.23382806777954,-1,3,6045,107
6044,107,0.267722632430901,id1f372081,left_hip,1.20129585266113,1,1,6045,107
6044,107,0.601872500955038,id1f372081,left_ankle,1.21268200874329,1,1,6045,107
6044,105,0.56162543023025,id1f372081,right_ankle,1.21061706542969,1,3,6045,107
4787,101,0.229767332299712,id1f372081,left_wrist,1.23382806777954,-2,5,4785,108
4785,107,0.274532596818176,id1f372081,left_hip,1.20129585266113,0,1,4785,108
4784,108,0.669789553840429,id1f372081,left_ankle,1.21268200874329,1,1,4785,108
4784,107,0.533037155899379,id1f372081,right_ankle,1.21061706542969,1,2,4785,108
11299,104,0.289544640728637,id1f372081,left_wrist,1.23382806777954,-12,-13,11287,103
11296,104,0.287279576296271,id1f372081,left_hip,1.20129585266113,-9,-10,11287,103
11294,103,0.544183555762887,id1f372081,left_ankle,1.21268200874329,-7,-7,11287,103
11291,106,0.496744713681717,id1f372081,right_ankle,1.21061706542969,-4,-7,11287,103
5940,107,0.200370480612359,id1f372081,left_wrist,1.23382806777954,-1,-1,5939,107
5937,108,0.256091050506652,id1f372081,left_hip,1.20129585266113,2,1,5939,107
5937,108,0.646403068332531,id1f372081,left_ankle,1.21268200874329,2,1,5939,107
5937,108,0.509053425074425,id1f372081,right_ankle,1.21061706542969,2,1,5939,107
4040,120,0.122359339003007,id1f372081,left_wrist,1.23382806777954,6,-6,4046,108
4045,107,0.277729238418323,id1f372081,left_hip,1.20129585266113,1,2,4046,108
4046,106,0.653249185506284,id1f372081,left_ankle,1.21268200874329,0,2,4046,108
4046,103,0.556719227250708,id1f372081,right_ankle,1.21061706542969,0,5,4046,108
11402,108,0.295051795485743,id1f372081,left_wrist,1.23382806777954,-13,-14,11389,107
11399,105,0.259143246283195,id1f372081,left_hip,1.20129585266113,-10,-8,11389,107
11396,106,0.585428416867234,id1f372081,left_ankle,1.21268200874329,-7,-6,11389,107
11396,104,0.501555247630547,id1f372081,right_ankle,1.21061706542969,-7,-4,11389,107
12335,106,0.160330712908674,id1f372081,left_wrist,1.23382806777954,-7,-9,12328,104
12333,105,0.242153001228204,id1f372081,left_hip,1.20129585266113,-5,-6,12328,104
12334,106,0.553449292210905,id1f372081,left_ankle,1.21268200874329,-6,-8,12328,104
12334,104,0.557172761699506,id1f372081,right_ankle,1.21061706542969,-6,-6,12328,104
2873,113,0.171950061764889,id1f372081,left_wrist,1.23382806777954,0,-6,2873,107
2871,106,0.266657873630008,id1f372081,left_hip,1.20129585266113,2,3,2873,107
2872,104,0.620691623132044,id1f372081,left_ankle,1.21268200874329,1,4,2873,107
2871,106,0.560744947355781,id1f372081,right_ankle,1.21061706542969,2,3,2873,107
5729,106,0.213882709923223,id1f372081,left_wrist,1.23382806777954,0,0,5729,106
5728,106,0.284898779130491,id1f372081,left_hip,1.20129585266113,1,1,5729,106
5728,105,0.709735260818851,id1f372081,left_ankle,1.21268200874329,1,2,5729,106
5727,105,0.600788870542629,id1f372081,right_ankle,1.21061706542969,2,3,5729,106
15687,104,0.29540249579849,id1f372081,left_wrist,1.23382806777954,-11,-13,15676,102
15684,106,0.254551681484742,id1f372081,left_hip,1.20129585266113,-8,-12,15676,102
15682,102,0.513929918171079,id1f372081,left_ankle,1.21268200874329,-6,-6,15676,102
15680,106,0.535296203562591,id1f372081,right_ankle,1.21061706542969,-4,-8,15676,102
20985,103,0.253658445918906,id1f372081,left_wrist,1.23382806777954,-10,-10,20975,103
20983,104,0.274699475125278,id1f372081,left_hip,1.20129585266113,-8,-9,20975,103
20982,102,0.606406269592843,id1f372081,left_ankle,1.21268200874329,-7,-6,20975,103
20980,105,0.54325660250135,id1f372081,right_ankle,1.21061706542969,-5,-7,20975,103
2230,113,0.237147212379149,id1f372081,left_wrist,1.23382806777954,-2,-7,2228,108
2232,109,0.266072481561271,id1f372081,left_hip,1.20129585266113,-4,-5,2228,108
2232,108,0.622383260246276,id1f372081,left_ankle,1.21268200874329,-4,-4,2228,108
2229,108,0.561290666659876,id1f372081,right_ankle,1.21061706542969,-1,-1,2228,108
16737,107,0.258465326583373,id1f372081,left_wrist,1.23382806777954,-14,-17,16723,104
16732,111,0.249507043662267,id1f372081,left_hip,1.20129585266113,-9,-16,16723,104
16729,106,0.578237201008875,id1f372081,left_ankle,1.21268200874329,-6,-8,16723,104
16731,105,0.550944797026044,id1f372081,right_ankle,1.21061706542969,-8,-9,16723,104
20783,97,0.291397466124426,id1f372081,left_wrist,1.23382806777954,-6,-1,20777,102
20781,100,0.308826108090362,id1f372081,left_hip,1.20129585266113,-4,-2,20777,102
20779,99,0.671295746303326,id1f372081,left_ankle,1.21268200874329,-2,1,20777,102
20775,105,0.552404469702569,id1f372081,right_ankle,1.21061706542969,2,-1,20777,102
17892,104,0.311696627930442,id1f372081,left_wrist,1.23382806777954,-14,-12,17878,106
17886,106,0.261040610423322,id1f372081,left_hip,1.20129585266113,-8,-8,17878,106
17885,104,0.644206335513638,id1f372081,left_ankle,1.21268200874329,-7,-5,17878,106
17886,106,0.512026445411228,id1f372081,right_ankle,1.21061706542969,-8,-8,17878,106
6790,105,0.220938741140231,id1f372081,left_wrist,1.23382806777954,-7,-6,6783,106
6788,106,0.281221575371927,id1f372081,left_hip,1.20129585266113,-5,-5,6783,106
6784,107,0.686815625923597,id1f372081,left_ankle,1.21268200874329,-1,-2,6783,106
6787,107,0.599228744007008,id1f372081,right_ankle,1.21061706542969,-4,-5,6783,106
14210,103,0.212379833942746,id1f372081,left_wrist,1.23382806777954,-11,-10,14199,104
14206,104,0.226234011620057,id1f372081,left_hip,1.20129585266113,-7,-7,14199,104
14204,104,0.639552601522642,id1f372081,left_ankle,1.21268200874329,-5,-5,14199,104
14202,103,0.568853311598354,id1f372081,right_ankle,1.21061706542969,-3,-2,14199,104
20783,97,0.291397466124426,id1f372081,left_wrist,1.23382806777954,-6,-1,20777,102
20781,100,0.308826108090362,id1f372081,left_hip,1.20129585266113,-4,-2,20777,102
20779,99,0.671295746303326,id1f372081,left_ankle,1.21268200874329,-2,1,20777,102
20775,105,0.552404469702569,id1f372081,right_ankle,1.21061706542969,2,-1,20777,102
20985,103,0.253658445918906,id1f372081,left_wrist,1.23382806777954,-3,-2,20982,104
20983,104,0.274699475125278,id1f372081,left_hip,1.20129585266113,-1,-1,20982,104
20982,102,0.606406269592843,id1f372081,left_ankle,1.21268200874329,0,2,20982,104
20980,105,0.54325660250135,id1f372081,right_ankle,1.21061706542969,2,1,20982,104
7527,104,0.225763826753724,id1f372081,left_wrist,1.23382806777954,-8,-8,7519,104
7525,104,0.270445562566801,id1f372081,left_hip,1.20129585266113,-6,-6,7519,104
7524,104,0.651593227055647,id1f372081,left_ankle,1.21268200874329,-5,-5,7519,104
7523,104,0.561282573306783,id1f372081,right_ankle,1.21061706542969,-4,-4,7519,104
5555,101,0.087579466858368,id079c763c,left_wrist,1.2805438041687,8,10,5563,103
5564,102,0.258874111292384,id079c763c,left_hip,1.24096608161926,-1,0,5563,103
5566,102,0.609091592201442,id079c763c,left_ankle,1.24091386795044,-3,-2,5563,103
5563,104,0.712940851612363,id079c763c,right_ankle,1.23443102836609,0,-1,5563,103
3590,109,0.0754727982457196,id079c763c,left_wrist,1.2805438041687,-31,-40,3559,100
3560,101,0.277702252328591,id079c763c,left_hip,1.24096608161926,-1,-2,3559,100
3562,100,0.725239869484204,id079c763c,left_ankle,1.24091386795044,-3,-3,3559,100
3562,99,0.78343422034023,id079c763c,right_ankle,1.23443102836609,-3,-2,3559,100
6778,106,0.162995544956142,id079c763c,left_wrist,1.2805438041687,9,7,6787,104
6789,104,0.239090967006161,id079c763c,left_hip,1.24096608161926,-2,-2,6787,104
6789,106,0.62924923166045,id079c763c,left_ankle,1.24091386795044,-2,-4,6787,104
6787,103,0.619520478061453,id079c763c,right_ankle,1.23443102836609,0,1,6787,104
10751,95,0.174626285896355,id079c763c,left_wrist,1.2805438041687,7,6,10758,94
10759,96,0.349163282054396,id079c763c,left_hip,1.24096608161926,-1,-3,10758,94
10760,97,0.747309110213349,id079c763c,left_ankle,1.24091386795044,-2,-5,10758,94
10761,96,0.652847576214699,id079c763c,right_ankle,1.23443102836609,-3,-5,10758,94
19308,95,0.177007699495355,id079c763c,left_wrist,1.2805438041687,-5,-5,19303,95
19309,93,0.378750957127117,id079c763c,left_hip,1.24096608161926,-6,-4,19303,95
19307,95,0.788790519564996,id079c763c,left_ankle,1.24091386795044,-4,-4,19303,95
19309,94,0.720608602435992,id079c763c,right_ankle,1.23443102836609,-6,-5,19303,95
10751,95,0.174626285896355,id079c763c,left_wrist,1.2805438041687,7,6,10758,94
10759,96,0.349163282054396,id079c763c,left_hip,1.24096608161926,-1,-3,10758,94
10760,97,0.747309110213349,id079c763c,left_ankle,1.24091386795044,-2,-5,10758,94
10761,96,0.652847576214699,id079c763c,right_ankle,1.23443102836609,-3,-5,10758,94
5454,102,0.134330246543613,id079c763c,left_wrist,1.2805438041687,8,8,5462,102
5464,101,0.283984975254341,id079c763c,left_hip,1.24096608161926,-2,-1,5462,102
5465,102,0.681030118991457,id079c763c,left_ankle,1.24091386795044,-3,-3,5462,102
5462,102,0.651526552416581,id079c763c,right_ankle,1.23443102836609,0,0,5462,102
1048,73,0.0986088076465458,id079c763c,left_wrist,1.2805438041687,9,30,1057,94
1058,94,0.320719695398513,id079c763c,left_hip,1.24096608161926,-1,-1,1057,94
1059,93,0.76890235930789,id079c763c,left_ankle,1.24091386795044,-2,-1,1057,94
1062,95,0.766864938581222,id079c763c,right_ankle,1.23443102836609,-5,-6,1057,94
8835,98,0.163967394978761,id079c763c,left_wrist,1.2805438041687,8,7,8843,97
8844,97,0.290154120247998,id079c763c,left_hip,1.24096608161926,-1,-1,8843,97
8846,96,0.71436795087425,id079c763c,left_ankle,1.24091386795044,-3,-2,8843,97
8848,94,0.66789720534307,id079c763c,right_ankle,1.23443102836609,-5,-2,8843,97
17924,88,0.170027258861152,id079c763c,left_wrist,1.2805438041687,-6,-3,17918,91
17924,91,0.396838048504684,id079c763c,left_hip,1.24096608161926,-6,-6,17918,91
17920,92,0.774627686375841,id079c763c,left_ankle,1.24091386795044,-2,-3,17918,91
17923,91,0.725207138432365,id079c763c,right_ankle,1.23443102836609,-5,-5,17918,91
7284,100,0.132714659342044,id079c763c,left_wrist,1.2805438041687,7,6,7291,99
7293,99,0.290163882846513,id079c763c,left_hip,1.24096608161926,-2,-2,7291,99
7295,99,0.70974126756444,id079c763c,left_ankle,1.24091386795044,-4,-4,7291,99
7294,99,0.627262997724349,id079c763c,right_ankle,1.23443102836609,-3,-3,7291,99
2763,102,0.174119738221611,id079c763c,left_wrist,1.2805438041687,8,6,2771,100
2771,101,0.329511327505389,id079c763c,left_hip,1.24096608161926,0,-1,2771,100
2772,101,0.741686906089931,id079c763c,left_ankle,1.24091386795044,-1,-2,2771,100
2771,100,0.665278856964901,id079c763c,right_ankle,1.23443102836609,0,0,2771,100
7866,100,0.0537837467641788,id079c763c,left_wrist,1.2805438041687,9,8,7875,99
7877,98,0.314756369559168,id079c763c,left_hip,1.24096608161926,-2,-1,7875,99
7879,98,0.741376749936478,id079c763c,left_ankle,1.24091386795044,-4,-3,7875,99
7880,97,0.743470598523794,id079c763c,right_ankle,1.23443102836609,-5,-3,7875,99
13417,97,0.0820400033662905,id079c763c,left_wrist,1.2805438041687,7,8,13424,98
13427,95,0.306655009549113,id079c763c,left_hip,1.24096608161926,-3,0,13424,98
13428,97,0.765776494567303,id079c763c,left_ankle,1.24091386795044,-4,-3,13424,98
13429,96,0.737016485453517,id079c763c,right_ankle,1.23443102836609,-5,-3,13424,98
8255,99,0.139578421938652,id079c763c,left_wrist,1.2805438041687,10,8,8265,97
8267,95,0.281842041434669,id079c763c,left_hip,1.24096608161926,-2,0,8265,97
8267,97,0.695003923552447,id079c763c,left_ankle,1.24091386795044,-2,-2,8265,97
8268,97,0.636516166426647,id079c763c,right_ankle,1.23443102836609,-3,-3,8265,97
14484,85,0.10857941634089,id079c763c,left_wrist,1.2805438041687,-5,8,14479,98
14478,100,0.256686791661042,id079c763c,left_hip,1.24096608161926,1,-1,14479,98
14481,100,0.757173585958017,id079c763c,left_ankle,1.24091386795044,-2,-4,14479,98
14482,96,0.70334195516815,id079c763c,right_ankle,1.23443102836609,-3,-1,14479,98
14665,110,0.141026942072258,id079c763c,left_wrist,1.2805438041687,8,-3,14673,99
14677,97,0.24370534920387,id079c763c,left_hip,1.24096608161926,-4,-2,14673,99
14675,100,0.755396834561632,id079c763c,left_ankle,1.24091386795044,-2,-3,14673,99
14676,98,0.722952154427218,id079c763c,right_ankle,1.23443102836609,-3,-2,14673,99
11630,91,0.218190073753545,id079c763c,left_wrist,1.2805438041687,-10,-4,11620,97
11622,99,0.354443498632839,id079c763c,left_hip,1.24096608161926,-2,-4,11620,97
11624,96,0.705468869191081,id079c763c,left_ankle,1.24091386795044,-4,-3,11620,97
11623,97,0.724241517797329,id079c763c,right_ankle,1.23443102836609,-3,-3,11620,97
9026,98,0.147159189824046,id079c763c,left_wrist,1.2805438041687,9,7,9035,96
9037,95,0.288429131305612,id079c763c,left_hip,1.24096608161926,-2,-1,9035,96
9037,97,0.74384491377137,id079c763c,left_ankle,1.24091386795044,-2,-3,9035,96
9038,97,0.700225377738177,id079c763c,right_ankle,1.23443102836609,-3,-4,9035,96
9605,93,0.0934255544614945,id079c763c,left_wrist,1.2805438041687,6,8,9611,95
9611,96,0.262141466427704,id079c763c,left_hip,1.24096608161926,0,-1,9611,95
9614,95,0.707786868138509,id079c763c,left_ankle,1.24091386795044,-3,-3,9611,95
9613,97,0.749420746667459,id079c763c,right_ankle,1.23443102836609,-2,-4,9611,95
5465,98,0.18888760332207,idbae5a811,left_wrist,0.94660496711731,-2,-6,5463,94
5459,97,0.252272979152135,idbae5a811,left_hip,1.19164681434631,4,1,5463,94
5462,99,0.640714978425456,idbae5a811,left_ankle,0.941390991210938,1,-4,5463,94
5460,99,0.593257935981104,idbae5a811,right_ankle,0.946516036987305,3,-2,5463,94
10342,90,0.1864847071803,idbae5a811,left_wrist,0.94660496711731,-4,-3,10338,91
10343,93,0.295319878025616,idbae5a811,left_hip,1.19164681434631,-5,-7,10338,91
10340,91,0.636621948228702,idbae5a811,left_ankle,0.941390991210938,-2,-2,10338,91
10340,92,0.667406304205728,idbae5a811,right_ankle,0.946516036987305,-2,-3,10338,91
16240,92,0.158817506020899,idbae5a811,left_wrist,0.94660496711731,-2,0,16238,94
16238,96,0.278222987076961,idbae5a811,left_hip,1.19164681434631,0,-2,16238,94
16237,93,0.639956286280095,idbae5a811,left_ankle,0.941390991210938,1,2,16238,94
16238,93,0.591286407300396,idbae5a811,right_ankle,0.946516036987305,0,1,16238,94
2597,91,0.194566245546289,idbae5a811,left_wrist,0.94660496711731,-3,2,2594,96
2598,91,0.309143736324095,idbae5a811,left_hip,1.19164681434631,-4,1,2594,96
2595,94,0.713214622656237,idbae5a811,left_ankle,0.941390991210938,-1,1,2594,96
2598,91,0.674130447270997,idbae5a811,right_ankle,0.946516036987305,-4,1,2594,96
7496,95,0.173445093738821,idbae5a811,left_wrist,0.94660496711731,-4,-5,7492,94
7498,92,0.270004026856016,idbae5a811,left_hip,1.19164681434631,-6,-4,7492,94
7496,94,0.628319224065873,idbae5a811,left_ankle,0.941390991210938,-4,-4,7492,94
7496,93,0.573937952843766,idbae5a811,right_ankle,0.946516036987305,-4,-3,7492,94
3771,91,0.239489495457176,idbae5a811,left_wrist,0.94660496711731,2,1,3773,90
3773,91,0.284438869092131,idbae5a811,left_hip,1.19164681434631,0,-1,3773,90
3771,91,0.733935481410819,idbae5a811,left_ankle,0.941390991210938,2,1,3773,90
3772,91,0.591187195001606,idbae5a811,right_ankle,0.946516036987305,1,0,3773,90
7685,90,0.162780784118068,idbae5a811,left_wrist,0.94660496711731,-5,-4,7680,91
7683,96,0.268108237116786,idbae5a811,left_hip,1.19164681434631,-3,-8,7680,91
7682,92,0.704775321714067,idbae5a811,left_ankle,0.941390991210938,-2,-3,7680,91
7683,93,0.645659603284999,idbae5a811,right_ankle,0.946516036987305,-3,-5,7680,91
2506,92,0.215180891161985,idbae5a811,left_wrist,0.94660496711731,-4,-3,2502,93
2505,94,0.280469866137429,idbae5a811,left_hip,1.19164681434631,-3,-4,2502,93
2506,90,0.725136698796641,idbae5a811,left_ankle,0.941390991210938,-4,-1,2502,93
2506,93,0.636574107906186,idbae5a811,right_ankle,0.946516036987305,-4,-4,2502,93
8237,97,0.14053633952763,idbae5a811,left_wrist,0.94660496711731,-4,-2,8233,99
8236,94,0.263226515363427,idbae5a811,left_hip,1.19164681434631,-3,2,8233,99
8235,95,0.661492514663783,idbae5a811,left_ankle,0.941390991210938,-2,2,8233,99
8234,95,0.612820981251676,idbae5a811,right_ankle,0.946516036987305,-1,3,8233,99
16835,90,0.115586007188668,idbae5a811,left_wrist,0.94660496711731,-49,-45,16786,94
16791,91,0.290516198693375,idbae5a811,left_hip,1.19164681434631,-5,-2,16786,94
16785,94,0.663726675500528,idbae5a811,left_ankle,0.941390991210938,1,1,16786,94
16787,92,0.573292652724052,idbae5a811,right_ankle,0.946516036987305,-1,1,16786,94
13599,92,0.144433227711316,idbae5a811,left_wrist,0.94660496711731,0,0,13599,92
13599,94,0.291915834582892,idbae5a811,left_hip,1.19164681434631,0,-2,13599,92
13597,92,0.686264395078165,idbae5a811,left_ankle,0.941390991210938,2,2,13599,92
13597,93,0.597927059511156,idbae5a811,right_ankle,0.946516036987305,2,1,13599,92
16560,101,0.161718004276147,idbae5a811,left_wrist,0.94660496711731,45,36,16605,92
16607,92,0.32398564458734,idbae5a811,left_hip,1.19164681434631,-2,-2,16605,92
16604,92,0.639034141675047,idbae5a811,left_ankle,0.941390991210938,1,1,16605,92
16605,92,0.594847954704589,idbae5a811,right_ankle,0.946516036987305,0,0,16605,92
8424,94,0.147064714229188,idbae5a811,left_wrist,0.94660496711731,1,1,8425,94
8424,94,0.277095141313284,idbae5a811,left_hip,1.19164681434631,1,1,8425,94
8424,93,0.675972344409914,idbae5a811,left_ankle,0.941390991210938,1,2,8425,94
8424,94,0.589852429630782,idbae5a811,right_ankle,0.946516036987305,1,1,8425,94
10787,91,0.197381064997007,idbae5a811,left_wrist,0.94660496711731,3,-3,10790,85
10791,92,0.249530462572308,idbae5a811,left_hip,1.19164681434631,-1,-8,10790,85
10789,89,0.714841420483167,idbae5a811,left_ankle,0.941390991210938,1,-3,10790,85
10790,89,0.59228621444513,idbae5a811,right_ankle,0.946516036987305,0,-4,10790,85
8702,91,0.181312264392182,idbae5a811,left_wrist,0.94660496711731,0,-5,8702,86
8702,93,0.285327480103793,idbae5a811,left_hip,1.19164681434631,0,-7,8702,86
8701,91,0.637307946380441,idbae5a811,left_ankle,0.941390991210938,1,-4,8702,86
8699,93,0.632558270555928,idbae5a811,right_ankle,0.946516036987305,3,-4,8702,86
1953,93,0.164622431761976,idbae5a811,left_wrist,0.94660496711731,0,-5,1953,88
1951,94,0.327061285011442,idbae5a811,left_hip,1.19164681434631,2,-4,1953,88
1951,94,0.709385717403242,idbae5a811,left_ankle,0.941390991210938,2,-4,1953,88
1951,94,0.682037299899647,idbae5a811,right_ankle,0.946516036987305,2,-4,1953,88
4412,97,0.190852541457271,idbae5a811,left_wrist,0.94660496711731,-1,-6,4411,92
4412,93,0.281386720185097,idbae5a811,left_hip,1.19164681434631,-1,-2,4411,92
4410,97,0.660342627815891,idbae5a811,left_ankle,0.941390991210938,1,-4,4411,92
4411,95,0.569163361215806,idbae5a811,right_ankle,0.946516036987305,0,-3,4411,92
8886,90,0.11454538558717,idbae5a811,left_wrist,0.94660496711731,-2,5,8884,97
8884,94,0.272099614457415,idbae5a811,left_hip,1.19164681434631,0,3,8884,97
8883,97,0.687195749321199,idbae5a811,left_ankle,0.941390991210938,1,1,8884,97
8883,94,0.531898175090516,idbae5a811,right_ankle,0.946516036987305,1,4,8884,97
6679,95,0.182276817266984,idbae5a811,left_wrist,0.94660496711731,5,-1,6684,89
6682,92,0.240730876810269,idbae5a811,left_hip,1.19164681434631,2,-1,6684,89
6680,93,0.657348667746694,idbae5a811,left_ankle,0.941390991210938,4,0,6684,89
6679,91,0.526850821900371,idbae5a811,right_ankle,0.946516036987305,5,3,6684,89
16560,101,0.161718004276147,idbae5a811,left_wrist,0.94660496711731,45,36,16605,92
16607,92,0.32398564458734,idbae5a811,left_hip,1.19164681434631,-2,-2,16605,92
16604,92,0.639034141675047,idbae5a811,left_ankle,0.941390991210938,1,1,16605,92
16605,92,0.594847954704589,idbae5a811,right_ankle,0.946516036987305,0,0,16605,92
11757,119,0.231554857692834,id7c20ee7a,left_wrist,1.30382394790649,1,-15,11758,103
11752,110,0.168714445512489,id7c20ee7a,left_hip,1.26690793037415,6,-1,11758,103
11758,102,0.614394138880045,id7c20ee7a,left_ankle,1.28818798065186,0,1,11758,103
11760,101,0.653118214300045,id7c20ee7a,right_ankle,1.28891706466675,-2,0,11758,103
7325,109,0.171461030587781,id7c20ee7a,left_wrist,1.30382394790649,-50,-50,7275,109
7268,111,0.155873499786037,id7c20ee7a,left_hip,1.26690793037415,7,5,7275,109
7273,110,0.670912868456163,id7c20ee7a,left_ankle,1.28818798065186,2,1,7275,109
7272,110,0.603852089335447,id7c20ee7a,right_ankle,1.28891706466675,3,2,7275,109
6332,109,0.196434039691985,id7c20ee7a,left_wrist,1.30382394790649,-49,-50,6283,108
6277,110,0.175439239739425,id7c20ee7a,left_hip,1.26690793037415,6,4,6283,108
6280,110,0.611777073953867,id7c20ee7a,left_ankle,1.28818798065186,3,1,6283,108
6280,109,0.581879134571627,id7c20ee7a,right_ankle,1.28891706466675,3,2,6283,108
17722,106,0.10200977726913,id7c20ee7a,left_wrist,1.30382394790649,-1,0,17721,107
17719,106,0.19390504716548,id7c20ee7a,left_hip,1.26690793037415,2,3,17721,107
17722,105,0.612913842860687,id7c20ee7a,left_ankle,1.28818798065186,-1,1,17721,107
17719,108,0.540877591609189,id7c20ee7a,right_ankle,1.28891706466675,2,1,17721,107
15827,98,0.109144917473486,id7c20ee7a,left_wrist,1.30382394790649,-4,4,15823,106
15823,106,0.173690326198655,id7c20ee7a,left_hip,1.26690793037415,0,0,15823,106
15825,105,0.641721009376525,id7c20ee7a,left_ankle,1.28818798065186,-2,-1,15823,106
15823,106,0.670523120319224,id7c20ee7a,right_ankle,1.28891706466675,0,0,15823,106
3831,111,0.190236448177187,id7c20ee7a,left_wrist,1.30382394790649,-51,-51,3780,111
3775,112,0.176052379592977,id7c20ee7a,left_hip,1.26690793037415,5,4,3780,111
3778,110,0.54646459154262,id7c20ee7a,left_ankle,1.28818798065186,2,3,3780,111
3778,109,0.561923340806771,id7c20ee7a,right_ankle,1.28891706466675,2,4,3780,111
1634,107,0.151624674678088,id7c20ee7a,left_wrist,1.30382394790649,5,4,1639,106
1632,105,0.151791038121974,id7c20ee7a,left_hip,1.26690793037415,7,8,1639,106
1637,106,0.576361483905738,id7c20ee7a,left_ankle,1.28818798065186,2,2,1639,106
1637,106,0.537791926713409,id7c20ee7a,right_ankle,1.28891706466675,2,2,1639,106
17086,101,0.101723965389205,id7c20ee7a,left_wrist,1.30382394790649,-2,4,17084,107
17087,104,0.204964713944755,id7c20ee7a,left_hip,1.26690793037415,-3,0,17084,107
17085,105,0.66386077353888,id7c20ee7a,left_ankle,1.28818798065186,-1,1,17084,107
17084,106,0.610486876707656,id7c20ee7a,right_ankle,1.28891706466675,0,1,17084,107
13937,105,0.118730636748658,id7c20ee7a,left_wrist,1.30382394790649,4,5,13941,106
13937,105,0.145740816146624,id7c20ee7a,left_hip,1.26690793037415,4,5,13941,106
13940,105,0.57954398957868,id7c20ee7a,left_ankle,1.28818798065186,1,2,13941,106
13940,106,0.68071653559958,id7c20ee7a,right_ankle,1.28891706466675,1,1,13941,106
3941,111,0.156583058254984,id7c20ee7a,left_wrist,1.30382394790649,-51,-52,3890,110
3886,109,0.169250978049865,id7c20ee7a,left_hip,1.26690793037415,4,5,3890,110
3887,112,0.494653393604466,id7c20ee7a,left_ankle,1.28818798065186,3,1,3890,110
3886,112,0.520731835626185,id7c20ee7a,right_ankle,1.28891706466675,4,2,3890,110
1428,101,0.103843246671617,id7c20ee7a,left_wrist,1.30382394790649,4,0,1432,97
1426,103,0.125182550686741,id7c20ee7a,left_hip,1.26690793037415,6,0,1432,97
1430,103,0.675713374857339,id7c20ee7a,left_ankle,1.28818798065186,2,-4,1432,97
1432,102,0.612919218949961,id7c20ee7a,right_ankle,1.28891706466675,0,-5,1432,97
2529,109,0.195775909538345,id7c20ee7a,left_wrist,1.30382394790649,-45,-47,2484,107
2478,106,0.166003702319203,id7c20ee7a,left_hip,1.26690793037415,6,7,2484,107
2482,106,0.624387236437699,id7c20ee7a,left_ankle,1.28818798065186,2,3,2484,107
2482,107,0.581388276567746,id7c20ee7a,right_ankle,1.28891706466675,2,2,2484,107
8722,118,0.134429526629309,id7c20ee7a,left_wrist,1.30382394790649,-49,-58,8673,109
8667,108,0.146039606270868,id7c20ee7a,left_hip,1.26690793037415,6,7,8673,109
8671,109,0.665005026940081,id7c20ee7a,left_ankle,1.28818798065186,2,2,8673,109
8670,109,0.632945748439361,id7c20ee7a,right_ankle,1.28891706466675,3,3,8673,109
3941,111,0.156583058254984,id7c20ee7a,left_wrist,1.30382394790649,-51,-52,3890,110
3886,109,0.169250978049865,id7c20ee7a,left_hip,1.26690793037415,4,5,3890,110
3887,112,0.494653393604466,id7c20ee7a,left_ankle,1.28818798065186,3,1,3890,110
3886,112,0.520731835626185,id7c20ee7a,right_ankle,1.28891706466675,4,2,3890,110
6881,113,0.188560040634603,id7c20ee7a,left_wrist,1.30382394790649,-52,-52,6829,113
6823,110,0.135103568642002,id7c20ee7a,left_hip,1.26690793037415,6,9,6829,113
6827,112,0.557108230260067,id7c20ee7a,left_ankle,1.28818798065186,2,3,6829,113
6826,111,0.558150648833428,id7c20ee7a,right_ankle,1.28891706466675,3,5,6829,113
4491,112,0.18062843128886,id7c20ee7a,left_wrist,1.30382394790649,-51,-52,4440,111
4435,112,0.169677288750523,id7c20ee7a,left_hip,1.26690793037415,5,4,4440,111
4437,112,0.520937256790827,id7c20ee7a,left_ankle,1.28818798065186,3,2,4440,111
4437,111,0.588056965335356,id7c20ee7a,right_ankle,1.28891706466675,3,3,4440,111
5901,107,0.221693416212328,id7c20ee7a,left_wrist,1.30382394790649,-50,-49,5851,108
5842,110,0.189458670891839,id7c20ee7a,left_hip,1.26690793037415,9,7,5851,108
5848,109,0.57097889237357,id7c20ee7a,left_ankle,1.28818798065186,3,2,5851,108
5848,111,0.541595029160648,id7c20ee7a,right_ankle,1.28891706466675,3,0,5851,108
4272,110,0.200043550066982,id7c20ee7a,left_wrist,1.30382394790649,-50,-50,4222,110
4218,108,0.166774327044677,id7c20ee7a,left_hip,1.26690793037415,4,6,4222,110
4219,111,0.56680283293246,id7c20ee7a,left_ankle,1.28818798065186,3,2,4222,110
4219,110,0.547211479703786,id7c20ee7a,right_ankle,1.28891706466675,3,3,4222,110
10810,104,0.174184294599541,id7c20ee7a,left_wrist,1.30382394790649,-1,3,10809,108
10804,107,0.134542351337941,id7c20ee7a,left_hip,1.26690793037415,5,6,10809,108
10807,108,0.550103903744942,id7c20ee7a,left_ankle,1.28818798065186,2,2,10809,108
10806,109,0.632203719792386,id7c20ee7a,right_ankle,1.28891706466675,3,2,10809,108
17408,98,0.143257622293101,id7c20ee7a,left_wrist,1.30382394790649,-6,3,17402,107
17396,113,0.181117009104914,id7c20ee7a,left_hip,1.26690793037415,6,0,17402,107
17403,107,0.637755247255389,id7c20ee7a,left_ankle,1.28818798065186,-1,-1,17402,107
17400,106,0.568896614923143,id7c20ee7a,right_ankle,1.28891706466675,2,3,17402,107
665,101,0.17531727702983,id00b70b13,left_wrist,1.02006387710571,28,25,693,98
696,98,0.271335584995387,id00b70b13,left_hip,1.0443389415741,-3,-3,693,98
696,98,0.648405815718575,id00b70b13,left_ankle,1.04040813446045,-3,-3,693,98
694,99,0.612042692188889,id00b70b13,right_ankle,1.05222296714783,-1,-2,693,98
10243,101,0.202739583721737,id00b70b13,left_wrist,1.02006387710571,7,7,10250,101
10252,102,0.321774077433212,id00b70b13,left_hip,1.0443389415741,-2,-3,10250,101
10252,101,0.642430505609351,id00b70b13,left_ankle,1.04040813446045,-2,-2,10250,101
10253,100,0.623978611370934,id00b70b13,right_ankle,1.05222296714783,-3,-2,10250,101
17100,116,0.204903332851844,id00b70b13,left_wrist,1.02006387710571,8,-7,17108,101
17111,101,0.308634701695725,id00b70b13,left_hip,1.0443389415741,-3,-3,17108,101
17110,102,0.686901261171378,id00b70b13,left_ankle,1.04040813446045,-2,-3,17108,101
17111,101,0.629465889646069,id00b70b13,right_ankle,1.05222296714783,-3,-3,17108,101
7295,99,0.176940182325596,id00b70b13,left_wrist,1.02006387710571,41,40,7336,98
7337,101,0.316462935960443,id00b70b13,left_hip,1.0443389415741,-1,-4,7336,98
7338,99,0.621769707959891,id00b70b13,left_ankle,1.04040813446045,-2,-3,7336,98
7336,102,0.682078551551472,id00b70b13,right_ankle,1.05222296714783,0,-4,7336,98
1054,82,0.102374350940553,id00b70b13,left_wrist,1.02006387710571,29,45,1083,98
1085,99,0.2881248903232,id00b70b13,left_hip,1.0443389415741,-2,-3,1083,98
1086,98,0.634140425897408,id00b70b13,left_ankle,1.04040813446045,-3,-3,1083,98
1083,98,0.665544027539682,id00b70b13,right_ankle,1.05222296714783,0,0,1083,98
2760,135,0.129746182470615,id00b70b13,left_wrist,1.02006387710571,27,-4,2787,104
2789,103,0.303975823900519,id00b70b13,left_hip,1.0443389415741,-2,-1,2787,104
2788,104,0.698685354093003,id00b70b13,left_ankle,1.04040813446045,-1,-1,2787,104
2790,103,0.59757041444249,id00b70b13,right_ankle,1.05222296714783,-3,-2,2787,104
6335,169,0.132111374532764,id00b70b13,left_wrist,1.02006387710571,93,26,6428,102
6521,170,0.179173477009976,id00b70b13,left_wrist,1.02006387710571,-93,-161,6428,102
6431,103,0.295919826106497,id00b70b13,left_hip,1.0443389415741,-3,-4,6428,102
6433,100,0.702794223233478,id00b70b13,left_ankle,1.04040813446045,-5,-3,6428,102
6431,103,0.671513468619584,id00b70b13,right_ankle,1.05222296714783,-3,-4,6428,102
3064,102,0.125577709672237,id00b70b13,left_wrist,1.02006387710571,29,28,3093,101
3094,101,0.277067805336911,id00b70b13,left_hip,1.0443389415741,-1,-1,3093,101
3095,101,0.764307487914807,id00b70b13,left_ankle,1.04040813446045,-2,-2,3093,101
3094,100,0.546552583919549,id00b70b13,right_ankle,1.05222296714783,-1,0,3093,101
2654,107,0.270305635993295,id00b70b13,left_wrist,1.02006387710571,29,28,2683,106
2685,105,0.270916143632003,id00b70b13,left_hip,1.0443389415741,-2,-1,2683,106
2685,104,0.583631492053751,id00b70b13,left_ankle,1.04040813446045,-2,0,2683,106
2687,104,0.691136687983708,id00b70b13,right_ankle,1.05222296714783,-4,-2,2683,106
4406,62,0.0866517103585893,id00b70b13,left_wrist,1.02006387710571,-11,29,4395,102
4398,102,0.254215023156347,id00b70b13,left_hip,1.0443389415741,-3,-3,4395,102
4398,101,0.59214115114937,id00b70b13,left_ankle,1.04040813446045,-3,-2,4395,102
4398,101,0.724712212380468,id00b70b13,right_ankle,1.05222296714783,-3,-2,4395,102
4600,63,0.167315722433286,id00b70b13,left_wrist,1.02006387710571,-5,36,4595,104
4598,102,0.265448694853905,id00b70b13,left_hip,1.0443389415741,-3,-1,4595,104
4597,103,0.712789771580115,id00b70b13,left_ankle,1.04040813446045,-2,-1,4595,104
4598,103,0.6244299535048,id00b70b13,right_ankle,1.05222296714783,-3,-2,4595,104
2654,107,0.270305635993295,id00b70b13,left_wrist,1.02006387710571,29,27,2683,105
2685,105,0.270916143632003,id00b70b13,left_hip,1.0443389415741,-2,-2,2683,105
2685,104,0.583631492053751,id00b70b13,left_ankle,1.04040813446045,-2,-1,2683,105
2687,104,0.691136687983708,id00b70b13,right_ankle,1.05222296714783,-4,-3,2683,105
19097,99,0.179599958277426,id00b70b13,left_wrist,1.02006387710571,-5,-5,19092,99
19096,99,0.28126976582134,id00b70b13,left_hip,1.0443389415741,-4,-4,19092,99
19096,98,0.753095881042107,id00b70b13,left_ankle,1.04040813446045,-4,-3,19092,99
19094,100,0.708485105251767,id00b70b13,right_ankle,1.05222296714783,-2,-3,19092,99
6521,170,0.179173477009976,id00b70b13,left_wrist,1.02006387710571,8,-61,6529,101
6533,101,0.272066746057899,id00b70b13,left_hip,1.0443389415741,-4,-4,6529,101
6532,102,0.690855397267589,id00b70b13,left_ankle,1.04040813446045,-3,-4,6529,101
6533,101,0.67334270387499,id00b70b13,right_ankle,1.05222296714783,-4,-4,6529,101
9920,84,0.179647992937061,id00b70b13,left_wrist,1.02006387710571,25,44,9945,103
9948,103,0.31284478126481,id00b70b13,left_hip,1.0443389415741,-3,-3,9945,103
9948,103,0.774183997267162,id00b70b13,left_ankle,1.04040813446045,-3,-3,9945,103
9949,102,0.690277944501898,id00b70b13,right_ankle,1.05222296714783,-4,-3,9945,103
13206,114,0.250352413812108,id00b70b13,left_wrist,1.02006387710571,7,-8,13213,99
13217,100,0.307462915241058,id00b70b13,left_hip,1.0443389415741,-4,-5,13213,99
13216,100,0.761236403600306,id00b70b13,left_ankle,1.04040813446045,-3,-4,13213,99
13215,99,0.619663773846896,id00b70b13,right_ankle,1.05222296714783,-2,-2,13213,99
1952,92,0.135002079810602,id00b70b13,left_wrist,1.02006387710571,28,36,1980,100
1980,101,0.290815699547891,id00b70b13,left_hip,1.0443389415741,0,-1,1980,100
1981,101,0.717309225839802,id00b70b13,left_ankle,1.04040813446045,-1,-2,1980,100
1978,104,0.679780081675779,id00b70b13,right_ankle,1.05222296714783,2,-2,1980,100
2552,103,0.200180749431079,id00b70b13,left_wrist,1.02006387710571,31,29,2583,101
2585,101,0.286404995461016,id00b70b13,left_hip,1.0443389415741,-2,-2,2583,101
2584,102,0.652392301479503,id00b70b13,left_ankle,1.04040813446045,-1,-2,2583,101
2585,103,0.685543822827159,id00b70b13,right_ankle,1.05222296714783,-2,-4,2583,101
1054,82,0.102374350940553,id00b70b13,left_wrist,1.02006387710571,29,45,1083,98
1085,99,0.2881248903232,id00b70b13,left_hip,1.0443389415741,-2,-3,1083,98
1086,98,0.634140425897408,id00b70b13,left_ankle,1.04040813446045,-3,-3,1083,98
1083,98,0.665544027539682,id00b70b13,right_ankle,1.05222296714783,0,0,1083,98
18061,100,0.337925784374529,id00b70b13,left_wrist,1.02006387710571,-54,-55,18007,99
18012,98,0.2825161685393,id00b70b13,left_hip,1.0443389415741,-5,-4,18007,99
18010,100,0.774901875643471,id00b70b13,left_ankle,1.04040813446045,-3,-4,18007,99
18009,101,0.69605489373355,id00b70b13,right_ankle,1.05222296714783,-2,-4,18007,99
14657,105,0.126328136232762,id1165e00c,left_wrist,1.19689393043518,-2,-3,14655,104
14655,104,0.268915157995901,id1165e00c,left_hip,1.2112500667572,0,0,14655,104
14654,106,0.692186375949298,id1165e00c,left_ankle,1.20762205123901,1,-1,14655,104
14653,106,0.792249982526827,id1165e00c,right_ankle,1.21875214576721,2,0,14655,104
2133,112,0.201158019180415,id1165e00c,left_wrist,1.19689393043518,1,-2,2134,109
2131,109,0.280043477254985,id1165e00c,left_hip,1.2112500667572,3,3,2134,109
2132,109,0.646859389834364,id1165e00c,left_ankle,1.20762205123901,2,2,2134,109
2132,109,0.625289643212573,id1165e00c,right_ankle,1.21875214576721,2,2,2134,109
10819,97,0.069261779489188,id1165e00c,left_wrist,1.19689393043518,-9,2,10810,108
10808,110,0.224985554461302,id1165e00c,left_hip,1.2112500667572,2,0,10810,108
10810,109,0.586180668939936,id1165e00c,left_ankle,1.20762205123901,0,-1,10810,108
10809,111,0.705980694084043,id1165e00c,right_ankle,1.21875214576721,1,-2,10810,108
10073,101,0.0998856521690372,id1165e00c,left_wrist,1.19689393043518,-6,-1,10067,106
10062,110,0.223175523708207,id1165e00c,left_hip,1.2112500667572,5,1,10067,106
10064,109,0.584325330277082,id1165e00c,left_ankle,1.20762205123901,3,0,10067,106
10064,107,0.693191661375824,id1165e00c,right_ankle,1.21875214576721,3,2,10067,106
8254,105,0.0889721342634785,id1165e00c,left_wrist,1.19689393043518,0,3,8254,108
8253,108,0.231241459389248,id1165e00c,left_hip,1.2112500667572,1,1,8254,108
8255,107,0.635131110305732,id1165e00c,left_ankle,1.20762205123901,-1,0,8254,108
8253,107,0.737037802800213,id1165e00c,right_ankle,1.21875214576721,1,2,8254,108
21528,105,0.101156190352061,id1165e00c,left_wrist,1.19689393043518,0,2,21528,107
21526,108,0.251588325301197,id1165e00c,left_hip,1.2112500667572,2,1,21528,107
21528,108,0.677831777753496,id1165e00c,left_ankle,1.20762205123901,0,-1,21528,107
21527,108,0.762820307224659,id1165e00c,right_ankle,1.21875214576721,1,0,21528,107
3990,110,0.135755977153632,id1165e00c,left_wrist,1.19689393043518,-2,-2,3988,110
3985,114,0.240576422292824,id1165e00c,left_hip,1.2112500667572,3,-1,3988,110
3985,112,0.518072507370742,id1165e00c,left_ankle,1.20762205123901,3,1,3988,110
3985,112,0.635227298383264,id1165e00c,right_ankle,1.21875214576721,3,1,3988,110
17685,107,0.152736607080105,id1165e00c,left_wrist,1.19689393043518,-3,-4,17682,106
17683,104,0.235156603631836,id1165e00c,left_hip,1.2112500667572,-1,1,17682,106
17682,106,0.592671039354327,id1165e00c,left_ankle,1.20762205123901,0,0,17682,106
17680,106,0.696832183011659,id1165e00c,right_ankle,1.21875214576721,2,2,17682,106
1543,107,0.155812341070374,id1165e00c,left_wrist,1.19689393043518,51,52,1594,108
1592,108,0.249977074170124,id1165e00c,left_hip,1.2112500667572,2,2,1594,108
1593,108,0.635011572351396,id1165e00c,left_ankle,1.20762205123901,1,1,1594,108
1592,108,0.625087963390463,id1165e00c,right_ankle,1.21875214576721,2,2,1594,108
8783,95,0.0996833208050395,id1165e00c,left_wrist,1.19689393043518,-5,6,8778,106
8779,104,0.238016702660195,id1165e00c,left_hip,1.2112500667572,-1,1,8778,106
8779,104,0.589950759966034,id1165e00c,left_ankle,1.20762205123901,-1,1,8778,106
8776,105,0.783507786010027,id1165e00c,right_ankle,1.21875214576721,2,3,8778,106
3116,107,0.15608096633207,id1165e00c,left_wrist,1.19689393043518,1,1,3117,107
3116,107,0.242230186364991,id1165e00c,left_hip,1.2112500667572,1,1,3117,107
3114,108,0.592880763810041,id1165e00c,left_ankle,1.20762205123901,3,2,3117,107
3114,108,0.634020135382082,id1165e00c,right_ankle,1.21875214576721,3,2,3117,107
4441,108,0.114972242169751,id1165e00c,left_wrist,1.19689393043518,-10,-3,4431,115
4432,114,0.223929715633676,id1165e00c,left_hip,1.2112500667572,-1,0,4431,115
4429,112,0.547050951930644,id1165e00c,left_ankle,1.20762205123901,2,5,4431,115
4433,112,0.593994461181502,id1165e00c,right_ankle,1.21875214576721,-2,1,4431,115
18318,101,0.193962336995742,id1165e00c,left_wrist,1.19689393043518,-11,-4,18307,108
18310,105,0.237363898972382,id1165e00c,left_hip,1.2112500667572,-3,0,18307,108
18308,108,0.616718072276932,id1165e00c,left_ankle,1.20762205123901,-1,-1,18307,108
18307,107,0.721943434675767,id1165e00c,right_ankle,1.21875214576721,0,1,18307,108
15713,107,0.148201620434625,id1165e00c,left_wrist,1.19689393043518,-10,-8,15703,109
15705,108,0.262160546212272,id1165e00c,left_hip,1.2112500667572,-2,-1,15703,109
15705,106,0.615362832390042,id1165e00c,left_ankle,1.20762205123901,-2,1,15703,109
15704,106,0.714743421452279,id1165e00c,right_ankle,1.21875214576721,-1,2,15703,109
5867,112,0.102561662508889,id1165e00c,left_wrist,1.19689393043518,0,-3,5867,109
5866,108,0.238871801041095,id1165e00c,left_hip,1.2112500667572,1,2,5867,109
5864,111,0.566253792567728,id1165e00c,left_ankle,1.20762205123901,3,1,5867,109
5864,110,0.632028072971814,id1165e00c,right_ankle,1.21875214576721,3,2,5867,109
10819,97,0.069261779489188,id1165e00c,left_wrist,1.19689393043518,-9,2,10810,108
10808,110,0.224985554461302,id1165e00c,left_hip,1.2112500667572,2,0,10810,108
10810,109,0.586180668939936,id1165e00c,left_ankle,1.20762205123901,0,-1,10810,108
10809,111,0.705980694084043,id1165e00c,right_ankle,1.21875214576721,1,-2,10810,108
1917,112,0.204809749346768,id1165e00c,left_wrist,1.19689393043518,1,-2,1918,109
1917,106,0.263727214790604,id1165e00c,left_hip,1.2112500667572,1,4,1918,109
1915,110,0.622503686107443,id1165e00c,left_ankle,1.20762205123901,3,2,1918,109
1918,109,0.73610421710397,id1165e00c,right_ankle,1.21875214576721,0,0,1918,109
7728,103,0.11496717301539,id1165e00c,left_wrist,1.19689393043518,-6,-1,7722,108
7721,110,0.241096357189059,id1165e00c,left_hip,1.2112500667572,1,-1,7722,108
7722,108,0.649387672114714,id1165e00c,left_ankle,1.20762205123901,0,0,7722,108
7721,110,0.691145025545365,id1165e00c,right_ankle,1.21875214576721,1,-1,7722,108
21113,104,0.124270617646219,id1165e00c,left_wrist,1.19689393043518,-6,-4,21107,106
21109,104,0.25892245354607,id1165e00c,left_hip,1.2112500667572,-2,0,21107,106
21109,105,0.72646929723322,id1165e00c,left_ankle,1.20762205123901,-2,-1,21107,106
21106,106,0.793363857173351,id1165e00c,right_ankle,1.21875214576721,1,1,21107,106
13616,96,0.110947873812371,id1165e00c,left_wrist,1.19689393043518,-5,2,13611,103
13610,106,0.272325793053848,id1165e00c,left_hip,1.2112500667572,1,-2,13611,103
13611,105,0.686603788102239,id1165e00c,left_ankle,1.20762205123901,0,-2,13611,103
13609,105,0.769172716357788,id1165e00c,right_ankle,1.21875214576721,2,0,13611,103
14015,103,0.232547097261482,id5308a7d6,left_wrist,1.21512007713318,-2,-4,14013,101
14012,103,0.29345459865225,id5308a7d6,left_hip,1.18529605865479,1,-1,14013,101
14011,103,0.715313270986013,id5308a7d6,left_ankle,1.18898892402649,2,0,14013,101
14012,101,0.758220379627547,id5308a7d6,right_ankle,1.17898607254028,1,1,14013,101
6642,108,0.173346247941737,id5308a7d6,left_wrist,1.21512007713318,-4,-4,6638,108
6638,107,0.231254034740996,id5308a7d6,left_hip,1.18529605865479,0,1,6638,108
6637,108,0.655178746131382,id5308a7d6,left_ankle,1.18898892402649,1,1,6638,108
6636,105,0.672675653237909,id5308a7d6,right_ankle,1.17898607254028,2,5,6638,108
8568,100,0.254753611850768,id5308a7d6,left_wrist,1.21512007713318,-2,-2,8566,100
8565,100,0.308507765596336,id5308a7d6,left_hip,1.18529605865479,1,1,8566,100
8564,101,0.688930556519717,id5308a7d6,left_ankle,1.18898892402649,2,1,8566,100
8564,100,0.639443287225646,id5308a7d6,right_ankle,1.17898607254028,2,2,8566,100
20869,103,0.169816058073572,id5308a7d6,left_wrist,1.21512007713318,-4,-4,20865,103
20866,101,0.260990773891307,id5308a7d6,left_hip,1.18529605865479,-1,1,20865,103
20864,102,0.785413180689041,id5308a7d6,left_ankle,1.18898892402649,1,2,20865,103
20864,102,0.694712487066735,id5308a7d6,right_ankle,1.17898607254028,1,2,20865,103
17981,101,0.266317429253688,id5308a7d6,left_wrist,1.21512007713318,-4,-4,17977,101
17977,102,0.308191392204496,id5308a7d6,left_hip,1.18529605865479,0,-1,17977,101
17976,101,0.729720245005644,id5308a7d6,left_ankle,1.18898892402649,1,1,17977,101
17977,100,0.749878554081322,id5308a7d6,right_ankle,1.17898607254028,0,1,17977,101
20076,99,0.209140232199059,id5308a7d6,left_wrist,1.21512007713318,-4,-4,20072,99
20072,100,0.30708412716197,id5308a7d6,left_hip,1.18529605865479,0,-1,20072,99
20071,98,0.79546957121306,id5308a7d6,left_ankle,1.18898892402649,1,2,20072,99
20070,102,0.718481175243443,id5308a7d6,right_ankle,1.17898607254028,2,-1,20072,99
17073,102,0.248656653327653,id5308a7d6,left_wrist,1.21512007713318,-3,-2,17070,103
17070,103,0.290983359875103,id5308a7d6,left_hip,1.18529605865479,0,0,17070,103
17069,102,0.711278057736785,id5308a7d6,left_ankle,1.18898892402649,1,2,17070,103
17067,104,0.69120455447886,id5308a7d6,right_ankle,1.17898607254028,3,2,17070,103
16553,105,0.238668866979408,id5308a7d6,left_wrist,1.21512007713318,-6,-5,16547,106
16549,105,0.240767210469062,id5308a7d6,left_hip,1.18529605865479,-2,-1,16547,106
16548,105,0.769605296874275,id5308a7d6,left_ankle,1.18898892402649,-1,0,16547,106
16545,106,0.79174366620748,id5308a7d6,right_ankle,1.17898607254028,2,2,16547,106
5721,103,0.226942499985095,id5308a7d6,left_wrist,1.21512007713318,-1,-1,5720,103
5718,103,0.281443184696357,id5308a7d6,left_hip,1.18529605865479,2,2,5720,103
5717,103,0.741918034823787,id5308a7d6,left_ankle,1.18898892402649,3,3,5720,103
5718,100,0.574071635474189,id5308a7d6,right_ankle,1.17898607254028,2,5,5720,103
16046,103,0.245489219744276,id5308a7d6,left_wrist,1.21512007713318,-5,-4,16041,104
16041,104,0.266418775211611,id5308a7d6,left_hip,1.18529605865479,0,0,16041,104
16040,104,0.778366485136727,id5308a7d6,left_ankle,1.18898892402649,1,1,16041,104
16039,104,0.709554100171193,id5308a7d6,right_ankle,1.17898607254028,2,2,16041,104
20670,100,0.210690767357629,id5308a7d6,left_wrist,1.21512007713318,-5,-3,20665,102
20666,101,0.313560336950972,id5308a7d6,left_hip,1.18529605865479,-1,0,20665,102
20665,101,0.808899855334126,id5308a7d6,left_ankle,1.18898892402649,0,1,20665,102
20665,101,0.784747844775402,id5308a7d6,right_ankle,1.17898607254028,0,1,20665,102
6232,102,0.253438096093224,id5308a7d6,left_wrist,1.21512007713318,-3,-1,6229,104
6229,102,0.288262656060336,id5308a7d6,left_hip,1.18529605865479,0,2,6229,104
6227,102,0.637955856025038,id5308a7d6,left_ankle,1.18898892402649,2,4,6229,104
6225,105,0.63183836999667,id5308a7d6,right_ankle,1.17898607254028,4,3,6229,104
8469,100,0.248001586596906,id5308a7d6,left_wrist,1.21512007713318,-1,-2,8468,99
8466,100,0.297422672896112,id5308a7d6,left_hip,1.18529605865479,2,1,8468,99
8465,100,0.828756220858295,id5308a7d6,left_ankle,1.18898892402649,3,2,8468,99
8466,99,0.738320386591932,id5308a7d6,right_ankle,1.17898607254028,2,2,8468,99
17073,102,0.248656653327653,id5308a7d6,left_wrist,1.21512007713318,-3,-2,17070,103
17070,103,0.290983359875103,id5308a7d6,left_hip,1.18529605865479,0,0,17070,103
17069,102,0.711278057736785,id5308a7d6,left_ankle,1.18898892402649,1,2,17070,103
17067,104,0.69120455447886,id5308a7d6,right_ankle,1.17898607254028,3,2,17070,103
1696,104,0.24182740167424,id5308a7d6,left_wrist,1.21512007713318,0,-3,1696,101
1694,102,0.285867501824152,id5308a7d6,left_hip,1.18529605865479,2,1,1696,101
1693,103,0.696406883377802,id5308a7d6,left_ankle,1.18898892402649,3,1,1696,101
1693,102,0.74817624090473,id5308a7d6,right_ankle,1.17898607254028,3,2,1696,101
7669,101,0.233913887322997,id5308a7d6,left_wrist,1.21512007713318,-4,-2,7665,103
7666,101,0.28156885828023,id5308a7d6,left_hip,1.18529605865479,-1,1,7665,103
7664,102,0.768928574795315,id5308a7d6,left_ankle,1.18898892402649,1,2,7665,103
7664,102,0.696281494765357,id5308a7d6,right_ankle,1.17898607254028,1,2,7665,103
9382,105,0.212080868657631,id5308a7d6,left_wrist,1.21512007713318,-2,-3,9380,104
9380,103,0.281105373343202,id5308a7d6,left_hip,1.18529605865479,0,1,9380,104
9379,102,0.722793062643726,id5308a7d6,left_ankle,1.18898892402649,1,3,9380,104
9375,106,0.572823431174363,id5308a7d6,right_ankle,1.17898607254028,5,3,9380,104
3398,101,0.239305808701544,id5308a7d6,left_wrist,1.21512007713318,-1,-2,3397,100
3395,100,0.289525432406863,id5308a7d6,left_hip,1.18529605865479,2,2,3397,100
3394,100,0.734343403547356,id5308a7d6,left_ankle,1.18898892402649,3,3,3397,100
3394,102,0.676515491678355,id5308a7d6,right_ankle,1.17898607254028,3,1,3397,100
12270,104,0.180971632351037,id5308a7d6,left_wrist,1.21512007713318,-3,-5,12267,102
12267,103,0.25358170465721,id5308a7d6,left_hip,1.18529605865479,0,-1,12267,102
12266,103,0.726189876655971,id5308a7d6,left_ankle,1.18898892402649,1,0,12267,102
12265,102,0.74542704793321,id5308a7d6,right_ankle,1.17898607254028,2,2,12267,102
20468,101,0.220995293160624,id5308a7d6,left_wrist,1.21512007713318,-3,-2,20465,102
20465,102,0.275327978345527,id5308a7d6,left_hip,1.18529605865479,0,0,20465,102
20463,102,0.778941737425097,id5308a7d6,left_ankle,1.18898892402649,2,2,20465,102
20465,100,0.665918486059291,id5308a7d6,right_ankle,1.17898607254028,0,2,20465,102
17624,110,0.303388633179158,ida61e8ddf,left_wrist,0.826615810394287,-1,-3,17623,108
17622,109,0.341298191680067,ida61e8ddf,left_hip,0.840967893600464,1,0,17623,108
17622,108,0.869373356153356,ida61e8ddf,left_ankle,0.831996917724609,1,1,17623,108
17622,110,0.846493364812757,ida61e8ddf,right_ankle,0.83033013343811,1,-1,17623,108
3207,113,0.29391220498286,ida61e8ddf,left_wrist,0.826615810394287,0,1,3207,114
3205,114,0.311691001278768,ida61e8ddf,left_hip,0.840967893600464,2,2,3207,114
3205,114,0.921655921441197,ida61e8ddf,left_ankle,0.831996917724609,2,2,3207,114
3208,110,0.716078676347153,ida61e8ddf,right_ankle,0.83033013343811,-1,3,3207,114
9745,104,0.370954997344848,ida61e8ddf,left_wrist,0.826615810394287,-1,0,9744,105
9742,105,0.404921211494024,ida61e8ddf,left_hip,0.840967893600464,2,2,9744,105
9741,106,0.8915514861923,ida61e8ddf,left_ankle,0.831996917724609,3,2,9744,105
9740,106,0.940860752008652,ida61e8ddf,right_ankle,0.83033013343811,4,3,9744,105
6841,109,0.28259066936123,ida61e8ddf,left_wrist,0.826615810394287,-2,-2,6839,109
6840,108,0.318277507139537,ida61e8ddf,left_hip,0.840967893600464,-1,0,6839,109
6842,109,0.994494281766032,ida61e8ddf,left_ankle,0.831996917724609,-3,-3,6839,109
6839,109,0.832270717097349,ida61e8ddf,right_ankle,0.83033013343811,0,0,6839,109
12098,110,0.316730584297536,ida61e8ddf,left_wrist,0.826615810394287,0,-1,12098,109
12096,111,0.353330899038823,ida61e8ddf,left_hip,0.840967893600464,2,0,12098,109
12095,111,0.993387310932141,ida61e8ddf,left_ankle,0.831996917724609,3,1,12098,109
12096,111,0.79279229316748,ida61e8ddf,right_ankle,0.83033013343811,2,0,12098,109
4877,107,0.292626733672181,ida61e8ddf,left_wrist,0.826615810394287,1,4,4878,110
4875,111,0.330093665228224,ida61e8ddf,left_hip,0.840967893600464,3,2,4878,110
4877,109,0.94572666064852,ida61e8ddf,left_ankle,0.831996917724609,1,2,4878,110
4875,111,0.857903409340238,ida61e8ddf,right_ankle,0.83033013343811,3,2,4878,110
8469,101,0.151783887589042,ida61e8ddf,left_wrist,0.826615810394287,-6,0,8463,107
8464,103,0.316806500546565,ida61e8ddf,left_hip,0.840967893600464,-1,3,8463,107
8462,106,0.691193107004951,ida61e8ddf,left_ankle,0.831996917724609,1,2,8463,107
8464,103,0.761306118991375,ida61e8ddf,right_ankle,0.83033013343811,-1,3,8463,107
3207,113,0.29391220498286,ida61e8ddf,left_wrist,0.826615810394287,0,1,3207,114
3205,114,0.311691001278768,ida61e8ddf,left_hip,0.840967893600464,2,2,3207,114
3205,114,0.921655921441197,ida61e8ddf,left_ankle,0.831996917724609,2,2,3207,114
3208,110,0.716078676347153,ida61e8ddf,right_ankle,0.83033013343811,-1,3,3207,114
6625,110,0.299799760883876,ida61e8ddf,left_wrist,0.826615810394287,-2,-1,6623,111
6622,110,0.342361392900779,ida61e8ddf,left_hip,0.840967893600464,1,2,6623,111
6622,110,0.987170732271374,ida61e8ddf,left_ankle,0.831996917724609,1,2,6623,111
6622,109,0.886075615957516,ida61e8ddf,right_ankle,0.83033013343811,1,3,6623,111
12975,109,0.252118842666992,ida61e8ddf,left_wrist,0.826615810394287,-2,-1,12973,110
12971,110,0.333585766330664,ida61e8ddf,left_hip,0.840967893600464,2,2,12973,110
12972,108,0.842528744187226,ida61e8ddf,left_ankle,0.831996917724609,1,3,12973,110
12971,109,0.914080053650146,ida61e8ddf,right_ankle,0.83033013343811,2,3,12973,110
8676,107,0.309475786273423,ida61e8ddf,left_wrist,0.826615810394287,0,-1,8676,106
8673,108,0.346060948538646,ida61e8ddf,left_hip,0.840967893600464,3,1,8676,106
8673,108,0.943439723489877,ida61e8ddf,left_ankle,0.831996917724609,3,1,8676,106
8672,108,0.895239544619827,ida61e8ddf,right_ankle,0.83033013343811,4,2,8676,106
1204,109,0.306170332026111,ida61e8ddf,left_wrist,0.826615810394287,1,1,1205,109
1203,109,0.292339617347142,ida61e8ddf,left_hip,0.840967893600464,2,2,1205,109
1203,109,0.982890986596801,ida61e8ddf,left_ankle,0.831996917724609,2,2,1205,109
1203,108,0.784476631141627,ida61e8ddf,right_ankle,0.83033013343811,2,3,1205,109
14042,110,0.313838789792789,ida61e8ddf,left_wrist,0.826615810394287,0,-3,14042,107
14040,107,0.398245340768087,ida61e8ddf,left_hip,0.840967893600464,2,2,14042,107
14043,104,0.819896348992413,ida61e8ddf,left_ankle,0.831996917724609,-1,2,14042,107
14038,111,0.823223912889722,ida61e8ddf,right_ankle,0.83033013343811,4,0,14042,107
7587,107,0.329904541743615,ida61e8ddf,left_wrist,0.826615810394287,1,2,7588,108
7587,106,0.369243607750678,ida61e8ddf,left_hip,0.840967893600464,1,3,7588,108
7586,106,0.88665382520413,ida61e8ddf,left_ankle,0.831996917724609,2,4,7588,108
7585,108,0.874016774284305,ida61e8ddf,right_ankle,0.83033013343811,3,3,7588,108
17517,108,0.337350619721231,ida61e8ddf,left_wrist,0.826615810394287,-1,-1,17516,108
17515,108,0.387622113619712,ida61e8ddf,left_hip,0.840967893600464,1,1,17516,108
17515,108,0.953915337402598,ida61e8ddf,left_ankle,0.831996917724609,1,1,17516,108
17515,108,0.883641827419515,ida61e8ddf,right_ankle,0.83033013343811,1,1,17516,108
5202,110,0.267160411184472,ida61e8ddf,left_wrist,0.826615810394287,0,0,5202,110
5201,110,0.294754104044111,ida61e8ddf,left_hip,0.840967893600464,1,1,5202,110
5201,109,0.905784731920065,ida61e8ddf,left_ankle,0.831996917724609,1,2,5202,110
5201,110,0.86176088541601,ida61e8ddf,right_ankle,0.83033013343811,1,1,5202,110
15225,108,0.360286974019295,ida61e8ddf,left_wrist,0.826615810394287,-3,-3,15222,108
15220,110,0.359949052931208,ida61e8ddf,left_hip,0.840967893600464,2,0,15222,108
15220,109,0.932300686616338,ida61e8ddf,left_ankle,0.831996917724609,2,1,15222,108
15219,111,0.875919172467771,ida61e8ddf,right_ankle,0.83033013343811,3,0,15222,108
1637,111,0.284469171763535,ida61e8ddf,left_wrist,0.826615810394287,1,1,1638,111
1637,111,0.298636093423224,ida61e8ddf,left_hip,0.840967893600464,1,1,1638,111
1637,110,0.916393478194222,ida61e8ddf,left_ankle,0.831996917724609,1,2,1638,111
1637,111,0.796699691629757,ida61e8ddf,right_ankle,0.83033013343811,1,1,1638,111
15770,108,0.340535289947106,ida61e8ddf,left_wrist,0.826615810394287,-3,-3,15767,108
15765,109,0.396734850545959,ida61e8ddf,left_hip,0.840967893600464,2,1,15767,108
15766,108,0.888934627696102,ida61e8ddf,left_ankle,0.831996917724609,1,1,15767,108
15764,110,0.888514347295038,ida61e8ddf,right_ankle,0.83033013343811,3,1,15767,108
8569,108,0.266242859042509,ida61e8ddf,left_wrist,0.826615810394287,0,0,8569,108
8566,108,0.364279068081392,ida61e8ddf,left_hip,0.840967893600464,3,3,8569,108
8567,107,0.853263580145583,ida61e8ddf,left_ankle,0.831996917724609,2,3,8569,108
8566,107,0.863163674568658,ida61e8ddf,right_ankle,0.83033013343811,3,4,8569,108
1983,102,0.233927308971011,id9603e9c3,left_wrist,0.880231142044067,-2,-3,1981,101
1983,101,0.341282569852101,id9603e9c3,left_hip,0.907907962799072,-2,-2,1981,101
1981,102,0.833731451131568,id9603e9c3,left_ankle,0.890710830688477,0,-1,1981,101
1981,101,0.769086802697474,id9603e9c3,right_ankle,0.896207809448242,0,0,1981,101
5942,102,0.314071967757413,id9603e9c3,left_wrist,0.880231142044067,-1,-2,5941,101
5943,100,0.386119847244613,id9603e9c3,left_hip,0.907907962799072,-2,-1,5941,101
5942,100,0.780242939744716,id9603e9c3,left_ankle,0.890710830688477,-1,0,5941,101
5940,102,0.809934269847569,id9603e9c3,right_ankle,0.896207809448242,1,0,5941,101
14785,97,0.3828383657077,id9603e9c3,left_wrist,0.880231142044067,-4,-3,14781,98
14784,97,0.459720307790167,id9603e9c3,left_hip,0.907907962799072,-3,-2,14781,98
14783,97,0.887628173481876,id9603e9c3,left_ankle,0.890710830688477,-2,-1,14781,98
14780,98,0.854074596854182,id9603e9c3,right_ankle,0.896207809448242,1,1,14781,98
4942,102,0.251687745139027,id9603e9c3,left_wrist,0.880231142044067,-1,-1,4941,102
4942,101,0.33165220306253,id9603e9c3,left_hip,0.907907962799072,-1,0,4941,102
4940,102,0.839618516438146,id9603e9c3,left_ankle,0.890710830688477,1,1,4941,102
4940,99,0.643530659132102,id9603e9c3,right_ankle,0.896207809448242,1,4,4941,102
10349,100,0.314263841121291,id9603e9c3,left_wrist,0.880231142044067,-2,-1,10347,101
10349,100,0.383510164173899,id9603e9c3,left_hip,0.907907962799072,-2,-1,10347,101
10348,100,0.790553037785453,id9603e9c3,left_ankle,0.890710830688477,-1,0,10347,101
10346,102,0.783087325677214,id9603e9c3,right_ankle,0.896207809448242,1,0,10347,101
14785,97,0.3828383657077,id9603e9c3,left_wrist,0.880231142044067,-4,-3,14781,98
14784,97,0.459720307790167,id9603e9c3,left_hip,0.907907962799072,-3,-2,14781,98
14783,97,0.887628173481876,id9603e9c3,left_ankle,0.890710830688477,-2,-1,14781,98
14780,98,0.854074596854182,id9603e9c3,right_ankle,0.896207809448242,1,1,14781,98
1299,98,0.257474212208382,id9603e9c3,left_wrist,0.880231142044067,-3,-1,1296,100
1296,101,0.346512205911334,id9603e9c3,left_hip,0.907907962799072,0,-1,1296,100
1296,99,0.757425220309088,id9603e9c3,left_ankle,0.890710830688477,0,1,1296,100
1295,97,0.721341788123729,id9603e9c3,right_ankle,0.896207809448242,1,4,1296,100
12443,102,0.290387943468366,id9603e9c3,left_wrist,0.880231142044067,-2,-4,12441,100
12443,101,0.419427672892609,id9603e9c3,left_hip,0.907907962799072,-2,-3,12441,100
12442,100,0.85562804040389,id9603e9c3,left_ankle,0.890710830688477,-1,-1,12441,100
12441,101,0.809474868735761,id9603e9c3,right_ankle,0.896207809448242,0,-1,12441,100
12343,101,0.34538105339959,id9603e9c3,left_wrist,0.880231142044067,-1,-2,12342,100
12344,100,0.437645514212339,id9603e9c3,left_hip,0.907907962799072,-2,-2,12342,100
12342,101,0.795245384328982,id9603e9c3,left_ankle,0.890710830688477,0,-1,12342,100
12341,101,0.752273692447163,id9603e9c3,right_ankle,0.896207809448242,1,0,12342,100
8149,101,0.28996243616251,id9603e9c3,left_wrist,0.880231142044067,-2,-1,8147,102
8148,102,0.353256234732497,id9603e9c3,left_hip,0.907907962799072,-1,-1,8147,102
8147,102,0.782863892774254,id9603e9c3,left_ankle,0.890710830688477,0,0,8147,102
8148,101,0.751411252378847,id9603e9c3,right_ankle,0.896207809448242,-1,0,8147,102
7740,103,0.271741834794353,id9603e9c3,left_wrist,0.880231142044067,-2,-2,7738,103
7740,103,0.328603010242059,id9603e9c3,left_hip,0.907907962799072,-2,-2,7738,103
7738,103,0.704569209885231,id9603e9c3,left_ankle,0.890710830688477,0,0,7738,103
7738,102,0.668638481326455,id9603e9c3,right_ankle,0.896207809448242,0,1,7738,103
9952,99,0.364576298482119,id9603e9c3,left_wrist,0.880231142044067,-4,-3,9948,100
9952,98,0.390330765371252,id9603e9c3,left_hip,0.907907962799072,-4,-2,9948,100
9949,101,0.762090441378483,id9603e9c3,left_ankle,0.890710830688477,-1,-2,9948,100
9949,99,0.719847738931734,id9603e9c3,right_ankle,0.896207809448242,-1,0,9948,100
16415,99,0.362635019779305,id9603e9c3,left_wrist,0.880231142044067,-3,-4,16412,98
16414,98,0.434861293819748,id9603e9c3,left_hip,0.907907962799072,-2,-2,16412,98
16414,97,0.838791273195233,id9603e9c3,left_ankle,0.890710830688477,-2,-1,16412,98
16411,97,0.84510625297453,id9603e9c3,right_ankle,0.896207809448242,1,2,16412,98
4155,100,0.260100088938967,id9603e9c3,left_wrist,0.880231142044067,-3,-1,4152,102
4154,100,0.375040512924964,id9603e9c3,left_hip,0.907907962799072,-2,0,4152,102
4153,101,0.748057310151889,id9603e9c3,left_ankle,0.890710830688477,-1,0,4152,102
4153,99,0.757660712879932,id9603e9c3,right_ankle,0.896207809448242,-1,2,4152,102
3956,102,0.285640299708978,id9603e9c3,left_wrist,0.880231142044067,-1,-2,3955,101
3955,102,0.344314369980246,id9603e9c3,left_hip,0.907907962799072,0,-1,3955,101
3954,101,0.828368275420495,id9603e9c3,left_ankle,0.890710830688477,1,1,3955,101
3954,100,0.76753894875293,id9603e9c3,right_ankle,0.896207809448242,1,2,3955,101
7541,99,0.279149852978511,id9603e9c3,left_wrist,0.880231142044067,-2,-2,7539,99
7541,97,0.362577256410752,id9603e9c3,left_hip,0.907907962799072,-2,0,7539,99
7539,100,0.80385906859364,id9603e9c3,left_ankle,0.890710830688477,0,-1,7539,99
7538,99,0.799188453773037,id9603e9c3,right_ankle,0.896207809448242,1,1,7539,99
5942,102,0.314071967757413,id9603e9c3,left_wrist,0.880231142044067,-1,-2,5941,101
5943,100,0.386119847244613,id9603e9c3,left_hip,0.907907962799072,-2,-1,5941,101
5942,100,0.780242939744716,id9603e9c3,left_ankle,0.890710830688477,-1,0,5941,101
5940,102,0.809934269847569,id9603e9c3,right_ankle,0.896207809448242,1,0,5941,101
15264,98,0.379279366851497,id9603e9c3,left_wrist,0.880231142044067,-3,-4,15261,97
15262,98,0.444813371439564,id9603e9c3,left_hip,0.907907962799072,-1,-2,15261,97
15261,97,0.875211789484481,id9603e9c3,left_ankle,0.890710830688477,0,0,15261,97
15259,97,0.807119220685054,id9603e9c3,right_ankle,0.896207809448242,2,2,15261,97
3165,100,0.274671527469927,id9603e9c3,left_wrist,0.880231142044067,-2,-1,3163,101
3164,101,0.338084991220054,id9603e9c3,left_hip,0.907907962799072,-1,-1,3163,101
3163,100,0.758869207506312,id9603e9c3,left_ankle,0.890710830688477,0,1,3163,101
3163,100,0.748150419142896,id9603e9c3,right_ankle,0.896207809448242,0,1,3163,101
8762,100,0.30689905092285,id9603e9c3,left_wrist,0.880231142044067,-5,-2,8757,103
8761,102,0.389555312925274,id9603e9c3,left_hip,0.907907962799072,-4,-3,8757,103
8759,101,0.77116405399646,id9603e9c3,left_ankle,0.890710830688477,-2,0,8757,103
8758,102,0.753264257924059,id9603e9c3,right_ankle,0.896207809448242,-1,0,8757,103
6698,86,0.195746546567177,idfc5f05e4,left_wrist,0.80348801612854,2,1,6700,85
6699,85,0.282860423894986,idfc5f05e4,left_hip,0.795062065124512,1,1,6700,85
6695,87,0.922494578760454,idfc5f05e4,left_ankle,0.789574861526489,5,3,6700,85
6697,84,0.8164240720757,idfc5f05e4,right_ankle,0.798737049102783,3,4,6700,85
8870,85,0.218040205354773,idfc5f05e4,left_wrist,0.80348801612854,0,0,8870,85
8870,86,0.315509473207738,idfc5f05e4,left_hip,0.795062065124512,0,-1,8870,85
8871,84,0.935298367713485,idfc5f05e4,left_ankle,0.789574861526489,-1,0,8870,85
8869,83,0.931212160711359,idfc5f05e4,right_ankle,0.798737049102783,1,3,8870,85
10210,84,0.18034145417894,idfc5f05e4,left_wrist,0.80348801612854,1,1,10211,84
10212,84,0.290987881857818,idfc5f05e4,left_hip,0.795062065124512,-1,-1,10211,84
10208,87,0.970689800021167,idfc5f05e4,left_ankle,0.789574861526489,3,0,10211,84
10209,80,0.826966332788632,idfc5f05e4,right_ankle,0.798737049102783,2,6,10211,84
15296,85,0.25919434773583,idfc5f05e4,left_wrist,0.80348801612854,42,41,15338,84
15338,84,0.31653004894436,idfc5f05e4,left_hip,0.795062065124512,0,0,15338,84
15337,84,0.957626085966643,idfc5f05e4,left_ankle,0.789574861526489,1,1,15338,84
15334,87,0.947347609038687,idfc5f05e4,right_ankle,0.798737049102783,4,1,15338,84
3641,89,0.177241984980226,idfc5f05e4,left_wrist,0.80348801612854,2,0,3643,87
3642,87,0.276096070008165,idfc5f05e4,left_hip,0.795062065124512,1,1,3643,87
3640,89,0.966296689137793,idfc5f05e4,left_ankle,0.789574861526489,3,1,3643,87
3642,87,0.88950514490938,idfc5f05e4,right_ankle,0.798737049102783,1,1,3643,87
3815,88,0.176337448614796,idfc5f05e4,left_wrist,0.80348801612854,1,0,3816,87
3814,88,0.251073894842357,idfc5f05e4,left_hip,0.795062065124512,2,1,3816,87
3813,88,0.915491352940079,idfc5f05e4,left_ankle,0.789574861526489,3,2,3816,87
3814,89,0.857195595527002,idfc5f05e4,right_ankle,0.798737049102783,2,0,3816,87
12450,83,0.194437771635887,idfc5f05e4,left_wrist,0.80348801612854,0,1,12450,84
12452,83,0.317951703494675,idfc5f05e4,left_hip,0.795062065124512,-2,-1,12450,84
12449,84,0.957329872433269,idfc5f05e4,left_ankle,0.789574861526489,1,1,12450,84
12448,83,0.827458639957223,idfc5f05e4,right_ankle,0.798737049102783,2,3,12450,84
12950,84,0.216129880948385,idfc5f05e4,left_wrist,0.80348801612854,0,-1,12950,83
12952,83,0.352709344415366,idfc5f05e4,left_hip,0.795062065124512,-2,-2,12950,83
12950,83,1.00122552717514,idfc5f05e4,left_ankle,0.789574861526489,0,0,12950,83
12949,80,0.838542970642759,idfc5f05e4,right_ankle,0.798737049102783,1,4,12950,83
1923,89,0.223832498854489,idfc5f05e4,left_wrist,0.80348801612854,3,2,1926,88
1923,88,0.301391747582933,idfc5f05e4,left_hip,0.795062065124512,3,3,1926,88
1921,89,0.852296026921086,idfc5f05e4,left_ankle,0.789574861526489,5,4,1926,88
1924,87,0.906960473634995,idfc5f05e4,right_ankle,0.798737049102783,2,3,1926,88
15006,84,0.182528146105158,idfc5f05e4,left_wrist,0.80348801612854,1,0,15007,83
15008,83,0.345747734142901,idfc5f05e4,left_hip,0.795062065124512,-1,-1,15007,83
15007,79,0.803695316721146,idfc5f05e4,left_ankle,0.789574861526489,0,4,15007,83
15005,85,0.964376658064343,idfc5f05e4,right_ankle,0.798737049102783,2,0,15007,83
2436,86,0.249107909839851,idfc5f05e4,left_wrist,0.80348801612854,4,2,2440,84
2438,85,0.319707553596663,idfc5f05e4,left_hip,0.795062065124512,2,1,2440,84
2434,90,0.949367758672186,idfc5f05e4,left_ankle,0.789574861526489,6,0,2440,84
2436,86,0.925343949904273,idfc5f05e4,right_ankle,0.798737049102783,4,2,2440,84
2350,87,0.190333765634312,idfc5f05e4,left_wrist,0.80348801612854,4,4,2354,87
2353,86,0.304823028190437,idfc5f05e4,left_hip,0.795062065124512,1,2,2354,87
2352,83,0.786573864847454,idfc5f05e4,left_ankle,0.789574861526489,2,6,2354,87
2352,85,0.841715321716249,idfc5f05e4,right_ankle,0.798737049102783,2,4,2354,87
14432,83,0.185273489889212,idfc5f05e4,left_wrist,0.80348801612854,0,1,14432,84
14434,84,0.37679788463144,idfc5f05e4,left_hip,0.795062065124512,-2,-2,14432,84
14431,84,0.976475891547701,idfc5f05e4,left_ankle,0.789574861526489,1,1,14432,84
14430,84,0.950751109965145,idfc5f05e4,right_ankle,0.798737049102783,2,2,14432,84
8047,82,0.146714033800279,idfc5f05e4,left_wrist,0.80348801612854,-1,1,8046,84
8048,84,0.322786560929848,idfc5f05e4,left_hip,0.795062065124512,-2,-2,8046,84
8046,80,0.852721574881341,idfc5f05e4,left_ankle,0.789574861526489,0,4,8046,84
8043,83,0.954430809307834,idfc5f05e4,right_ankle,0.798737049102783,3,4,8046,84
2436,86,0.249107909839851,idfc5f05e4,left_wrist,0.80348801612854,4,2,2440,84
2438,85,0.319707553596663,idfc5f05e4,left_hip,0.795062065124512,2,1,2440,84
2434,90,0.949367758672186,idfc5f05e4,left_ankle,0.789574861526489,6,0,2440,84
2436,86,0.925343949904273,idfc5f05e4,right_ankle,0.798737049102783,4,2,2440,84
5447,85,0.16547730347105,idfc5f05e4,left_wrist,0.80348801612854,-1,0,5446,86
5447,85,0.265986994353205,idfc5f05e4,left_hip,0.795062065124512,-1,0,5446,86
5444,85,0.925954423420659,idfc5f05e4,left_ankle,0.789574861526489,2,3,5446,86
5445,85,0.907121143763079,idfc5f05e4,right_ankle,0.798737049102783,1,2,5446,86
10293,82,0.20069998398691,idfc5f05e4,left_wrist,0.80348801612854,1,2,10294,83
10295,82,0.319837008320205,idfc5f05e4,left_hip,0.795062065124512,-1,0,10294,83
10294,82,0.866087024888243,idfc5f05e4,left_ankle,0.789574861526489,0,1,10294,83
10288,83,0.936723841357837,idfc5f05e4,right_ankle,0.798737049102783,6,6,10294,83
4931,87,0.206914362339349,idfc5f05e4,left_wrist,0.80348801612854,1,1,4932,87
4930,86,0.28380840056977,idfc5f05e4,left_hip,0.795062065124512,2,3,4932,87
4929,87,0.806170488666131,idfc5f05e4,left_ankle,0.789574861526489,3,3,4932,87
4928,88,0.875094828933103,idfc5f05e4,right_ankle,0.798737049102783,4,3,4932,87
5531,85,0.198714609872123,idfc5f05e4,left_wrist,0.80348801612854,0,0,5531,85
5531,87,0.286947895805745,idfc5f05e4,left_hip,0.795062065124512,0,-2,5531,85
5528,85,0.858214993236476,idfc5f05e4,left_ankle,0.789574861526489,3,3,5531,85
5529,86,0.842160790935156,idfc5f05e4,right_ankle,0.798737049102783,2,1,5531,85
2350,87,0.190333765634312,idfc5f05e4,left_wrist,0.80348801612854,4,4,2354,87
2353,86,0.304823028190437,idfc5f05e4,left_hip,0.795062065124512,1,2,2354,87
2352,83,0.786573864847454,idfc5f05e4,left_ankle,0.789574861526489,2,6,2354,87
2352,85,0.841715321716249,idfc5f05e4,right_ankle,0.798737049102783,2,4,2354,87
15149,100,0.303180522888237,idf540d82b,left_wrist,1.40293788909912,12,10,15161,98
15155,98,0.273071579275322,idf540d82b,left_hip,1.43067979812622,6,6,15161,98
15150,99,0.521290478858374,idf540d82b,left_ankle,1.41204309463501,11,10,15161,98
15150,101,0.472309484773037,idf540d82b,right_ankle,1.42493200302124,11,8,15161,98
4326,99,0.317104735966772,idf540d82b,left_wrist,1.40293788909912,10,12,4336,101
4334,96,0.275183128246702,idf540d82b,left_hip,1.43067979812622,2,7,4336,101
4326,101,0.545662382695564,idf540d82b,left_ankle,1.41204309463501,10,10,4336,101
4326,101,0.468180194068757,idf540d82b,right_ankle,1.42493200302124,10,10,4336,101
21901,97,0.343276926783098,idf540d82b,left_wrist,1.40293788909912,4,6,21905,99
21906,96,0.342690136036038,idf540d82b,left_hip,1.43067979812622,-1,2,21905,99
21899,98,0.662754713409746,idf540d82b,left_ankle,1.41204309463501,6,7,21905,99
21898,97,0.607712272932817,idf540d82b,right_ankle,1.42493200302124,7,9,21905,99
20554,100,0.325743001284796,idf540d82b,left_wrist,1.40293788909912,11,4,20565,93
20561,100,0.368238189446328,idf540d82b,left_hip,1.43067979812622,4,-3,20565,93
20555,97,0.645198163261214,idf540d82b,left_ankle,1.41204309463501,10,6,20565,93
20553,99,0.479474013956681,idf540d82b,right_ankle,1.42493200302124,12,6,20565,93
21664,98,0.342906617763187,idf540d82b,left_wrist,1.40293788909912,49,47,21713,96
21716,95,0.371132937896195,idf540d82b,left_hip,1.43067979812622,-3,-2,21713,96
21706,97,0.59325228794073,idf540d82b,left_ankle,1.41204309463501,7,6,21713,96
21706,97,0.581973721562859,idf540d82b,right_ankle,1.42493200302124,7,6,21713,96
16609,96,0.329263536440821,idf540d82b,left_wrist,1.40293788909912,3,5,16612,98
16614,96,0.343241297760253,idf540d82b,left_hip,1.43067979812622,-2,0,16612,98
16605,98,0.64974641872389,idf540d82b,left_ankle,1.41204309463501,7,7,16612,98
16605,98,0.549628322116119,idf540d82b,right_ankle,1.42493200302124,7,7,16612,98
8621,52,0.096582503366764,idf540d82b,left_wrist,1.40293788909912,-36,11,8585,99
8581,96,0.263309135306658,idf540d82b,left_hip,1.43067979812622,4,7,8585,99
8574,100,0.466513328814239,idf540d82b,left_ankle,1.41204309463501,11,10,8585,99
8575,98,0.507393635483527,idf540d82b,right_ankle,1.42493200302124,10,11,8585,99
17949,50,0.106695765344634,idf540d82b,left_wrist,1.40293788909912,4,50,17953,96
17955,94,0.390260109493949,idf540d82b,left_hip,1.43067979812622,-2,0,17953,96
17947,96,0.604946084936505,idf540d82b,left_ankle,1.41204309463501,6,6,17953,96
17947,94,0.641200146496332,idf540d82b,right_ankle,1.42493200302124,6,8,17953,96
372,95,0.246055772974423,idf540d82b,left_wrist,1.40293788909912,-46,-41,326,100
322,98,0.29924349421839,idf540d82b,left_hip,1.43067979812622,4,6,326,100
316,98,0.585605998707144,idf540d82b,left_ankle,1.41204309463501,10,12,326,100
317,98,0.532204760676185,idf540d82b,right_ankle,1.42493200302124,9,11,326,100
21664,98,0.342906617763187,idf540d82b,left_wrist,1.40293788909912,49,51,21713,100
21716,95,0.371132937896195,idf540d82b,left_hip,1.43067979812622,-3,2,21713,100
21706,97,0.59325228794073,idf540d82b,left_ankle,1.41204309463501,7,10,21713,100
21706,97,0.581973721562859,idf540d82b,right_ankle,1.42493200302124,7,10,21713,100
22759,100,0.312520522741278,idf540d82b,left_wrist,1.40293788909912,12,9,22771,97
22768,97,0.297211749310223,idf540d82b,left_hip,1.43067979812622,3,3,22771,97
22761,98,0.588655739372969,idf540d82b,left_ankle,1.41204309463501,10,9,22771,97
22760,99,0.552886373583567,idf540d82b,right_ankle,1.42493200302124,11,9,22771,97
8280,99,0.259372124671043,idf540d82b,left_wrist,1.40293788909912,9,6,8289,96
8286,100,0.280743776572276,idf540d82b,left_hip,1.43067979812622,3,-1,8289,96
8281,97,0.597076282076071,idf540d82b,left_ankle,1.41204309463501,8,7,8289,96
8280,98,0.526280920866753,idf540d82b,right_ankle,1.42493200302124,9,7,8289,96
17185,97,0.338491048582402,idf540d82b,left_wrist,1.40293788909912,4,7,17189,100
17190,98,0.349593417241297,idf540d82b,left_hip,1.43067979812622,-1,1,17189,100
17183,96,0.566005465236625,idf540d82b,left_ankle,1.41204309463501,6,10,17189,100
17182,101,0.66340972217358,idf540d82b,right_ankle,1.42493200302124,7,6,17189,100
18233,96,0.321150737404701,idf540d82b,left_wrist,1.40293788909912,2,3,18235,97
18237,98,0.357257262019024,idf540d82b,left_hip,1.43067979812622,-2,-3,18235,97
18229,97,0.675117981350861,idf540d82b,left_ankle,1.41204309463501,6,6,18235,97
18232,95,0.618611746616827,idf540d82b,right_ankle,1.42493200302124,3,5,18235,97
16216,97,0.238814200110313,idf540d82b,left_wrist,1.40293788909912,8,10,16224,99
16222,97,0.319582615303061,idf540d82b,left_hip,1.43067979812622,2,4,16224,99
16213,99,0.531951620206021,idf540d82b,left_ankle,1.41204309463501,11,11,16224,99
16211,101,0.592665947226575,idf540d82b,right_ankle,1.42493200302124,13,11,16224,99
11098,95,0.321879206768583,idf540d82b,left_wrist,1.40293788909912,5,7,11103,97
11102,95,0.320763481594697,idf540d82b,left_hip,1.43067979812622,1,3,11103,97
11093,97,0.533400306549859,idf540d82b,left_ankle,1.41204309463501,10,10,11103,97
11095,95,0.602499730922404,idf540d82b,right_ankle,1.42493200302124,8,10,11103,97
11382,101,0.292785060319941,idf540d82b,left_wrist,1.40293788909912,7,3,11389,97
11388,99,0.332909833247217,idf540d82b,left_hip,1.43067979812622,1,-1,11389,97
11382,94,0.621665438094298,idf540d82b,left_ankle,1.41204309463501,7,10,11389,97
11382,94,0.552165756167927,idf540d82b,right_ankle,1.42493200302124,7,10,11389,97
7091,101,0.264532402963384,idf540d82b,left_wrist,1.40293788909912,16,15,7107,100
7099,102,0.258997022526193,idf540d82b,left_hip,1.43067979812622,8,6,7107,100
7096,100,0.51893768957019,idf540d82b,left_ankle,1.41204309463501,11,11,7107,100
7094,102,0.474754059023499,idf540d82b,right_ankle,1.42493200302124,13,11,7107,100
15922,98,0.283354322633213,idf540d82b,left_wrist,1.40293788909912,10,8,15932,96
15927,99,0.273025639919296,idf540d82b,left_hip,1.43067979812622,5,2,15932,96
15921,97,0.549743055541926,idf540d82b,left_ankle,1.41204309463501,11,10,15932,96
15922,97,0.530453268936994,idf540d82b,right_ankle,1.42493200302124,10,9,15932,96
18909,95,0.403394575528454,idf540d82b,left_wrist,1.40293788909912,4,7,18913,98
18913,95,0.362901014719772,idf540d82b,left_hip,1.43067979812622,0,3,18913,98
18902,98,0.595458852887819,idf540d82b,left_ankle,1.41204309463501,11,11,18913,98
18906,94,0.547385376137703,idf540d82b,right_ankle,1.42493200302124,7,11,18913,98
7970,93,0.196371263490886,idb221f542,left_wrist,1.14370608329773,-2,-2,7968,93
7977,95,0.250849722182738,idb221f542,left_hip,0.927685022354126,-9,-11,7968,93
7967,93,0.763633501413425,idb221f542,left_ankle,0.957937955856323,1,1,7968,93
7971,94,0.779536264347463,idb221f542,right_ankle,0.931617021560669,-3,-4,7968,93
9417,97,0.283450210110775,idb221f542,left_wrist,1.14370608329773,-3,-3,9414,97
9422,97,0.321724947358491,idb221f542,left_hip,0.927685022354126,-8,-8,9414,97
9413,100,0.873194310366504,idb221f542,left_ankle,0.957937955856323,1,-2,9414,97
9416,98,0.792623419845735,idb221f542,right_ankle,0.931617021560669,-2,-3,9414,97
12125,99,0.235371967595181,idb221f542,left_wrist,1.14370608329773,-1,-2,12124,98
12131,98,0.289439301297529,idb221f542,left_hip,0.927685022354126,-7,-7,12124,98
12122,99,0.760276534782622,idb221f542,left_ankle,0.957937955856323,2,1,12124,98
12126,99,0.838162526066608,idb221f542,right_ankle,0.931617021560669,-2,-3,12124,98
2710,100,0.228050826602172,idb221f542,left_wrist,1.14370608329773,-4,-3,2706,101
2706,100,0.286351905632567,idb221f542,left_hip,0.927685022354126,0,1,2706,101
2706,100,0.790264757919758,idb221f542,left_ankle,0.957937955856323,0,1,2706,101
2704,99,0.826906500356738,idb221f542,right_ankle,0.931617021560669,2,4,2706,101
6321,99,0.257730198034565,idb221f542,left_wrist,1.14370608329773,-2,-2,6319,99
6326,98,0.310524778350816,idb221f542,left_hip,0.927685022354126,-7,-6,6319,99
6319,98,0.791062298650398,idb221f542,left_ankle,0.957937955856323,0,1,6319,99
6321,98,0.812990402126938,idb221f542,right_ankle,0.931617021560669,-2,-1,6319,99
7488,98,0.29126477410729,idb221f542,left_wrist,1.14370608329773,-1,-1,7487,98
7488,98,0.304142296881444,idb221f542,left_hip,0.927685022354126,-1,-1,7487,98
7486,97,0.795498162943052,idb221f542,left_ankle,0.957937955856323,1,2,7487,98
7486,97,0.840313042874908,idb221f542,right_ankle,0.931617021560669,1,2,7487,98
1628,100,0.189642516906278,idb221f542,left_wrist,1.14370608329773,-2,-3,1626,99
1625,100,0.269872975122649,idb221f542,left_hip,0.927685022354126,1,0,1626,99
1624,99,0.685467065063468,idb221f542,left_ankle,0.957937955856323,2,2,1626,99
1624,99,0.801326389506154,idb221f542,right_ankle,0.931617021560669,2,2,1626,99
17010,100,0.302047193946244,idb221f542,left_wrist,1.14370608329773,-3,-3,17007,100
17013,100,0.340174025044615,idb221f542,left_hip,0.927685022354126,-6,-6,17007,100
17008,101,0.834498306648898,idb221f542,left_ankle,0.957937955856323,-1,-2,17007,100
17009,99,0.801334131265969,idb221f542,right_ankle,0.931617021560669,-2,-1,17007,100
15347,99,0.313185117102102,idb221f542,left_wrist,1.14370608329773,-3,-3,15344,99
15352,97,0.320878451634574,idb221f542,left_hip,0.927685022354126,-8,-6,15344,99
15346,100,0.782177224761206,idb221f542,left_ankle,0.957937955856323,-2,-3,15344,99
15346,100,0.829105993960876,idb221f542,right_ankle,0.931617021560669,-2,-3,15344,99
16029,100,0.292712095472068,idb221f542,left_wrist,1.14370608329773,-2,-3,16027,99
16033,99,0.32980167924088,idb221f542,left_hip,0.927685022354126,-6,-6,16027,99
16028,100,0.764736686206978,idb221f542,left_ankle,0.957937955856323,-1,-2,16027,99
16029,99,0.769559263688163,idb221f542,right_ankle,0.931617021560669,-2,-2,16027,99
17109,98,0.303243558956316,idb221f542,left_wrist,1.14370608329773,-3,-2,17106,99
17112,99,0.328473374328165,idb221f542,left_hip,0.927685022354126,-6,-6,17106,99
17108,98,0.758940953437404,idb221f542,left_ankle,0.957937955856323,-2,-1,17106,99
17107,100,0.802617903731395,idb221f542,right_ankle,0.931617021560669,-1,-2,17106,99
1431,99,0.185178585139277,idb221f542,left_wrist,1.14370608329773,-3,-3,1428,99
1429,97,0.282387764374073,idb221f542,left_hip,0.927685022354126,-1,1,1428,99
1427,99,0.761372441693163,idb221f542,left_ankle,0.957937955856323,1,1,1428,99
1426,102,0.849588720426429,idb221f542,right_ankle,0.931617021560669,2,-1,1428,99
7005,96,0.259082679242444,idb221f542,left_wrist,1.14370608329773,-2,-1,7003,97
7009,98,0.299847441571459,idb221f542,left_hip,0.927685022354126,-6,-7,7003,97
7002,98,0.798949733825067,idb221f542,left_ankle,0.957937955856323,1,0,7003,97
7004,99,0.837223483053936,idb221f542,right_ankle,0.931617021560669,-1,-3,7003,97
9899,99,0.29524732663455,idb221f542,left_wrist,1.14370608329773,-2,-2,9897,99
9905,97,0.299440637175117,idb221f542,left_hip,0.927685022354126,-8,-6,9897,99
9897,98,0.830120083643769,idb221f542,left_ankle,0.957937955856323,0,1,9897,99
9899,99,0.829147061719535,idb221f542,right_ankle,0.931617021560669,-2,-2,9897,99
2021,100,0.175814624715917,idb221f542,left_wrist,1.14370608329773,-3,-3,2018,100
2018,99,0.295949588859149,idb221f542,left_hip,0.927685022354126,0,1,2018,100
2016,101,0.748372969781112,idb221f542,left_ankle,0.957937955856323,2,1,2018,100
2016,100,0.799437316146998,idb221f542,right_ankle,0.931617021560669,2,2,2018,100
14664,99,0.325581833567623,idb221f542,left_wrist,1.14370608329773,-2,-2,14662,99
14667,100,0.320679954369793,idb221f542,left_hip,0.927685022354126,-5,-6,14662,99
14661,102,0.790876925336602,idb221f542,left_ankle,0.957937955856323,1,-2,14662,99
14664,99,0.747654725346194,idb221f542,right_ankle,0.931617021560669,-2,-2,14662,99
13488,99,0.244817236285191,idb221f542,left_wrist,1.14370608329773,-4,-4,13484,99
13490,99,0.309525349867252,idb221f542,left_hip,0.927685022354126,-6,-6,13484,99
13486,99,0.754504184367027,idb221f542,left_ankle,0.957937955856323,-2,-2,13484,99
13487,99,0.784119511991306,idb221f542,right_ankle,0.931617021560669,-3,-3,13484,99
1141,98,0.189012077249442,idb221f542,left_wrist,1.14370608329773,-4,-3,1137,99
1139,96,0.265929510235268,idb221f542,left_hip,0.927685022354126,-2,1,1137,99
1136,98,0.810852811182827,idb221f542,left_ankle,0.957937955856323,1,2,1137,99
1136,98,0.838955463203858,idb221f542,right_ankle,0.931617021560669,1,2,1137,99
8836,99,0.299199017834613,idb221f542,left_wrist,1.14370608329773,-1,-2,8835,98
8844,95,0.288237313816594,idb221f542,left_hip,0.927685022354126,-9,-6,8835,98
8835,97,0.820929583906732,idb221f542,left_ankle,0.957937955856323,0,1,8835,98
8838,98,0.815885592877822,idb221f542,right_ankle,0.931617021560669,-3,-3,8835,98
16814,98,0.311436475368943,idb221f542,left_wrist,1.14370608329773,-4,-2,16810,100
16817,99,0.341047886012888,idb221f542,left_hip,0.927685022354126,-7,-6,16810,100
16812,99,0.788561745195571,idb221f542,left_ankle,0.957937955856323,-2,-1,16810,100
16811,100,0.734836531491516,idb221f542,right_ankle,0.931617021560669,-1,-1,16810,100
