tau_i,T_i,sim_i,subj_id,loc_id,exec_t,SS_start_diff,SS_end_diff,manSS_tau_i,manSS_T_i
5113,115,0.365891081740545,idabd0c53c,left_wrist,1.12588095664978,-1,-3,5112,113
5111,114,0.373280026545782,idabd0c53c,left_hip,0.961760997772217,1,0,5112,113
5111,114,0.669482951686357,idabd0c53c,left_ankle,0.937618970870972,1,0,5112,113
5113,116,0.586325204041793,idabd0c53c,right_ankle,0.970832109451294,-1,-4,5112,113
7155,109,0.386267814840798,idabd0c53c,left_wrist,1.12588095664978,-4,-2,7151,111
7152,113,0.338145700085078,idabd0c53c,left_hip,0.961760997772217,-1,-3,7151,111
7152,110,0.66574987946686,idabd0c53c,left_ankle,0.937618970870972,-1,0,7151,111
7154,109,0.635694437838353,idabd0c53c,right_ankle,0.970832109451294,-3,-1,7151,111
10929,109,0.379031296742621,idabd0c53c,left_wrist,1.12588095664978,-3,-3,10926,109
10926,109,0.416002856982449,idabd0c53c,left_hip,0.961760997772217,0,0,10926,109
10925,109,0.744664890085554,idabd0c53c,left_ankle,0.937618970870972,1,1,10926,109
10925,109,0.645268850708744,idabd0c53c,right_ankle,0.970832109451294,1,1,10926,109
17244,108,0.437371731967877,idabd0c53c,left_wrist,1.12588095664978,-3,-3,17241,108
17244,105,0.426140665412538,idabd0c53c,left_hip,0.961760997772217,-3,0,17241,108
17241,107,0.673001886315117,idabd0c53c,left_ankle,0.937618970870972,0,1,17241,108
17241,108,0.642229231840436,idabd0c53c,right_ankle,0.970832109451294,0,0,17241,108
3854,116,0.380896042112788,idabd0c53c,left_wrist,1.12588095664978,-2,-3,3852,115
3851,117,0.367713084506441,idabd0c53c,left_hip,0.961760997772217,1,-1,3852,115
3850,117,0.636906749215652,idabd0c53c,left_ankle,0.937618970870972,2,0,3852,115
3856,113,0.632613521123369,idabd0c53c,right_ankle,0.970832109451294,-4,-2,3852,115
17033,107,0.344462501322518,idabd0c53c,left_wrist,1.12588095664978,-4,-4,17029,107
17030,106,0.462154422445213,idabd0c53c,left_hip,0.961760997772217,-1,0,17029,107
17030,106,0.767223146592494,idabd0c53c,left_ankle,0.937618970870972,-1,0,17029,107
17029,105,0.654164632679825,idabd0c53c,right_ankle,0.970832109451294,0,2,17029,107
17881,106,0.448656618213865,idabd0c53c,left_wrist,1.12588095664978,-3,-3,17878,106
17879,105,0.468777257027009,idabd0c53c,left_hip,0.961760997772217,-1,0,17878,106
17878,106,0.659001923064751,idabd0c53c,left_ankle,0.937618970870972,0,0,17878,106
17878,108,0.653521973837117,idabd0c53c,right_ankle,0.970832109451294,0,-2,17878,106
12567,110,0.293385634340145,idabd0c53c,left_wrist,1.12588095664978,-4,-4,12563,110
12564,112,0.371119600357214,idabd0c53c,left_hip,0.961760997772217,-1,-3,12563,110
12562,111,0.665052228822704,idabd0c53c,left_ankle,0.937618970870972,1,0,12563,110
12564,109,0.633050826778879,idabd0c53c,right_ankle,0.970832109451294,-1,0,12563,110
12017,112,0.369804233966684,idabd0c53c,left_wrist,1.12588095664978,-3,-4,12014,111
12015,111,0.420585953982392,idabd0c53c,left_hip,0.961760997772217,-1,-1,12014,111
12013,111,0.683846884115737,idabd0c53c,left_ankle,0.937618970870972,1,1,12014,111
12014,112,0.596583299693258,idabd0c53c,right_ankle,0.970832109451294,0,-1,12014,111
1279,109,0.378288650452582,idabd0c53c,left_wrist,1.12588095664978,-2,-3,1277,108
1277,107,0.366769565542256,idabd0c53c,left_hip,0.961760997772217,0,1,1277,108
1277,106,0.749648423088329,idabd0c53c,left_ankle,0.937618970870972,0,2,1277,108
1275,110,0.653973569093539,idabd0c53c,right_ankle,0.970832109451294,2,0,1277,108
3969,113,0.287773768152776,idabd0c53c,left_wrist,1.12588095664978,-3,-3,3966,113
3967,113,0.363271660201602,idabd0c53c,left_hip,0.961760997772217,-1,-1,3966,113
3966,113,0.729497492608656,idabd0c53c,left_ankle,0.937618970870972,0,0,3966,113
3968,115,0.587789820140446,idabd0c53c,right_ankle,0.970832109451294,-2,-4,3966,113
3400,113,0.383937522973083,idabd0c53c,left_wrist,1.12588095664978,-3,-3,3397,113
3397,113,0.372878213341194,idabd0c53c,left_hip,0.961760997772217,0,0,3397,113
3397,112,0.699948577993053,idabd0c53c,left_ankle,0.937618970870972,0,1,3397,113
3399,115,0.609035222272088,idabd0c53c,right_ankle,0.970832109451294,-2,-4,3397,113
13113,112,0.380624024561533,idabd0c53c,left_wrist,1.12588095664978,-2,-3,13111,111
13111,114,0.433295834932102,idabd0c53c,left_hip,0.961760997772217,0,-3,13111,111
13110,112,0.672253317847404,idabd0c53c,left_ankle,0.937618970870972,1,0,13111,111
13111,110,0.665611735853996,idabd0c53c,right_ankle,0.970832109451294,0,1,13111,111
7375,115,0.347928426911723,idabd0c53c,left_wrist,1.12588095664978,-3,-3,7372,115
7372,117,0.347559831244453,idabd0c53c,left_hip,0.961760997772217,0,-2,7372,115
7371,116,0.711960930937836,idabd0c53c,left_ankle,0.937618970870972,1,0,7372,115
7375,115,0.566589357358061,idabd0c53c,right_ankle,0.970832109451294,-3,-3,7372,115
14714,107,0.334267995334992,idabd0c53c,left_wrist,1.12588095664978,-4,-2,14710,109
14711,113,0.395327654856056,idabd0c53c,left_hip,0.961760997772217,-1,-5,14710,109
14710,107,0.632165640215447,idabd0c53c,left_ankle,0.937618970870972,0,2,14710,109
14711,105,0.665310410087556,idabd0c53c,right_ankle,0.970832109451294,-1,3,14710,109
9526,112,0.361635604168071,idabd0c53c,left_wrist,1.12588095664978,-3,-3,9523,112
9524,110,0.38335494321464,idabd0c53c,left_hip,0.961760997772217,-1,1,9523,112
9524,110,0.73036698482926,idabd0c53c,left_ankle,0.937618970870972,-1,1,9523,112
9525,112,0.643945404479444,idabd0c53c,right_ankle,0.970832109451294,-2,-2,9523,112
13661,103,0.397577995774893,idabd0c53c,left_wrist,1.12588095664978,-4,-2,13657,105
13659,104,0.487345983222148,idabd0c53c,left_hip,0.961760997772217,-2,-1,13657,105
13657,104,0.706046169612156,idabd0c53c,left_ankle,0.937618970870972,0,1,13657,105
13656,104,0.666011423232205,idabd0c53c,right_ankle,0.970832109451294,1,2,13657,105
18838,108,0.331956302386814,idabd0c53c,left_wrist,1.12588095664978,-2,-2,18836,108
18835,108,0.409438323426955,idabd0c53c,left_hip,0.961760997772217,1,1,18836,108
18835,108,0.703742635617295,idabd0c53c,left_ankle,0.937618970870972,1,1,18836,108
18835,108,0.668613688852169,idabd0c53c,right_ankle,0.970832109451294,1,1,18836,108
7263,113,0.310280241208952,idabd0c53c,left_wrist,1.12588095664978,-2,-3,7261,112
7264,109,0.374424268920335,idabd0c53c,left_hip,0.961760997772217,-3,0,7261,112
7261,111,0.654733842470475,idabd0c53c,left_ankle,0.937618970870972,0,1,7261,112
7262,114,0.570287376044867,idabd0c53c,right_ankle,0.970832109451294,-1,-3,7261,112
14714,107,0.334267995334992,idabd0c53c,left_wrist,1.12588095664978,-4,-2,14710,109
14711,113,0.395327654856056,idabd0c53c,left_hip,0.961760997772217,-1,-5,14710,109
14710,107,0.632165640215447,idabd0c53c,left_ankle,0.937618970870972,0,2,14710,109
14711,105,0.665310410087556,idabd0c53c,right_ankle,0.970832109451294,-1,3,14710,109
18058,95,0.251485258114662,id5993bf4a,left_wrist,1.09782814979553,-3,-7,18055,91
18061,94,0.505190477783125,id5993bf4a,left_hip,1.07848787307739,-6,-9,18055,91
18053,94,0.842043964750416,id5993bf4a,left_ankle,1.0615451335907,2,-1,18055,91
18053,92,0.67175845927355,id5993bf4a,right_ankle,1.09071183204651,2,1,18055,91
4112,98,0.214358108998935,id5993bf4a,left_wrist,1.09782814979553,0,-1,4112,97
4111,98,0.359266270797572,id5993bf4a,left_hip,1.07848787307739,1,0,4112,97
4108,98,0.685108650630847,id5993bf4a,left_ankle,1.0615451335907,4,3,4112,97
4108,99,0.671730870912993,id5993bf4a,right_ankle,1.09071183204651,4,2,4112,97
12551,98,0.214711375579865,id5993bf4a,left_wrist,1.09782814979553,0,-2,12551,96
12552,100,0.485493882885549,id5993bf4a,left_hip,1.07848787307739,-1,-5,12551,96
12549,97,0.72896110947134,id5993bf4a,left_ankle,1.0615451335907,2,1,12551,96
12550,96,0.724230891904784,id5993bf4a,right_ankle,1.09071183204651,1,1,12551,96
2495,113,0.174082563882336,id5993bf4a,left_wrist,1.09782814979553,-8,-27,2487,94
2486,96,0.34876154024093,id5993bf4a,left_hip,1.07848787307739,1,-1,2487,94
2484,96,0.903028531870649,id5993bf4a,left_ankle,1.0615451335907,3,1,2487,94
2483,97,0.779603486551241,id5993bf4a,right_ankle,1.09071183204651,4,1,2487,94
5172,97,0.193401919290549,id5993bf4a,left_wrist,1.09782814979553,-1,-3,5171,95
5172,97,0.338170713417439,id5993bf4a,left_hip,1.07848787307739,-1,-3,5171,95
5168,95,0.864727521355074,id5993bf4a,left_ankle,1.0615451335907,3,3,5171,95
5169,95,0.759809229896057,id5993bf4a,right_ankle,1.09071183204651,2,2,5171,95
7464,98,0.22799105524485,id5993bf4a,left_wrist,1.09782814979553,-2,-2,7462,98
7463,98,0.378058328499368,id5993bf4a,left_hip,1.07848787307739,-1,-1,7462,98
7460,99,0.899143537712983,id5993bf4a,left_ankle,1.0615451335907,2,1,7462,98
7460,98,0.760426624466347,id5993bf4a,right_ankle,1.09071183204651,2,2,7462,98
392,95,0.234406922180193,id5993bf4a,left_wrist,1.09782814979553,-5,-4,387,96
392,95,0.436412730712031,id5993bf4a,left_hip,1.07848787307739,-5,-4,387,96
385,96,0.717562185806128,id5993bf4a,left_ankle,1.0615451335907,2,2,387,96
387,95,0.687887569206595,id5993bf4a,right_ankle,1.09071183204651,0,1,387,96
7367,98,0.204360750896529,id5993bf4a,left_wrist,1.09782814979553,-1,-2,7366,97
7368,96,0.369199049247533,id5993bf4a,left_hip,1.07848787307739,-2,-1,7366,97
7363,98,0.737798139733783,id5993bf4a,left_ankle,1.0615451335907,3,2,7366,97
7364,97,0.738277266794567,id5993bf4a,right_ankle,1.09071183204651,2,2,7366,97
16740,95,0.240378647470695,id5993bf4a,left_wrist,1.09782814979553,-3,-2,16737,96
16742,96,0.512270636332783,id5993bf4a,left_hip,1.07848787307739,-5,-5,16737,96
16735,96,0.779257325168357,id5993bf4a,left_ankle,1.0615451335907,2,2,16737,96
16735,95,0.765980721409185,id5993bf4a,right_ankle,1.09071183204651,2,3,16737,96
6606,97,0.274058477078413,id5993bf4a,left_wrist,1.09782814979553,-3,-2,6603,98
6606,96,0.413461885019937,id5993bf4a,left_hip,1.07848787307739,-3,-1,6603,98
6601,98,0.902110629853293,id5993bf4a,left_ankle,1.0615451335907,2,2,6603,98
6602,98,0.705328865464687,id5993bf4a,right_ankle,1.09071183204651,1,1,6603,98
9302,95,0.250690361351497,id5993bf4a,left_wrist,1.09782814979553,-5,-11,9297,89
9303,95,0.560422097009266,id5993bf4a,left_hip,1.07848787307739,-6,-12,9297,89
9296,88,0.88742421083561,id5993bf4a,left_ankle,1.0615451335907,1,2,9297,89
9298,90,0.743085572277176,id5993bf4a,right_ankle,1.09071183204651,-1,-2,9297,89
11584,98,0.240035429179778,id5993bf4a,left_wrist,1.09782814979553,-1,3,11583,102
11588,95,0.402520755414329,id5993bf4a,left_hip,1.07848787307739,-5,2,11583,102
11581,103,0.787591991729973,id5993bf4a,left_ankle,1.0615451335907,2,1,11583,102
11580,98,0.744748885250243,id5993bf4a,right_ankle,1.09071183204651,3,7,11583,102
9483,96,0.231555215522094,id5993bf4a,left_wrist,1.09782814979553,-5,-5,9478,96
9485,94,0.488697794026217,id5993bf4a,left_hip,1.07848787307739,-7,-5,9478,96
9477,100,0.857137616704705,id5993bf4a,left_ankle,1.0615451335907,1,-3,9478,96
9478,96,0.785664677573144,id5993bf4a,right_ankle,1.09071183204651,0,0,9478,96
3626,94,0.194300440174156,id5993bf4a,left_wrist,1.09782814979553,1,4,3627,97
3632,94,0.394246092666148,id5993bf4a,left_hip,1.07848787307739,-5,-2,3627,97
3626,96,0.719412738101299,id5993bf4a,left_ankle,1.0615451335907,1,2,3627,97
3626,96,0.719037667551589,id5993bf4a,right_ankle,1.09071183204651,1,2,3627,97
15881,98,0.29483256307344,id5993bf4a,left_wrist,1.09782814979553,-2,-1,15879,99
15884,96,0.493509810564295,id5993bf4a,left_hip,1.07848787307739,-5,-2,15879,99
15878,97,0.865292999485115,id5993bf4a,left_ankle,1.0615451335907,1,3,15879,99
15878,97,0.708174650615993,id5993bf4a,right_ankle,1.09071183204651,1,3,15879,99
12935,102,0.313263695067309,id5993bf4a,left_wrist,1.09782814979553,1,-4,12936,97
12939,98,0.508185986742864,id5993bf4a,left_hip,1.07848787307739,-3,-4,12936,97
12935,97,0.84339530355854,id5993bf4a,left_ankle,1.0615451335907,1,1,12936,97
12935,97,0.770401426660807,id5993bf4a,right_ankle,1.09071183204651,1,1,12936,97
15311,97,0.254960169325074,id5993bf4a,left_wrist,1.09782814979553,-1,-1,15310,97
15313,96,0.518771741017525,id5993bf4a,left_hip,1.07848787307739,-3,-2,15310,97
15306,98,0.85989177761233,id5993bf4a,left_ankle,1.0615451335907,4,3,15310,97
15306,97,0.735193291105637,id5993bf4a,right_ankle,1.09071183204651,4,4,15310,97
2191,103,0.205721130407017,id5993bf4a,left_wrist,1.09782814979553,5,-1,2196,97
2196,99,0.370211321475153,id5993bf4a,left_hip,1.07848787307739,0,-2,2196,97
2194,98,0.895665191716698,id5993bf4a,left_ankle,1.0615451335907,2,1,2196,97
2194,98,0.767799665032555,id5993bf4a,right_ankle,1.09071183204651,2,1,2196,97
13903,97,0.241405298867759,id5993bf4a,left_wrist,1.09782814979553,-4,-3,13899,98
13904,96,0.431710419851008,id5993bf4a,left_hip,1.07848787307739,-5,-3,13899,98
13898,97,0.72508743373761,id5993bf4a,left_ankle,1.0615451335907,1,2,13899,98
13899,97,0.734828087381774,id5993bf4a,right_ankle,1.09071183204651,0,1,13899,98
8034,122,0.205839683293025,id5993bf4a,left_wrist,1.09782814979553,-6,-28,8028,100
8029,98,0.302690377066966,id5993bf4a,left_hip,1.07848787307739,-1,1,8028,100
8026,100,0.796297025382665,id5993bf4a,left_ankle,1.0615451335907,2,2,8028,100
8025,100,0.710627083018418,id5993bf4a,right_ankle,1.09071183204651,3,3,8028,100
13845,100,0.189761661159871,idd80ac2b4,left_wrist,0.850306987762451,-2,-1,13843,101
13841,100,0.346884424132213,idd80ac2b4,left_hip,0.838832139968872,2,3,13843,101
13841,101,0.799532357748926,idd80ac2b4,left_ankle,1.00381994247437,2,2,13843,101
13841,100,0.693077289977775,idd80ac2b4,right_ankle,0.842326164245605,2,3,13843,101
10917,96,0.177114785638873,idd80ac2b4,left_wrist,0.850306987762451,0,3,10917,99
10913,98,0.32114981001331,idd80ac2b4,left_hip,0.838832139968872,4,5,10917,99
10915,97,0.786795561545409,idd80ac2b4,left_ankle,1.00381994247437,2,4,10917,99
10915,97,0.72579121753723,idd80ac2b4,right_ankle,0.842326164245605,2,4,10917,99
13154,101,0.209615706392466,idd80ac2b4,left_wrist,0.850306987762451,0,-1,13154,100
13149,101,0.347163511280961,idd80ac2b4,left_hip,0.838832139968872,5,4,13154,100
13152,100,0.801080892171086,idd80ac2b4,left_ankle,1.00381994247437,2,2,13154,100
13151,99,0.765067269865959,idd80ac2b4,right_ankle,0.842326164245605,3,4,13154,100
9355,103,0.146240647500069,idd80ac2b4,left_wrist,0.850306987762451,6,2,9361,99
9356,99,0.227720120344862,idd80ac2b4,left_hip,0.838832139968872,5,5,9361,99
9358,99,0.819905287656557,idd80ac2b4,left_ankle,1.00381994247437,3,3,9361,99
9358,100,0.682075173132883,idd80ac2b4,right_ankle,0.842326164245605,3,2,9361,99
8865,105,0.139372032916449,idd80ac2b4,left_wrist,0.850306987762451,3,-3,8868,99
8862,101,0.315634203837138,idd80ac2b4,left_hip,0.838832139968872,6,4,8868,99
8866,100,0.707104727395328,idd80ac2b4,left_ankle,1.00381994247437,2,1,8868,99
8864,99,0.745593161064362,idd80ac2b4,right_ankle,0.842326164245605,4,4,8868,99
13254,54,0.153356581384398,idd80ac2b4,left_wrist,0.850306987762451,-1,43,13253,98
13249,97,0.295479279122366,idd80ac2b4,left_hip,0.838832139968872,4,5,13253,98
13251,98,0.764548825192707,idd80ac2b4,left_ankle,1.00381994247437,2,2,13253,98
13249,99,0.783098944577768,idd80ac2b4,right_ankle,0.842326164245605,4,3,13253,98
563,100,0.169303875194918,idd80ac2b4,left_wrist,0.850306987762451,6,4,569,98
562,98,0.310408526822481,idd80ac2b4,left_hip,0.838832139968872,7,7,569,98
565,98,0.696843734743618,idd80ac2b4,left_ankle,1.00381994247437,4,4,569,98
565,99,0.73652820450341,idd80ac2b4,right_ankle,0.842326164245605,4,3,569,98
8077,96,0.147132271006671,idd80ac2b4,left_wrist,0.850306987762451,4,7,8081,99
8075,98,0.201579402637385,idd80ac2b4,left_hip,0.838832139968872,6,7,8081,99
8078,98,0.796231370804738,idd80ac2b4,left_ankle,1.00381994247437,3,4,8081,99
8078,98,0.738463786589712,idd80ac2b4,right_ankle,0.842326164245605,3,4,8081,99
12375,96,0.174260188955294,idd80ac2b4,left_wrist,0.850306987762451,-2,-1,12373,97
12369,97,0.309361571589002,idd80ac2b4,left_hip,0.838832139968872,4,4,12373,97
12370,98,0.834563676994549,idd80ac2b4,left_ankle,1.00381994247437,3,2,12373,97
12371,97,0.819669965473446,idd80ac2b4,right_ankle,0.842326164245605,2,2,12373,97
11691,103,0.199128064727315,idd80ac2b4,left_wrist,0.850306987762451,4,0,11695,99
11690,98,0.250478533518589,idd80ac2b4,left_hip,0.838832139968872,5,6,11695,99
11693,97,0.726053962872802,idd80ac2b4,left_ankle,1.00381994247437,2,4,11695,99
11693,101,0.690355600220203,idd80ac2b4,right_ankle,0.842326164245605,2,0,11695,99
8077,96,0.147132271006671,idd80ac2b4,left_wrist,0.850306987762451,4,7,8081,99
8075,98,0.201579402637385,idd80ac2b4,left_hip,0.838832139968872,6,7,8081,99
8078,98,0.796231370804738,idd80ac2b4,left_ankle,1.00381994247437,3,4,8081,99
8078,98,0.738463786589712,idd80ac2b4,right_ankle,0.842326164245605,3,4,8081,99
14443,98,0.217835788212935,idd80ac2b4,left_wrist,0.850306987762451,-3,-1,14440,100
14437,100,0.326711396031357,idd80ac2b4,left_hip,0.838832139968872,3,3,14440,100
14438,99,0.687841166367858,idd80ac2b4,left_ankle,1.00381994247437,2,3,14440,100
14437,100,0.719912068339755,idd80ac2b4,right_ankle,0.842326164245605,3,3,14440,100
7503,87,0.124750254823764,idd80ac2b4,left_wrist,0.850306987762451,-7,6,7496,100
7489,99,0.199819143804418,idd80ac2b4,left_hip,0.838832139968872,7,8,7496,100
7492,100,0.6741038715892,idd80ac2b4,left_ankle,1.00381994247437,4,4,7496,100
7492,100,0.595483706105,idd80ac2b4,right_ankle,0.842326164245605,4,4,7496,100
4187,135,0.148380685540204,idd80ac2b4,left_wrist,0.850306987762451,-4,-39,4183,100
4177,100,0.25430970974543,idd80ac2b4,left_hip,0.838832139968872,6,6,4183,100
4179,101,0.672278995460932,idd80ac2b4,left_ankle,1.00381994247437,4,3,4183,100
4178,101,0.64091807097194,idd80ac2b4,right_ankle,0.842326164245605,5,4,4183,100
1246,103,0.13990227005704,idd80ac2b4,left_wrist,0.850306987762451,9,4,1255,98
1247,100,0.262023607881927,idd80ac2b4,left_hip,0.838832139968872,8,6,1255,98
1251,99,0.710935189096371,idd80ac2b4,left_ankle,1.00381994247437,4,3,1255,98
1250,101,0.712453645139601,idd80ac2b4,right_ankle,0.842326164245605,5,2,1255,98
1739,99,0.118677982881515,idd80ac2b4,left_wrist,0.850306987762451,5,5,1744,99
1738,99,0.275242443392323,idd80ac2b4,left_hip,0.838832139968872,6,6,1744,99
1740,99,0.802276382354406,idd80ac2b4,left_ankle,1.00381994247437,4,4,1744,99
1741,99,0.675141541852572,idd80ac2b4,right_ankle,0.842326164245605,3,3,1744,99
5561,92,0.154051929055746,idd80ac2b4,left_wrist,0.850306987762451,-2,4,5559,98
5554,98,0.269373808761777,idd80ac2b4,left_hip,0.838832139968872,5,5,5559,98
5556,97,0.738927872334389,idd80ac2b4,left_ankle,1.00381994247437,3,4,5559,98
5557,97,0.75455911824205,idd80ac2b4,right_ankle,0.842326164245605,2,3,5559,98
8673,92,0.108263862184371,idd80ac2b4,left_wrist,0.850306987762451,-4,6,8669,102
8666,100,0.330889091242133,idd80ac2b4,left_hip,0.838832139968872,3,5,8669,102
8668,100,0.789397483716415,idd80ac2b4,left_ankle,1.00381994247437,1,3,8669,102
8667,100,0.695041955320545,idd80ac2b4,right_ankle,0.842326164245605,2,4,8669,102
11107,101,0.191641262932017,idd80ac2b4,left_wrist,0.850306987762451,6,3,11113,98
11108,98,0.298597653240866,idd80ac2b4,left_hip,0.838832139968872,5,5,11113,98
11110,98,0.728717083790841,idd80ac2b4,left_ankle,1.00381994247437,3,3,11113,98
11110,98,0.713865252913249,idd80ac2b4,right_ankle,0.842326164245605,3,3,11113,98
6811,98,0.18711490883306,idd80ac2b4,left_wrist,0.850306987762451,6,6,6817,98
6811,98,0.289231458797581,idd80ac2b4,left_hip,0.838832139968872,6,6,6817,98
6813,98,0.805363581339707,idd80ac2b4,left_ankle,1.00381994247437,4,4,6817,98
6813,98,0.731537232744432,idd80ac2b4,right_ankle,0.842326164245605,4,4,6817,98
16136,102,0.341982746777309,id82b9735c,left_wrist,0.859354972839355,1,2,16137,103
16138,102,0.481005343733662,id82b9735c,left_hip,0.872102975845337,-1,0,16137,103
16137,102,0.852823057136269,id82b9735c,left_ankle,0.856471061706543,0,1,16137,103
16135,102,0.816109521405606,id82b9735c,right_ankle,0.882485151290894,2,3,16137,103
5150,111,0.314810658249709,id82b9735c,left_wrist,0.859354972839355,4,1,5154,108
5152,109,0.361581326732736,id82b9735c,left_hip,0.872102975845337,2,1,5154,108
5150,108,0.724873223915947,id82b9735c,left_ankle,0.856471061706543,4,4,5154,108
5152,108,0.679650843342472,id82b9735c,right_ankle,0.882485151290894,2,2,5154,108
8042,105,0.309559960466338,id82b9735c,left_wrist,0.859354972839355,0,1,8042,106
8040,106,0.375916041795676,id82b9735c,left_hip,0.872102975845337,2,2,8042,106
8041,104,0.71460077000124,id82b9735c,left_ankle,0.856471061706543,1,3,8042,106
8038,107,0.742985947495511,id82b9735c,right_ankle,0.882485151290894,4,3,8042,106
5831,106,0.276801177259527,id82b9735c,left_wrist,0.859354972839355,0,2,5831,108
5830,108,0.374001832660963,id82b9735c,left_hip,0.872102975845337,1,1,5831,108
5831,108,0.750515529418549,id82b9735c,left_ankle,0.856471061706543,0,0,5831,108
5829,108,0.784800317390394,id82b9735c,right_ankle,0.882485151290894,2,2,5831,108
11481,105,0.270547373985367,id82b9735c,left_wrist,0.859354972839355,1,2,11482,106
11480,106,0.400696439132587,id82b9735c,left_hip,0.872102975845337,2,2,11482,106
11481,106,0.74756416792014,id82b9735c,left_ankle,0.856471061706543,1,1,11482,106
11479,104,0.694853569601904,id82b9735c,right_ankle,0.882485151290894,3,5,11482,106
4622,109,0.316225212520623,id82b9735c,left_wrist,0.859354972839355,4,4,4626,109
4624,108,0.366733233163312,id82b9735c,left_hip,0.872102975845337,2,3,4626,109
4625,108,0.74274629592367,id82b9735c,left_ankle,0.856471061706543,1,2,4626,109
4624,107,0.709172574891961,id82b9735c,right_ankle,0.882485151290894,2,4,4626,109
8471,98,0.23161136112571,id82b9735c,left_wrist,0.859354972839355,-2,7,8469,107
8469,106,0.403787677318529,id82b9735c,left_hip,0.872102975845337,0,1,8469,107
8468,108,0.837940571602605,id82b9735c,left_ankle,0.856471061706543,1,0,8469,107
8468,103,0.77717879547408,id82b9735c,right_ankle,0.882485151290894,1,5,8469,107
13429,102,0.297863781623548,id82b9735c,left_wrist,0.859354972839355,1,-2,13430,99
13429,102,0.473525896252408,id82b9735c,left_hip,0.872102975845337,1,-2,13430,99
13429,101,0.796861785153181,id82b9735c,left_ankle,0.856471061706543,1,-1,13430,99
13426,102,0.784238778072596,id82b9735c,right_ankle,0.882485151290894,4,1,13430,99
1521,111,0.348067971525263,id82b9735c,left_wrist,0.859354972839355,2,-2,1523,107
1520,108,0.388768316325102,id82b9735c,left_hip,0.872102975845337,3,2,1523,107
1522,104,0.742768483391711,id82b9735c,left_ankle,0.856471061706543,1,4,1523,107
1519,109,0.691358543414841,id82b9735c,right_ankle,0.882485151290894,4,2,1523,107
15330,101,0.427590378701802,id82b9735c,left_wrist,0.859354972839355,2,1,15332,100
15331,100,0.476433550628902,id82b9735c,left_hip,0.872102975845337,1,1,15332,100
15331,100,0.871087363695213,id82b9735c,left_ankle,0.856471061706543,1,1,15332,100
15328,102,0.800525512260957,id82b9735c,right_ankle,0.882485151290894,4,2,15332,100
5936,105,0.297022413084296,id82b9735c,left_wrist,0.859354972839355,2,4,5938,107
5937,107,0.36594561378364,id82b9735c,left_hip,0.872102975845337,1,1,5938,107
5938,107,0.796164717630093,id82b9735c,left_ankle,0.856471061706543,0,0,5938,107
5936,107,0.750764684332647,id82b9735c,right_ankle,0.882485151290894,2,2,5938,107
14727,103,0.392973586102339,id82b9735c,left_wrist,0.859354972839355,2,0,14729,101
14729,100,0.471901866351009,id82b9735c,left_hip,0.872102975845337,0,1,14729,101
14728,103,0.847902155039595,id82b9735c,left_ankle,0.856471061706543,1,-1,14729,101
14726,103,0.804761945689026,id82b9735c,right_ankle,0.882485151290894,3,1,14729,101
6147,108,0.316984687609153,id82b9735c,left_wrist,0.859354972839355,2,1,6149,107
6148,106,0.369232581710731,id82b9735c,left_hip,0.872102975845337,1,2,6149,107
6149,107,0.775391087675023,id82b9735c,left_ankle,0.856471061706543,0,0,6149,107
6147,106,0.766323487206417,id82b9735c,right_ankle,0.882485151290894,2,3,6149,107
5936,105,0.297022413084296,id82b9735c,left_wrist,0.859354972839355,2,4,5938,107
5937,107,0.36594561378364,id82b9735c,left_hip,0.872102975845337,1,1,5938,107
5938,107,0.796164717630093,id82b9735c,left_ankle,0.856471061706543,0,0,5938,107
5936,107,0.750764684332647,id82b9735c,right_ankle,0.882485151290894,2,2,5938,107
8361,111,0.332178105863093,id82b9735c,left_wrist,0.859354972839355,2,-1,8363,108
8361,109,0.379637905798793,id82b9735c,left_hip,0.872102975845337,2,1,8363,108
8362,107,0.647242945527981,id82b9735c,left_ankle,0.856471061706543,1,2,8363,108
8360,109,0.676416935083976,id82b9735c,right_ankle,0.882485151290894,3,2,8363,108
15733,103,0.386848771598747,id82b9735c,left_wrist,0.859354972839355,0,-1,15733,102
15734,101,0.471977400633789,id82b9735c,left_hip,0.872102975845337,-1,0,15733,102
15733,102,0.779764309011635,id82b9735c,left_ankle,0.856471061706543,0,0,15733,102
15728,106,0.745557000125437,id82b9735c,right_ankle,0.882485151290894,5,1,15733,102
15131,102,0.32755554032249,id82b9735c,left_wrist,0.859354972839355,0,0,15131,102
15132,101,0.493741498360726,id82b9735c,left_hip,0.872102975845337,-1,0,15131,102
15131,101,0.766672731356339,id82b9735c,left_ankle,0.856471061706543,0,1,15131,102
15129,98,0.815423952638494,id82b9735c,right_ankle,0.882485151290894,2,6,15131,102
6875,103,0.358331607262862,id82b9735c,left_wrist,0.859354972839355,2,5,6877,106
6875,106,0.367466081875691,id82b9735c,left_hip,0.872102975845337,2,2,6877,106
6877,106,0.817029340258699,id82b9735c,left_ankle,0.856471061706543,0,0,6877,106
6873,107,0.698807813513159,id82b9735c,right_ankle,0.882485151290894,4,3,6877,106
13731,101,0.25089006100942,id82b9735c,left_wrist,0.859354972839355,-1,-1,13730,101
13732,99,0.468826369956241,id82b9735c,left_hip,0.872102975845337,-2,0,13730,101
13729,102,0.819302770993375,id82b9735c,left_ankle,0.856471061706543,1,0,13730,101
13728,97,0.811021503175103,id82b9735c,right_ankle,0.882485151290894,2,6,13730,101
16836,103,0.370247580897961,id82b9735c,left_wrist,0.859354972839355,2,1,16838,102
16837,103,0.444149627092366,id82b9735c,left_hip,0.872102975845337,1,0,16838,102
16838,103,0.845314695795737,id82b9735c,left_ankle,0.856471061706543,0,-1,16838,102
16833,108,0.810668761105934,id82b9735c,right_ankle,0.882485151290894,5,-1,16838,102
8903,109,0.133678264718242,id8af5374b,left_wrist,1.02579402923584,-3,-4,8900,108
8894,105,0.173137224239383,id8af5374b,left_hip,1.05143904685974,6,9,8900,108
8899,106,0.672715900751504,id8af5374b,left_ankle,1.04994702339172,1,3,8900,108
8898,112,0.713365364675884,id8af5374b,right_ankle,1.03878808021545,2,-2,8900,108
14485,112,0.209290916301178,id8af5374b,left_wrist,1.02579402923584,-2,-5,14483,109
14475,111,0.272538622840408,id8af5374b,left_hip,1.05143904685974,8,6,14483,109
14481,110,0.69400187841545,id8af5374b,left_ankle,1.04994702339172,2,1,14483,109
14483,109,0.702139419000333,id8af5374b,right_ankle,1.03878808021545,0,0,14483,109
8127,113,0.161335301808559,id8af5374b,left_wrist,1.02579402923584,-3,-4,8124,112
8117,111,0.227539136239203,id8af5374b,left_hip,1.05143904685974,7,8,8124,112
8122,113,0.715224552771648,id8af5374b,left_ankle,1.04994702339172,2,1,8124,112
8123,112,0.766433781454437,id8af5374b,right_ankle,1.03878808021545,1,1,8124,112
6688,114,0.168031518371215,id8af5374b,left_wrist,1.02579402923584,-2,-4,6686,112
6677,114,0.259425590325464,id8af5374b,left_hip,1.05143904685974,9,7,6686,112
6684,113,0.719712973290656,id8af5374b,left_ankle,1.04994702339172,2,1,6686,112
6682,115,0.672397902420005,id8af5374b,right_ankle,1.03878808021545,4,1,6686,112
15372,111,0.227280209369764,id8af5374b,left_wrist,1.02579402923584,-5,-4,15367,112
15360,112,0.188335051703184,id8af5374b,left_hip,1.05143904685974,7,7,15367,112
15366,112,0.685607301290095,id8af5374b,left_ankle,1.04994702339172,1,1,15367,112
15365,113,0.647740685903624,id8af5374b,right_ankle,1.03878808021545,2,1,15367,112
4171,106,0.179671647511301,id8af5374b,left_wrist,1.02579402923584,-2,2,4169,110
4161,111,0.25492825691603,id8af5374b,left_hip,1.05143904685974,8,7,4169,110
4167,109,0.622511327304439,id8af5374b,left_ankle,1.04994702339172,2,3,4169,110
4168,109,0.69406509752717,id8af5374b,right_ankle,1.03878808021545,1,2,4169,110
14485,112,0.209290916301178,id8af5374b,left_wrist,1.02579402923584,-2,-5,14483,109
14475,111,0.272538622840408,id8af5374b,left_hip,1.05143904685974,8,6,14483,109
14481,110,0.69400187841545,id8af5374b,left_ankle,1.04994702339172,2,1,14483,109
14483,109,0.702139419000333,id8af5374b,right_ankle,1.03878808021545,0,0,14483,109
2525,112,0.132612622003236,id8af5374b,left_wrist,1.02579402923584,-3,-3,2522,112
2516,112,0.250516886895837,id8af5374b,left_hip,1.05143904685974,6,6,2522,112
2521,112,0.755946208148647,id8af5374b,left_ankle,1.04994702339172,1,1,2522,112
2522,109,0.77809461236097,id8af5374b,right_ankle,1.03878808021545,0,3,2522,112
5041,109,0.165471053098521,id8af5374b,left_wrist,1.02579402923584,0,-1,5041,108
5033,109,0.218254118246982,id8af5374b,left_hip,1.05143904685974,8,7,5041,108
5038,107,0.662332634519128,id8af5374b,left_ankle,1.04994702339172,3,4,5041,108
5039,110,0.794665562376802,id8af5374b,right_ankle,1.03878808021545,2,0,5041,108
2954,125,0.14393013945908,id8af5374b,left_wrist,1.02579402923584,10,-4,2964,111
2956,113,0.244892481076477,id8af5374b,left_hip,1.05143904685974,8,6,2964,111
2962,113,0.699961091882903,id8af5374b,left_ankle,1.04994702339172,2,0,2964,111
2963,111,0.777654836971106,id8af5374b,right_ankle,1.03878808021545,1,1,2964,111
4936,106,0.155629802395407,id8af5374b,left_wrist,1.02579402923584,-3,1,4933,110
4926,108,0.242861050373803,id8af5374b,left_hip,1.05143904685974,7,9,4933,110
4932,107,0.742049424594743,id8af5374b,left_ankle,1.04994702339172,1,4,4933,110
4931,109,0.771186165182488,id8af5374b,right_ankle,1.03878808021545,2,3,4933,110
1330,109,0.154024867542568,id8af5374b,left_wrist,1.02579402923584,-3,-3,1327,109
1320,109,0.245696043952586,id8af5374b,left_hip,1.05143904685974,7,7,1327,109
1325,109,0.688191399985264,id8af5374b,left_ankle,1.04994702339172,2,2,1327,109
1326,110,0.764877370147894,id8af5374b,right_ankle,1.03878808021545,1,0,1327,109
13037,114,0.200082737656279,id8af5374b,left_wrist,1.02579402923584,-6,-6,13031,114
13025,115,0.25297453742303,id8af5374b,left_hip,1.05143904685974,6,5,13031,114
13032,114,0.700568707018368,id8af5374b,left_ankle,1.04994702339172,-1,-1,13031,114
13031,114,0.77275204286589,id8af5374b,right_ankle,1.03878808021545,0,0,13031,114
17879,110,0.198955432229187,id8af5374b,left_wrist,1.02579402923584,-4,-3,17875,111
17868,111,0.270569235244077,id8af5374b,left_hip,1.05143904685974,7,7,17875,111
17874,111,0.6863650537159,id8af5374b,left_ankle,1.04994702339172,1,1,17875,111
17875,110,0.72338652908094,id8af5374b,right_ankle,1.03878808021545,0,1,17875,111
15809,110,0.222064481009822,id8af5374b,left_wrist,1.02579402923584,-4,-3,15805,111
15797,110,0.287987048392321,id8af5374b,left_hip,1.05143904685974,8,9,15805,111
15804,109,0.746422014613531,id8af5374b,left_ankle,1.04994702339172,1,3,15805,111
15804,111,0.684957224302437,id8af5374b,right_ankle,1.03878808021545,1,1,15805,111
16137,112,0.242221665732138,id8af5374b,left_wrist,1.02579402923584,-2,-5,16135,109
16127,110,0.279835591157721,id8af5374b,left_hip,1.05143904685974,8,7,16135,109
16133,110,0.683307011569286,id8af5374b,left_ankle,1.04994702339172,2,1,16135,109
16134,110,0.745907606661897,id8af5374b,right_ankle,1.03878808021545,1,0,16135,109
9233,118,0.153483623994681,id8af5374b,left_wrist,1.02579402923584,-2,-5,9231,115
9225,115,0.182661456900001,id8af5374b,left_hip,1.05143904685974,6,6,9231,115
9230,115,0.728349282349367,id8af5374b,left_ankle,1.04994702339172,1,1,9231,115
9226,118,0.758382965869497,id8af5374b,right_ankle,1.03878808021545,5,2,9231,115
8350,109,0.131555219278568,id8af5374b,left_wrist,1.02579402923584,-5,-3,8345,111
8338,111,0.185010983272154,id8af5374b,left_hip,1.05143904685974,7,7,8345,111
8344,110,0.646105396639514,id8af5374b,left_ankle,1.04994702339172,1,2,8345,111
8344,110,0.745519388313476,id8af5374b,right_ankle,1.03878808021545,1,2,8345,111
16466,111,0.263565854114639,id8af5374b,left_wrist,1.02579402923584,-3,-4,16463,110
16455,110,0.171859772507135,id8af5374b,left_hip,1.05143904685974,8,8,16463,110
16461,111,0.684966863933091,id8af5374b,left_ankle,1.04994702339172,2,1,16463,110
16462,111,0.644364694072982,id8af5374b,right_ankle,1.03878808021545,1,0,16463,110
12258,111,0.181135521703075,id8af5374b,left_wrist,1.02579402923584,-5,-6,12253,110
12246,111,0.198143125332719,id8af5374b,left_hip,1.05143904685974,7,6,12253,110
12252,111,0.761611042491226,id8af5374b,left_ankle,1.04994702339172,1,0,12253,110
12252,111,0.788041757473757,id8af5374b,right_ankle,1.03878808021545,1,0,12253,110
14704,63,0.0893554205316134,id650857ca,left_wrist,1.34647011756897,-51,-6,14653,108
14653,107,0.244499420095764,id650857ca,left_hip,1.24419903755188,0,1,14653,108
14652,108,0.597774364124122,id650857ca,left_ankle,1.26004314422607,1,1,14653,108
14653,110,0.552633581442201,id650857ca,right_ankle,1.24571013450623,0,-2,14653,108
7856,111,0.189018276113729,id650857ca,left_wrist,1.34647011756897,54,53,7910,110
7913,107,0.257981533922509,id650857ca,left_hip,1.24419903755188,-3,0,7910,110
7910,109,0.5324022443599,id650857ca,left_ankle,1.26004314422607,0,1,7910,110
7913,107,0.583590188600181,id650857ca,right_ankle,1.24571013450623,-3,0,7910,110
6140,109,0.124704244073247,id650857ca,left_wrist,1.34647011756897,-2,-2,6138,109
6139,108,0.213244811559072,id650857ca,left_hip,1.24419903755188,-1,0,6138,109
6137,108,0.460728187669439,id650857ca,left_ankle,1.26004314422607,1,2,6138,109
6139,108,0.558915589518282,id650857ca,right_ankle,1.24571013450623,-1,0,6138,109
22209,114,0.16571599349318,id650857ca,left_wrist,1.34647011756897,-60,-60,22149,114
22156,109,0.196783261335646,id650857ca,left_hip,1.24419903755188,-7,-2,22149,114
22154,115,0.488864743273773,id650857ca,left_ankle,1.26004314422607,-5,-6,22149,114
22157,115,0.435213307755415,id650857ca,right_ankle,1.24571013450623,-8,-9,22149,114
14077,100,0.250034190859895,id650857ca,left_wrist,1.34647011756897,47,56,14124,109
14125,107,0.243337652884904,id650857ca,left_hip,1.24419903755188,-1,1,14124,109
14124,109,0.544960811629786,id650857ca,left_ankle,1.26004314422607,0,0,14124,109
14125,108,0.542078606463043,id650857ca,right_ankle,1.24571013450623,-1,0,14124,109
4820,113,0.146289743510608,id650857ca,left_wrist,1.34647011756897,-2,-4,4818,111
4817,113,0.214021854928577,id650857ca,left_hip,1.24419903755188,1,-1,4818,111
4815,113,0.53545429467813,id650857ca,left_ankle,1.26004314422607,3,1,4818,111
4820,110,0.472802391456665,id650857ca,right_ankle,1.24571013450623,-2,-1,4818,111
2985,110,0.17955812285839,id650857ca,left_wrist,1.34647011756897,-6,-4,2979,112
2976,114,0.253755253891928,id650857ca,left_hip,1.24419903755188,3,1,2979,112
2980,108,0.500286675336604,id650857ca,left_ankle,1.26004314422607,-1,3,2979,112
2981,108,0.588101754956361,id650857ca,right_ankle,1.24571013450623,-2,2,2979,112
10671,116,0.249899091053494,id650857ca,left_wrist,1.34647011756897,2,-6,10673,108
10672,111,0.266633899870324,id650857ca,left_hip,1.24419903755188,1,-2,10673,108
10672,110,0.590650482155583,id650857ca,left_ankle,1.26004314422607,1,-1,10673,108
10674,111,0.608562736909266,id650857ca,right_ankle,1.24571013450623,-1,-4,10673,108
20664,106,0.271425359797829,id650857ca,left_wrist,1.34647011756897,-7,-7,20657,106
20660,109,0.264616013069423,id650857ca,left_hip,1.24419903755188,-3,-6,20657,106
20656,107,0.592163047847244,id650857ca,left_ankle,1.26004314422607,1,0,20657,106
20654,109,0.543847492705065,id650857ca,right_ankle,1.24571013450623,3,0,20657,106
13396,99,0.250895231042709,id650857ca,left_wrist,1.34647011756897,-8,2,13388,109
13390,107,0.254281800181613,id650857ca,left_hip,1.24419903755188,-2,0,13388,109
13387,108,0.47589649724922,id650857ca,left_ankle,1.26004314422607,1,2,13388,109
13389,107,0.505676655396173,id650857ca,right_ankle,1.24571013450623,-1,1,13388,109
21884,106,0.22025412884322,id650857ca,left_wrist,1.34647011756897,-55,-54,21829,107
21830,108,0.249427787318243,id650857ca,left_hip,1.24419903755188,-1,-2,21829,107
21828,108,0.55048806263547,id650857ca,left_ankle,1.26004314422607,1,0,21829,107
21828,111,0.562996447658545,id650857ca,right_ankle,1.24571013450623,1,-3,21829,107
16389,53,0.0880243433188811,id650857ca,left_wrist,1.34647011756897,-7,48,16382,108
16384,109,0.236198511726755,id650857ca,left_hip,1.24419903755188,-2,-3,16382,108
16382,108,0.532261073328777,id650857ca,left_ankle,1.26004314422607,0,0,16382,108
16383,107,0.542894440878805,id650857ca,right_ankle,1.24571013450623,-1,0,16382,108
7966,107,0.258074401692215,id650857ca,left_wrist,1.34647011756897,53,51,8019,105
8072,103,0.274892799068986,id650857ca,left_wrist,1.34647011756897,-53,-51,8019,105
8019,105,0.281390641899429,id650857ca,left_hip,1.24419903755188,0,0,8019,105
8018,105,0.596989261751659,id650857ca,left_ankle,1.26004314422607,1,1,8019,105
8019,102,0.650713776833151,id650857ca,right_ankle,1.24571013450623,0,3,8019,105
9669,55,0.124678200931656,id650857ca,left_wrist,1.34647011756897,2,58,9671,111
9671,108,0.213565261547698,id650857ca,left_hip,1.24419903755188,0,3,9671,111
9671,108,0.512106124940238,id650857ca,left_ankle,1.26004314422607,0,3,9671,111
9671,117,0.483852323620032,id650857ca,right_ankle,1.24571013450623,0,-6,9671,111
3526,112,0.165129437783826,id650857ca,left_wrist,1.34647011756897,-6,-7,3520,111
3519,109,0.216661654981236,id650857ca,left_hip,1.24419903755188,1,3,3520,111
3519,112,0.525139956403159,id650857ca,left_ankle,1.26004314422607,1,0,3520,111
3522,111,0.526540868176378,id650857ca,right_ankle,1.24571013450623,-2,-2,3520,111
312,102,0.268839585264812,id650857ca,left_wrist,1.34647011756897,-6,-4,306,104
307,101,0.295060302349056,id650857ca,left_hip,1.24419903755188,-1,2,306,104
306,102,0.637482202509965,id650857ca,left_ankle,1.26004314422607,0,2,306,104
302,105,0.5965157942815,id650857ca,right_ankle,1.24571013450623,4,3,306,104
16020,103,0.176205139781346,id650857ca,left_wrist,1.34647011756897,-54,-53,15966,104
15968,103,0.268946315492965,id650857ca,left_hip,1.24419903755188,-2,-1,15966,104
15965,104,0.611290677228552,id650857ca,left_ankle,1.26004314422607,1,1,15966,104
15963,103,0.58912280615182,id650857ca,right_ankle,1.24571013450623,3,4,15966,104
2341,107,0.165706109465688,id650857ca,left_wrist,1.34647011756897,-6,-5,2335,108
2336,107,0.241493538091251,id650857ca,left_hip,1.24419903755188,-1,0,2335,108
2335,105,0.474509530328543,id650857ca,left_ankle,1.26004314422607,0,3,2335,108
2335,107,0.54006726528725,id650857ca,right_ankle,1.24571013450623,0,1,2335,108
10016,117,0.246412481548224,id650857ca,left_wrist,1.34647011756897,1,-6,10017,110
10017,111,0.273640095765838,id650857ca,left_hip,1.24419903755188,0,-1,10017,110
10017,110,0.572472931369276,id650857ca,left_ankle,1.26004314422607,0,0,10017,110
10018,111,0.59662710403966,id650857ca,right_ankle,1.24571013450623,-1,-2,10017,110
14390,61,0.102340562576015,id650857ca,left_wrist,1.34647011756897,-51,-6,14339,106
14339,107,0.279991428768068,id650857ca,left_hip,1.24419903755188,0,-1,14339,106
14339,106,0.624225372315163,id650857ca,left_ankle,1.26004314422607,0,0,14339,106
14338,104,0.642969591966374,id650857ca,right_ankle,1.24571013450623,1,3,14339,106
20217,93,0.250997351376202,idff99de96,left_wrist,1.17202091217041,4,11,20221,100
20221,100,0.343859209213298,idff99de96,left_hip,1.1143000125885,0,0,20221,100
20218,99,0.670407627430018,idff99de96,left_ankle,1.11013913154602,3,4,20221,100
20218,102,0.770053319604438,idff99de96,right_ankle,1.12609910964966,3,1,20221,100
10143,137,0.386261665046152,idff99de96,left_wrist,1.17202091217041,-8,-46,10135,99
10142,93,0.389638940030435,idff99de96,left_hip,1.1143000125885,-7,-1,10135,99
10132,99,0.799080945429292,idff99de96,left_ankle,1.11013913154602,3,3,10135,99
10130,100,0.855582136618648,idff99de96,right_ankle,1.12609910964966,5,4,10135,99
9942,100,0.384137795680738,idff99de96,left_wrist,1.17202091217041,-12,-8,9930,104
9927,104,0.286834422126762,idff99de96,left_hip,1.1143000125885,3,3,9930,104
9927,103,0.7198174769872,idff99de96,left_ankle,1.11013913154602,3,4,9930,104
9928,103,0.786794494729902,idff99de96,right_ankle,1.12609910964966,2,3,9930,104
3586,109,0.252598491751323,idff99de96,left_wrist,1.17202091217041,6,7,3592,110
3592,113,0.403310303302942,idff99de96,left_hip,1.1143000125885,0,-3,3592,110
3591,109,0.651412734042003,idff99de96,left_ankle,1.11013913154602,1,2,3592,110
3593,109,0.790474553520237,idff99de96,right_ankle,1.12609910964966,-1,0,3592,110
15429,103,0.296046745253749,idff99de96,left_wrist,1.17202091217041,1,0,15430,102
15430,103,0.27676711744593,idff99de96,left_hip,1.1143000125885,0,-1,15430,102
15428,104,0.609608561361655,idff99de96,left_ankle,1.11013913154602,2,0,15430,102
15428,102,0.706526474403202,idff99de96,right_ankle,1.12609910964966,2,2,15430,102
9352,116,0.16574807450669,idff99de96,left_wrist,1.17202091217041,-39,-57,9313,98
9307,102,0.315399737219364,idff99de96,left_hip,1.1143000125885,6,2,9313,98
9309,101,0.729580465341081,idff99de96,left_ankle,1.11013913154602,4,1,9313,98
9308,104,0.737477151006517,idff99de96,right_ankle,1.12609910964966,5,-1,9313,98
10408,139,0.302990564690217,idff99de96,left_wrist,1.17202091217041,25,-10,10433,104
10432,106,0.351254257607238,idff99de96,left_hip,1.1143000125885,1,-1,10433,104
10432,102,0.72115609157429,idff99de96,left_ankle,1.11013913154602,1,3,10433,104
10433,103,0.875142976482538,idff99de96,right_ankle,1.12609910964966,0,1,10433,104
4371,56,0.115008119591083,idff99de96,left_wrist,1.17202091217041,-47,2,4324,105
4322,110,0.355151334282731,idff99de96,left_hip,1.1143000125885,2,-3,4324,105
4322,104,0.772025338258979,idff99de96,left_ankle,1.11013913154602,2,3,4324,105
4324,101,0.801765626539294,idff99de96,right_ankle,1.12609910964966,0,4,4324,105
4735,54,0.0724581869268494,idff99de96,left_wrist,1.17202091217041,1,46,4736,99
4734,101,0.368563464011946,idff99de96,left_hip,1.1143000125885,2,0,4736,99
4733,101,0.644963471548597,idff99de96,left_ankle,1.11013913154602,3,1,4736,99
4732,102,0.864191432010451,idff99de96,right_ankle,1.12609910964966,4,1,4736,99
12157,100,0.284312635651677,idff99de96,left_wrist,1.17202091217041,-10,-8,12147,102
12145,103,0.349753931788931,idff99de96,left_hip,1.1143000125885,2,1,12147,102
12145,101,0.791750543645424,idff99de96,left_ankle,1.11013913154602,2,3,12147,102
12144,103,0.842579691144652,idff99de96,right_ankle,1.12609910964966,3,2,12147,102
11756,103,0.328920759491191,idff99de96,left_wrist,1.17202091217041,-13,-14,11743,102
11743,102,0.323812117194693,idff99de96,left_hip,1.1143000125885,0,0,11743,102
11742,102,0.627389834151056,idff99de96,left_ankle,1.11013913154602,1,1,11743,102
11743,100,0.888935769695325,idff99de96,right_ankle,1.12609910964966,0,2,11743,102
1694,98,0.247567424873412,idff99de96,left_wrist,1.17202091217041,9,11,1703,100
1700,102,0.376413878815316,idff99de96,left_hip,1.1143000125885,3,1,1703,100
1698,101,0.742497963642866,idff99de96,left_ankle,1.11013913154602,5,4,1703,100
1698,101,0.730362297537412,idff99de96,right_ankle,1.12609910964966,5,4,1703,100
874,108,0.276281651444707,idff99de96,left_wrist,1.17202091217041,2,6,876,112
875,113,0.306441436325829,idff99de96,left_hip,1.1143000125885,1,0,876,112
870,116,0.704854778991816,idff99de96,left_ankle,1.11013913154602,6,2,876,112
880,107,0.676185087063773,idff99de96,right_ankle,1.12609910964966,-4,1,876,112
13141,105,0.323698402011207,idff99de96,left_wrist,1.17202091217041,3,1,13144,103
13142,103,0.378532381370681,idff99de96,left_hip,1.1143000125885,2,2,13144,103
13142,103,0.74909274436414,idff99de96,left_ankle,1.11013913154602,2,2,13144,103
13143,101,0.871205474676917,idff99de96,right_ankle,1.12609910964966,1,3,13144,103
18931,112,0.177681205374146,idff99de96,left_wrist,1.17202091217041,2,-14,18933,96
18937,97,0.322745804579818,idff99de96,left_hip,1.1143000125885,-4,-5,18933,96
18930,99,0.716452122202887,idff99de96,left_ankle,1.11013913154602,3,0,18933,96
18931,97,0.691708680231776,idff99de96,right_ankle,1.12609910964966,2,1,18933,96
12256,102,0.296527232206611,idff99de96,left_wrist,1.17202091217041,-8,-6,12248,104
12247,101,0.332466247396258,idff99de96,left_hip,1.1143000125885,1,4,12248,104
12245,103,0.754174366052467,idff99de96,left_ankle,1.11013913154602,3,4,12248,104
12246,102,0.79005731230252,idff99de96,right_ankle,1.12609910964966,2,4,12248,104
11456,95,0.325925649226863,idff99de96,left_wrist,1.17202091217041,-11,-5,11445,101
11445,99,0.390313889539367,idff99de96,left_hip,1.1143000125885,0,2,11445,101
11444,99,0.65789311055289,idff99de96,left_ankle,1.11013913154602,1,3,11445,101
11442,99,0.803608698768669,idff99de96,right_ankle,1.12609910964966,3,5,11445,101
10758,97,0.418872041279579,idff99de96,left_wrist,1.17202091217041,-19,-8,10739,108
10740,105,0.319140170903569,idff99de96,left_hip,1.1143000125885,-1,2,10739,108
10740,104,0.776589628506456,idff99de96,left_ankle,1.11013913154602,-1,3,10739,108
10743,101,0.843462880497045,idff99de96,right_ankle,1.12609910964966,-4,3,10739,108
20018,52,0.213251894930628,idff99de96,left_wrist,1.17202091217041,2,52,20020,102
20021,101,0.364715829750648,idff99de96,left_hip,1.1143000125885,-1,0,20020,102
20018,102,0.742412497912018,idff99de96,left_ankle,1.11013913154602,2,2,20020,102
20017,103,0.883207498552942,idff99de96,right_ankle,1.12609910964966,3,2,20020,102
10322,86,0.245573280470126,idff99de96,left_wrist,1.17202091217041,10,26,10332,102
10328,105,0.38132144337692,idff99de96,left_hip,1.1143000125885,4,1,10332,102
10327,106,0.711549554615582,idff99de96,left_ankle,1.11013913154602,5,1,10332,102
10329,105,0.841977527778656,idff99de96,right_ankle,1.12609910964966,3,0,10332,102
12547,93,0.129988846575951,id4ea159a8,left_wrist,1.01547694206238,-1,0,12546,94
12545,96,0.35900047367272,id4ea159a8,left_hip,1.00612783432007,1,-1,12546,94
12544,96,0.84601573205221,id4ea159a8,left_ankle,0.979902982711792,2,0,12546,94
12544,96,0.749272531902866,id4ea159a8,right_ankle,0.982290983200073,2,0,12546,94
11019,96,0.207540268779394,id4ea159a8,left_wrist,1.01547694206238,-4,-1,11015,99
11016,98,0.331643597059292,id4ea159a8,left_hip,1.00612783432007,-1,0,11015,99
11015,98,0.784609847221659,id4ea159a8,left_ankle,0.979902982711792,0,1,11015,99
11014,97,0.743903801495109,id4ea159a8,right_ankle,0.982290983200073,1,3,11015,99
4380,92,0.203445360014303,id4ea159a8,left_wrist,1.01547694206238,0,4,4380,96
4381,95,0.431860946445675,id4ea159a8,left_hip,1.00612783432007,-1,0,4380,96
4379,96,0.923035231814172,id4ea159a8,left_ankle,0.979902982711792,1,1,4380,96
4377,96,0.789869559629783,id4ea159a8,right_ankle,0.982290983200073,3,3,4380,96
4758,97,0.179455670799866,id4ea159a8,left_wrist,1.01547694206238,0,0,4758,97
4759,97,0.423851804475627,id4ea159a8,left_hip,1.00612783432007,-1,-1,4758,97
4756,98,0.875155011408317,id4ea159a8,left_ankle,0.979902982711792,2,1,4758,97
4756,96,0.821397989007988,id4ea159a8,right_ankle,0.982290983200073,2,3,4758,97
13398,91,0.20405818496081,id4ea159a8,left_wrist,1.01547694206238,-4,0,13394,95
13396,94,0.368425717514047,id4ea159a8,left_hip,1.00612783432007,-2,-1,13394,95
13393,97,0.794647797156192,id4ea159a8,left_ankle,0.979902982711792,1,-1,13394,95
13393,95,0.689171092542845,id4ea159a8,right_ankle,0.982290983200073,1,1,13394,95
8356,95,0.255471351453674,id4ea159a8,left_wrist,1.01547694206238,1,1,8357,95
8357,95,0.380444518300081,id4ea159a8,left_hip,1.00612783432007,0,0,8357,95
8356,96,0.790818995543205,id4ea159a8,left_ankle,0.979902982711792,1,0,8357,95
8353,96,0.640559531065394,id4ea159a8,right_ankle,0.982290983200073,4,3,8357,95
3242,97,0.15895547379856,id4ea159a8,left_wrist,1.01547694206238,2,-3,3244,92
3243,95,0.37921394680106,id4ea159a8,left_hip,1.00612783432007,1,-2,3244,92
3243,93,0.874661409494728,id4ea159a8,left_ankle,0.979902982711792,1,0,3244,92
3242,94,0.820734654622877,id4ea159a8,right_ankle,0.982290983200073,2,0,3244,92
13684,88,0.1798400719191,id4ea159a8,left_wrist,1.01547694206238,-7,-1,13677,94
13679,93,0.364868789455935,id4ea159a8,left_hip,1.00612783432007,-2,-1,13677,94
13676,94,0.802590844265511,id4ea159a8,left_ankle,0.979902982711792,1,1,13677,94
13676,95,0.699181378063668,id4ea159a8,right_ankle,0.982290983200073,1,0,13677,94
2002,104,0.216549371132641,id4ea159a8,left_wrist,1.01547694206238,7,-2,2009,95
2007,97,0.396540002214152,id4ea159a8,left_hip,1.00612783432007,2,0,2009,95
2007,95,0.820422157626296,id4ea159a8,left_ankle,0.979902982711792,2,2,2009,95
2007,95,0.814737620328892,id4ea159a8,right_ankle,0.982290983200073,2,2,2009,95
15873,92,0.114956890442578,id4ea159a8,left_wrist,1.01547694206238,-3,1,15870,96
15871,96,0.394033373605884,id4ea159a8,left_hip,1.00612783432007,-1,-1,15870,96
15869,96,0.84877788508173,id4ea159a8,left_ankle,0.979902982711792,1,1,15870,96
15869,97,0.744450405827549,id4ea159a8,right_ankle,0.982290983200073,1,0,15870,96
11304,98,0.20464739979816,id4ea159a8,left_wrist,1.01547694206238,2,-1,11306,95
11303,97,0.331732438986878,id4ea159a8,left_hip,1.00612783432007,3,1,11306,95
11304,96,0.804012437455797,id4ea159a8,left_ankle,0.979902982711792,2,1,11306,95
11303,96,0.718613562373262,id4ea159a8,right_ankle,0.982290983200073,3,2,11306,95
10349,97,0.184755986589599,id4ea159a8,left_wrist,1.01547694206238,-3,-3,10346,97
10346,97,0.373057827757341,id4ea159a8,left_hip,1.00612783432007,0,0,10346,97
10345,97,0.793425734770295,id4ea159a8,left_ankle,0.979902982711792,1,1,10346,97
10345,96,0.790525731676495,id4ea159a8,right_ankle,0.982290983200073,1,2,10346,97
6091,95,0.200763324186105,id4ea159a8,left_wrist,1.01547694206238,2,1,6093,94
6093,94,0.379477565270695,id4ea159a8,left_hip,1.00612783432007,0,0,6093,94
6091,95,0.882757714629314,id4ea159a8,left_ankle,0.979902982711792,2,1,6093,94
6091,95,0.810062949301827,id4ea159a8,right_ankle,0.982290983200073,2,1,6093,94
8450,97,0.202626139684859,id4ea159a8,left_wrist,1.01547694206238,1,0,8451,96
8451,96,0.346692961406949,id4ea159a8,left_hip,1.00612783432007,0,0,8451,96
8451,95,0.717402250803135,id4ea159a8,left_ankle,0.979902982711792,0,1,8451,96
8448,97,0.710330037983639,id4ea159a8,right_ankle,0.982290983200073,3,2,8451,96
9213,96,0.185990312329392,id4ea159a8,left_wrist,1.01547694206238,-1,1,9212,98
9215,95,0.332754185714015,id4ea159a8,left_hip,1.00612783432007,-3,0,9212,98
9212,97,0.762346723884086,id4ea159a8,left_ankle,0.979902982711792,0,1,9212,98
9211,97,0.738407544670498,id4ea159a8,right_ankle,0.982290983200073,1,2,9212,98
3338,92,0.218942293513671,id4ea159a8,left_wrist,1.01547694206238,-3,1,3335,96
3337,93,0.389310193588579,id4ea159a8,left_hip,1.00612783432007,-2,1,3335,96
3335,95,0.833576841370385,id4ea159a8,left_ankle,0.979902982711792,0,1,3335,96
3335,94,0.739717569764472,id4ea159a8,right_ankle,0.982290983200073,0,2,3335,96
9688,100,0.184747048325157,id4ea159a8,left_wrist,1.01547694206238,-1,-5,9687,96
9688,96,0.379211718331767,id4ea159a8,left_hip,1.00612783432007,-1,-1,9687,96
9687,95,0.786952009169479,id4ea159a8,left_ankle,0.979902982711792,0,1,9687,96
9687,94,0.786608868699011,id4ea159a8,right_ankle,0.982290983200073,0,2,9687,96
1443,97,0.176666892573409,id4ea159a8,left_wrist,1.01547694206238,0,-1,1443,96
1443,96,0.397652241465945,id4ea159a8,left_hip,1.00612783432007,0,0,1443,96
1442,96,0.864126584469974,id4ea159a8,left_ankle,0.979902982711792,1,1,1443,96
1442,95,0.821706619290719,id4ea159a8,right_ankle,0.982290983200073,1,2,1443,96
5234,94,0.170523238388133,id4ea159a8,left_wrist,1.01547694206238,-1,0,5233,95
5233,95,0.409743360292959,id4ea159a8,left_hip,1.00612783432007,0,0,5233,95
5232,95,0.800839764030499,id4ea159a8,left_ankle,0.979902982711792,1,1,5233,95
5230,96,0.862944332425902,id4ea159a8,right_ankle,0.982290983200073,3,2,5233,95
4001,95,0.187136733513771,id4ea159a8,left_wrist,1.01547694206238,-2,-1,3999,96
4000,95,0.346998510369218,id4ea159a8,left_hip,1.00612783432007,-1,0,3999,96
3997,97,0.798019000916712,id4ea159a8,left_ankle,0.979902982711792,2,1,3999,96
3997,96,0.81655973803614,id4ea159a8,right_ankle,0.982290983200073,2,2,3999,96
6022,116,0.229787275494,idc91a49d0,left_wrist,1.0969409942627,1,0,6023,115
6024,113,0.265989537278674,idc91a49d0,left_hip,1.07951521873474,-1,1,6023,115
6022,114,0.559697657347585,idc91a49d0,left_ankle,1.07094788551331,1,2,6023,115
6018,115,0.59955293081678,idc91a49d0,right_ankle,1.11213994026184,5,5,6023,115
18683,110,0.184200955784364,idc91a49d0,left_wrist,1.0969409942627,-3,-4,18680,109
18680,110,0.312896810360438,idc91a49d0,left_hip,1.07951521873474,0,-1,18680,109
18681,109,0.617733871948152,idc91a49d0,left_ankle,1.07094788551331,-1,-1,18680,109
18681,108,0.729423001748011,idc91a49d0,right_ankle,1.11213994026184,-1,0,18680,109
9342,115,0.201035099058786,idc91a49d0,left_wrist,1.0969409942627,2,5,9344,118
9345,117,0.240361657741549,idc91a49d0,left_hip,1.07951521873474,-1,0,9344,118
9342,117,0.536884447135968,idc91a49d0,left_ankle,1.07094788551331,2,3,9344,118
9342,114,0.555744841562695,idc91a49d0,right_ankle,1.11213994026184,2,6,9344,118
16279,108,0.193496605427674,idc91a49d0,left_wrist,1.0969409942627,-5,-2,16274,111
16274,111,0.304583106039853,idc91a49d0,left_hip,1.07951521873474,0,0,16274,111
16273,112,0.736133003386941,idc91a49d0,left_ankle,1.07094788551331,1,0,16274,111
16275,108,0.719752916040512,idc91a49d0,right_ankle,1.11213994026184,-1,2,16274,111
18465,110,0.243687639177049,idc91a49d0,left_wrist,1.0969409942627,-4,-3,18461,111
18462,110,0.299967711860934,idc91a49d0,left_hip,1.07951521873474,-1,0,18461,111
18462,110,0.692108262014007,idc91a49d0,left_ankle,1.07094788551331,-1,0,18461,111
18462,109,0.72289381565354,idc91a49d0,right_ankle,1.11213994026184,-1,1,18461,111
8681,110,0.247736993822117,idc91a49d0,left_wrist,1.0969409942627,-2,-1,8679,111
8679,111,0.275459862257485,idc91a49d0,left_hip,1.07951521873474,0,0,8679,111
8677,112,0.68222402088934,idc91a49d0,left_ankle,1.07094788551331,2,1,8679,111
8677,111,0.656231617964335,idc91a49d0,right_ankle,1.11213994026184,2,2,8679,111
1379,109,0.1598477770331,idc91a49d0,left_wrist,1.0969409942627,0,5,1379,114
1379,113,0.267351233417803,idc91a49d0,left_hip,1.07951521873474,0,1,1379,114
1377,113,0.634312175906495,idc91a49d0,left_ankle,1.07094788551331,2,3,1379,114
1377,112,0.688598993280663,idc91a49d0,right_ankle,1.11213994026184,2,4,1379,114
7037,112,0.16721436713045,idc91a49d0,left_wrist,1.0969409942627,-1,-2,7036,111
7036,111,0.282712080891161,idc91a49d0,left_hip,1.07951521873474,0,0,7036,111
7034,112,0.638950875243098,idc91a49d0,left_ankle,1.07094788551331,2,1,7036,111
7035,111,0.669262812776339,idc91a49d0,right_ankle,1.11213994026184,1,1,7036,111
15088,110,0.236961175390409,idc91a49d0,left_wrist,1.0969409942627,-4,-3,15084,111
15086,109,0.297400226489772,idc91a49d0,left_hip,1.07951521873474,-2,0,15084,111
15085,110,0.649148893609718,idc91a49d0,left_ankle,1.07094788551331,-1,0,15084,111
15084,110,0.663734009142917,idc91a49d0,right_ankle,1.11213994026184,0,1,15084,111
7037,112,0.16721436713045,idc91a49d0,left_wrist,1.0969409942627,-1,-2,7036,111
7036,111,0.282712080891161,idc91a49d0,left_hip,1.07951521873474,0,0,7036,111
7034,112,0.638950875243098,idc91a49d0,left_ankle,1.07094788551331,2,1,7036,111
7035,111,0.669262812776339,idc91a49d0,right_ankle,1.11213994026184,1,1,7036,111
13218,111,0.23505691950069,idc91a49d0,left_wrist,1.0969409942627,-3,-3,13215,111
13216,110,0.282837543977103,idc91a49d0,left_hip,1.07951521873474,-1,0,13215,111
13215,109,0.640823873306128,idc91a49d0,left_ankle,1.07094788551331,0,2,13215,111
13214,111,0.652947323846694,idc91a49d0,right_ankle,1.11213994026184,1,1,13215,111
17592,111,0.189891356770337,idc91a49d0,left_wrist,1.0969409942627,-2,-5,17590,108
17590,109,0.303251495390005,idc91a49d0,left_hip,1.07951521873474,0,-1,17590,108
17590,110,0.633723550894666,idc91a49d0,left_ankle,1.07094788551331,0,-2,17590,108
17590,110,0.721265135847126,idc91a49d0,right_ankle,1.11213994026184,0,-2,17590,108
17919,111,0.250389021011187,idc91a49d0,left_wrist,1.0969409942627,-2,-3,17917,110
17917,110,0.31457047337718,idc91a49d0,left_hip,1.07951521873474,0,0,17917,110
17916,110,0.732932027129476,idc91a49d0,left_ankle,1.07094788551331,1,1,17917,110
17916,112,0.727233676482792,idc91a49d0,right_ankle,1.11213994026184,1,-1,17917,110
8241,111,0.237919652493114,idc91a49d0,left_wrist,1.0969409942627,-1,-2,8240,110
8240,110,0.295302347319135,idc91a49d0,left_hip,1.07951521873474,0,0,8240,110
8239,110,0.671034933595402,idc91a49d0,left_ankle,1.07094788551331,1,1,8240,110
8238,111,0.732116256047385,idc91a49d0,right_ankle,1.11213994026184,2,1,8240,110
8022,111,0.168603315624726,idc91a49d0,left_wrist,1.0969409942627,-2,-2,8020,111
8020,111,0.281286449955556,idc91a49d0,left_hip,1.07951521873474,0,0,8020,111
8017,113,0.652009656592243,idc91a49d0,left_ankle,1.07094788551331,3,1,8020,111
8018,111,0.65008139830642,idc91a49d0,right_ankle,1.11213994026184,2,2,8020,111
18683,110,0.184200955784364,idc91a49d0,left_wrist,1.0969409942627,-3,-4,18680,109
18680,110,0.312896810360438,idc91a49d0,left_hip,1.07951521873474,0,-1,18680,109
18681,109,0.617733871948152,idc91a49d0,left_ankle,1.07094788551331,-1,-1,18680,109
18681,108,0.729423001748011,idc91a49d0,right_ankle,1.11213994026184,-1,0,18680,109
13437,112,0.227769528830219,idc91a49d0,left_wrist,1.0969409942627,-1,-3,13436,110
13436,111,0.284735702812079,idc91a49d0,left_hip,1.07951521873474,0,-1,13436,110
13436,110,0.646046616900552,idc91a49d0,left_ankle,1.07094788551331,0,0,13436,110
13434,111,0.710668905280127,idc91a49d0,right_ankle,1.11213994026184,2,1,13436,110
15524,107,0.179332527871236,idc91a49d0,left_wrist,1.0969409942627,-5,-4,15519,108
15519,109,0.315227249317662,idc91a49d0,left_hip,1.07951521873474,0,-1,15519,108
15519,109,0.692210486408487,idc91a49d0,left_ankle,1.07094788551331,0,-1,15519,108
15518,110,0.737168346464344,idc91a49d0,right_ankle,1.11213994026184,1,-1,15519,108
12668,111,0.204097018453074,idc91a49d0,left_wrist,1.0969409942627,-2,-1,12666,112
12667,111,0.264867679967729,idc91a49d0,left_hip,1.07951521873474,-1,0,12666,112
12663,115,0.641141131975422,idc91a49d0,left_ankle,1.07094788551331,3,0,12666,112
12664,113,0.712896694490439,idc91a49d0,right_ankle,1.11213994026184,2,1,12666,112
18900,110,0.249082236381938,idc91a49d0,left_wrist,1.0969409942627,-4,-4,18896,110
18897,110,0.305487904090433,idc91a49d0,left_hip,1.07951521873474,-1,-1,18896,110
18896,111,0.673093793840429,idc91a49d0,left_ankle,1.07094788551331,0,-1,18896,110
18897,110,0.645007966473372,idc91a49d0,right_ankle,1.11213994026184,-1,-1,18896,110
6992,104,0.18242450795293,id1c7e64ad,left_wrist,1.46792101860046,-1,-1,6991,104
6990,104,0.271146793001726,id1c7e64ad,left_hip,1.4336268901825,1,1,6991,104
6989,104,0.637381102679657,id1c7e64ad,left_ankle,1.41085600852966,2,2,6991,104
6987,106,0.620475187114509,id1c7e64ad,right_ankle,1.42870306968689,4,2,6991,104
4632,106,0.219374086235525,id1c7e64ad,left_wrist,1.46792101860046,-2,-2,4630,106
4630,105,0.253358463898585,id1c7e64ad,left_hip,1.4336268901825,0,1,4630,106
4629,106,0.655127536122301,id1c7e64ad,left_ankle,1.41085600852966,1,1,4630,106
4630,106,0.672589436066653,id1c7e64ad,right_ankle,1.42870306968689,0,0,4630,106
21124,105,0.273392243395752,id1c7e64ad,left_wrist,1.46792101860046,-1,-5,21123,101
21126,101,0.296680345392306,id1c7e64ad,left_hip,1.4336268901825,-3,-3,21123,101
21124,101,0.693448125617855,id1c7e64ad,left_ankle,1.41085600852966,-1,-1,21123,101
21123,101,0.711331046939163,id1c7e64ad,right_ankle,1.42870306968689,0,0,21123,101
12085,101,0.270103198193485,id1c7e64ad,left_wrist,1.46792101860046,-1,-2,12084,100
12086,98,0.287211791940066,id1c7e64ad,left_hip,1.4336268901825,-2,0,12084,100
12084,101,0.698620993590598,id1c7e64ad,left_ankle,1.41085600852966,0,-1,12084,100
12082,102,0.690258817851071,id1c7e64ad,right_ankle,1.42870306968689,2,0,12084,100
20927,99,0.291455065735596,id1c7e64ad,left_wrist,1.46792101860046,-3,-2,20924,100
20927,100,0.293806666556692,id1c7e64ad,left_hip,1.4336268901825,-3,-3,20924,100
20923,101,0.706352792501736,id1c7e64ad,left_ankle,1.41085600852966,1,0,20924,100
20921,102,0.705368885594128,id1c7e64ad,right_ankle,1.42870306968689,3,1,20924,100
4632,106,0.219374086235525,id1c7e64ad,left_wrist,1.46792101860046,-2,-2,4630,106
4630,105,0.253358463898585,id1c7e64ad,left_hip,1.4336268901825,0,1,4630,106
4629,106,0.655127536122301,id1c7e64ad,left_ankle,1.41085600852966,1,1,4630,106
4630,106,0.672589436066653,id1c7e64ad,right_ankle,1.42870306968689,0,0,4630,106
18049,102,0.216200886296844,id1c7e64ad,left_wrist,1.46792101860046,-2,-2,18047,102
18051,100,0.271360226335398,id1c7e64ad,left_hip,1.4336268901825,-4,-2,18047,102
18048,101,0.68378961439202,id1c7e64ad,left_ankle,1.41085600852966,-1,0,18047,102
18047,103,0.67778418230785,id1c7e64ad,right_ankle,1.42870306968689,0,-1,18047,102
17345,100,0.272982406208906,id1c7e64ad,left_wrist,1.46792101860046,-3,-3,17342,100
17345,101,0.286125377238881,id1c7e64ad,left_hip,1.4336268901825,-3,-4,17342,100
17342,100,0.666533882199145,id1c7e64ad,left_ankle,1.41085600852966,0,0,17342,100
17341,99,0.641755915162058,id1c7e64ad,right_ankle,1.42870306968689,1,2,17342,100
22531,100,0.197762709821846,id1c7e64ad,left_wrist,1.46792101860046,-3,-3,22528,100
22531,100,0.291133779751652,id1c7e64ad,left_hip,1.4336268901825,-3,-3,22528,100
22528,99,0.747399013022109,id1c7e64ad,left_ankle,1.41085600852966,0,1,22528,100
22528,97,0.714667982686301,id1c7e64ad,right_ankle,1.42870306968689,0,3,22528,100
13085,99,0.173989528145909,id1c7e64ad,left_wrist,1.46792101860046,-2,0,13083,101
13084,101,0.264187713024168,id1c7e64ad,left_hip,1.4336268901825,-1,-1,13083,101
13082,102,0.725118114585961,id1c7e64ad,left_ankle,1.41085600852966,1,0,13083,101
13082,101,0.602077645126153,id1c7e64ad,right_ankle,1.42870306968689,1,1,13083,101
17046,103,0.298474133851177,id1c7e64ad,left_wrist,1.46792101860046,-3,-5,17043,101
17046,101,0.275713395380002,id1c7e64ad,left_hip,1.4336268901825,-3,-3,17043,101
17044,101,0.679442698606192,id1c7e64ad,left_ankle,1.41085600852966,-1,-1,17043,101
17043,100,0.702065982776246,id1c7e64ad,right_ankle,1.42870306968689,0,1,17043,101
9350,104,0.183256082137726,id1c7e64ad,left_wrist,1.46792101860046,0,-3,9350,101
9348,103,0.266345132665003,id1c7e64ad,left_hip,1.4336268901825,2,0,9350,101
9348,103,0.691843308417554,id1c7e64ad,left_ankle,1.41085600852966,2,0,9350,101
9348,102,0.627129008077602,id1c7e64ad,right_ankle,1.42870306968689,2,1,9350,101
2593,108,0.235241891107674,id1c7e64ad,left_wrist,1.46792101860046,-49,-51,2544,106
2544,107,0.259017218849798,id1c7e64ad,left_hip,1.4336268901825,0,-1,2544,106
2544,105,0.575508809793306,id1c7e64ad,left_ankle,1.41085600852966,0,1,2544,106
2542,107,0.676696372340406,id1c7e64ad,right_ankle,1.42870306968689,2,1,2544,106
22130,101,0.239552820434502,id1c7e64ad,left_wrist,1.46792101860046,-3,-3,22127,101
22130,100,0.292333536504083,id1c7e64ad,left_hip,1.4336268901825,-3,-2,22127,101
22128,101,0.658966995838092,id1c7e64ad,left_ankle,1.41085600852966,-1,-1,22127,101
22126,102,0.67469137762547,id1c7e64ad,right_ankle,1.42870306968689,1,0,22127,101
6786,103,0.210280575646774,id1c7e64ad,left_wrist,1.46792101860046,-2,0,6784,105
6783,105,0.274258492386292,id1c7e64ad,left_hip,1.4336268901825,1,1,6784,105
6783,104,0.630958343401092,id1c7e64ad,left_ankle,1.41085600852966,1,2,6784,105
6781,106,0.707651235983652,id1c7e64ad,right_ankle,1.42870306968689,3,2,6784,105
14098,104,0.161318014207559,id1c7e64ad,left_wrist,1.46792101860046,-1,-2,14097,103
14097,104,0.235558370834333,id1c7e64ad,left_hip,1.4336268901825,0,-1,14097,103
14097,102,0.707983168119437,id1c7e64ad,left_ankle,1.41085600852966,0,1,14097,103
14096,103,0.659596059922299,id1c7e64ad,right_ankle,1.42870306968689,1,1,14097,103
2755,105,0.224031157027331,id1c7e64ad,left_wrist,1.46792101860046,-1,-3,2754,103
2753,105,0.242523338751969,id1c7e64ad,left_hip,1.4336268901825,1,-1,2754,103
2753,104,0.643775631423412,id1c7e64ad,left_ankle,1.41085600852966,1,0,2754,103
2752,106,0.630792868765547,id1c7e64ad,right_ankle,1.42870306968689,2,-1,2754,103
20112,105,0.310999393430608,id1c7e64ad,left_wrist,1.46792101860046,-2,-3,20110,104
20111,105,0.282235544599686,id1c7e64ad,left_hip,1.4336268901825,-1,-2,20110,104
20110,103,0.621924677362245,id1c7e64ad,left_ankle,1.41085600852966,0,1,20110,104
20111,102,0.587151488845995,id1c7e64ad,right_ankle,1.42870306968689,-1,1,20110,104
7664,54,0.11394059178829,id1c7e64ad,left_wrist,1.46792101860046,-51,-2,7613,103
7613,102,0.247308012514616,id1c7e64ad,left_hip,1.4336268901825,0,1,7613,103
7614,103,0.679227650013911,id1c7e64ad,left_ankle,1.41085600852966,-1,-1,7613,103
7614,102,0.686888788945927,id1c7e64ad,right_ankle,1.42870306968689,-1,0,7613,103
18670,104,0.283512849412558,id1c7e64ad,left_wrist,1.46792101860046,-1,-2,18669,103
18671,103,0.242939765199547,id1c7e64ad,left_hip,1.4336268901825,-2,-2,18669,103
18668,105,0.674770953349377,id1c7e64ad,left_ankle,1.41085600852966,1,-1,18669,103
18669,104,0.568261799701273,id1c7e64ad,right_ankle,1.42870306968689,0,-1,18669,103
5115,95,0.175193168463763,id8e66893c,left_wrist,1.02773714065552,13,14,5128,96
5127,96,0.390261978872258,id8e66893c,left_hip,1.02207207679749,1,1,5128,96
5128,96,0.532876300237529,id8e66893c,left_ankle,1.02687501907349,0,0,5128,96
5125,99,0.586430387106402,id8e66893c,right_ankle,1.03952789306641,3,0,5128,96
4251,97,0.150482431608365,id8e66893c,left_wrist,1.02773714065552,12,13,4263,98
4263,97,0.371719339399806,id8e66893c,left_hip,1.02207207679749,0,1,4263,98
4264,97,0.640457106149863,id8e66893c,left_ankle,1.02687501907349,-1,0,4263,98
4263,97,0.611516397879104,id8e66893c,right_ankle,1.03952789306641,0,1,4263,98
5021,95,0.180563959274531,id8e66893c,left_wrist,1.02773714065552,12,13,5033,96
5032,96,0.395809974649463,id8e66893c,left_hip,1.02207207679749,1,1,5033,96
5033,96,0.616786204557814,id8e66893c,left_ankle,1.02687501907349,0,0,5033,96
5031,95,0.63450628559439,id8e66893c,right_ankle,1.03952789306641,2,3,5033,96
7070,97,0.184997671662459,id8e66893c,left_wrist,1.02773714065552,-7,-7,7063,97
7068,97,0.354627752525505,id8e66893c,left_hip,1.02207207679749,-5,-5,7063,97
7069,96,0.533977893743402,id8e66893c,left_ankle,1.02687501907349,-6,-5,7063,97
7066,99,0.577743183796284,id8e66893c,right_ankle,1.03952789306641,-3,-5,7063,97
10886,95,0.304822644772168,id8e66893c,left_wrist,1.02773714065552,-5,-3,10881,97
10887,99,0.263445518083853,id8e66893c,left_hip,1.02207207679749,-6,-8,10881,97
10887,96,0.510790806494444,id8e66893c,left_ankle,1.02687501907349,-6,-5,10881,97
10884,102,0.474666663821749,id8e66893c,right_ankle,1.03952789306641,-3,-8,10881,97
17187,100,0.358756459030095,id8e66893c,left_wrist,1.02773714065552,-5,-7,17182,98
17188,98,0.3518935174586,id8e66893c,left_hip,1.02207207679749,-6,-6,17182,98
17187,99,0.605503086454045,id8e66893c,left_ankle,1.02687501907349,-5,-6,17182,98
17187,99,0.666173321081772,id8e66893c,right_ankle,1.03952789306641,-5,-6,17182,98
4069,100,0.190290369176762,id8e66893c,left_wrist,1.02773714065552,-5,-6,4064,99
4068,98,0.336747274340429,id8e66893c,left_hip,1.02207207679749,-4,-3,4064,99
4070,98,0.576193370782367,id8e66893c,left_ankle,1.02687501907349,-6,-5,4064,99
4070,99,0.483541474481866,id8e66893c,right_ankle,1.03952789306641,-6,-6,4064,99
17091,97,0.259236820339448,id8e66893c,left_wrist,1.02773714065552,-4,-5,17087,96
17090,99,0.361810415151314,id8e66893c,left_hip,1.02207207679749,-3,-6,17087,96
17090,98,0.588039818286887,id8e66893c,left_ankle,1.02687501907349,-3,-5,17087,96
17090,98,0.655287429854704,id8e66893c,right_ankle,1.03952789306641,-3,-5,17087,96
17869,99,0.285508205801833,id8e66893c,left_wrist,1.02773714065552,-6,-7,17863,98
17869,98,0.402255976859044,id8e66893c,left_hip,1.02207207679749,-6,-6,17863,98
17869,98,0.665191293299137,id8e66893c,left_ankle,1.02687501907349,-6,-6,17863,98
17869,98,0.623716679815354,id8e66893c,right_ankle,1.03952789306641,-6,-6,17863,98
12541,97,0.152937607285783,id8e66893c,left_wrist,1.02773714065552,-7,-6,12534,98
12539,98,0.339875987634412,id8e66893c,left_hip,1.02207207679749,-5,-5,12534,98
12540,97,0.626836628036225,id8e66893c,left_ankle,1.02687501907349,-6,-5,12534,98
12539,99,0.630570576611675,id8e66893c,right_ankle,1.03952789306641,-5,-6,12534,98
11949,95,0.174101280398056,id8e66893c,left_wrist,1.02773714065552,2,5,11951,98
11956,98,0.343169950712401,id8e66893c,left_hip,1.02207207679749,-5,-5,11951,98
11957,97,0.57888738742826,id8e66893c,left_ankle,1.02687501907349,-6,-5,11951,98
11956,98,0.610187745842712,id8e66893c,right_ankle,1.03952789306641,-5,-5,11951,98
1257,66,0.111990131352696,id8e66893c,left_wrist,1.02773714065552,-6,25,1251,97
1255,97,0.36333370213786,id8e66893c,left_hip,1.02207207679749,-4,-4,1251,97
1256,96,0.596542507933848,id8e66893c,left_ankle,1.02687501907349,-5,-4,1251,97
1255,96,0.602370955098113,id8e66893c,right_ankle,1.03952789306641,-4,-3,1251,97
4069,100,0.190290369176762,id8e66893c,left_wrist,1.02773714065552,-5,-6,4064,99
4068,98,0.336747274340429,id8e66893c,left_hip,1.02207207679749,-4,-3,4064,99
4070,98,0.576193370782367,id8e66893c,left_ankle,1.02687501907349,-6,-5,4064,99
4070,99,0.483541474481866,id8e66893c,right_ankle,1.03952789306641,-6,-6,4064,99
3392,98,0.191297496283553,id8e66893c,left_wrist,1.02773714065552,-1,-3,3391,96
3390,99,0.310162927882061,id8e66893c,left_hip,1.02207207679749,1,-2,3391,96
3391,99,0.526213011901474,id8e66893c,left_ankle,1.02687501907349,0,-3,3391,96
3391,99,0.474710011136835,id8e66893c,right_ankle,1.03952789306641,0,-3,3391,96
13023,88,0.158376152695505,id8e66893c,left_wrist,1.02773714065552,-6,4,13017,98
13022,96,0.357911497560685,id8e66893c,left_hip,1.02207207679749,-5,-3,13017,98
13022,96,0.629071411253646,id8e66893c,left_ankle,1.02687501907349,-5,-3,13017,98
13020,96,0.562369586811449,id8e66893c,right_ankle,1.03952789306641,-3,-1,13017,98
7263,99,0.201778192784116,id8e66893c,left_wrist,1.02773714065552,-6,-7,7257,98
7261,99,0.335933720476769,id8e66893c,left_hip,1.02207207679749,-4,-5,7257,98
7263,98,0.584510999670985,id8e66893c,left_ankle,1.02687501907349,-6,-6,7257,98
7262,98,0.526107043710274,id8e66893c,right_ankle,1.03952789306641,-5,-5,7257,98
14659,98,0.301277968287173,id8e66893c,left_wrist,1.02773714065552,-3,-6,14656,95
14660,97,0.408537225848292,id8e66893c,left_hip,1.02207207679749,-4,-6,14656,95
14659,98,0.642836578454874,id8e66893c,left_ankle,1.02687501907349,-3,-6,14656,95
14657,100,0.638317359731307,id8e66893c,right_ankle,1.03952789306641,-1,-6,14656,95
9420,100,0.327927535813821,id8e66893c,left_wrist,1.02773714065552,-7,-6,9413,101
9419,100,0.294521028134982,id8e66893c,left_hip,1.02207207679749,-6,-5,9413,101
9420,98,0.55735232746321,id8e66893c,left_ankle,1.02687501907349,-7,-4,9413,101
9420,101,0.489268659081666,id8e66893c,right_ankle,1.03952789306641,-7,-7,9413,101
13600,99,0.243137385032733,id8e66893c,left_wrist,1.02773714065552,-5,-3,13595,101
13601,98,0.354591124055324,id8e66893c,left_hip,1.02207207679749,-6,-3,13595,101
13601,98,0.611770463841006,id8e66893c,left_ankle,1.02687501907349,-6,-3,13595,101
13600,98,0.636150953312816,id8e66893c,right_ankle,1.03952789306641,-5,-2,13595,101
18743,88,0.211945954127235,id8e66893c,left_wrist,1.02773714065552,-1,5,18742,94
18742,99,0.351319016854069,id8e66893c,left_hip,1.02207207679749,0,-5,18742,94
18743,98,0.591203031343726,id8e66893c,left_ankle,1.02687501907349,-1,-5,18742,94
18742,97,0.617210451246117,id8e66893c,right_ankle,1.03952789306641,0,-3,18742,94
7263,99,0.201778192784116,id8e66893c,left_wrist,1.02773714065552,-6,-7,7257,98
7261,99,0.335933720476769,id8e66893c,left_hip,1.02207207679749,-4,-5,7257,98
7263,98,0.584510999670985,id8e66893c,left_ankle,1.02687501907349,-6,-6,7257,98
7262,98,0.526107043710274,id8e66893c,right_ankle,1.03952789306641,-5,-5,7257,98
14659,98,0.301277968287173,id8e66893c,left_wrist,1.02773714065552,-3,-6,14656,95
14660,97,0.408537225848292,id8e66893c,left_hip,1.02207207679749,-4,-6,14656,95
14659,98,0.642836578454874,id8e66893c,left_ankle,1.02687501907349,-3,-6,14656,95
14657,100,0.638317359731307,id8e66893c,right_ankle,1.03952789306641,-1,-6,14656,95
20853,94,0.287054003040094,id34e056c8,left_wrist,1.37878513336182,-2,-3,20851,93
20858,93,0.350375461157787,id34e056c8,left_hip,1.39668393135071,-7,-7,20851,93
20850,95,0.747841694233468,id34e056c8,left_ankle,1.40119385719299,1,-1,20851,93
20852,93,0.613758921786252,id34e056c8,right_ankle,1.41586112976074,-1,-1,20851,93
4747,94,0.281843658372586,id34e056c8,left_wrist,1.37878513336182,3,3,4750,94
4750,95,0.357087914779407,id34e056c8,left_hip,1.39668393135071,0,-1,4750,94
4748,94,0.780002381412143,id34e056c8,left_ankle,1.40119385719299,2,2,4750,94
4749,93,0.721735194648266,id34e056c8,right_ankle,1.41586112976074,1,2,4750,94
14531,88,0.266202813660382,id34e056c8,left_wrist,1.37878513336182,1,3,14532,90
14534,91,0.362324523531324,id34e056c8,left_hip,1.39668393135071,-2,-3,14532,90
14530,91,0.779869933146941,id34e056c8,left_ankle,1.40119385719299,2,1,14532,90
14529,92,0.747950281681486,id34e056c8,right_ankle,1.41586112976074,3,1,14532,90
2809,91,0.306177954004138,id34e056c8,left_wrist,1.37878513336182,1,3,2810,93
2812,92,0.359534130732736,id34e056c8,left_hip,1.39668393135071,-2,-1,2810,93
2809,91,0.69890187164873,id34e056c8,left_ankle,1.40119385719299,1,3,2810,93
2808,94,0.762778072659664,id34e056c8,right_ankle,1.41586112976074,2,1,2810,93
6041,93,0.258122244301651,id34e056c8,left_wrist,1.37878513336182,0,0,6041,93
6038,99,0.328809813568957,id34e056c8,left_hip,1.39668393135071,3,-3,6041,93
6039,93,0.809162239695876,id34e056c8,left_ankle,1.40119385719299,2,2,6041,93
6040,94,0.69880407870203,id34e056c8,right_ankle,1.41586112976074,1,0,6041,93
8608,93,0.150090823098938,id34e056c8,left_wrist,1.37878513336182,-4,1,8604,98
8603,98,0.234125957632577,id34e056c8,left_hip,1.39668393135071,1,1,8604,98
8604,95,0.732268791786893,id34e056c8,left_ankle,1.40119385719299,0,3,8604,98
8605,96,0.597366100056258,id34e056c8,right_ankle,1.41586112976074,-1,1,8604,98
371,89,0.213904093971626,id34e056c8,left_wrist,1.37878513336182,2,2,373,89
376,88,0.339625867249979,id34e056c8,left_hip,1.39668393135071,-3,-2,373,89
370,91,0.850616067061343,id34e056c8,left_ankle,1.40119385719299,3,1,373,89
370,90,0.728662607216034,id34e056c8,right_ankle,1.41586112976074,3,2,373,89
8513,96,0.250057472008715,id34e056c8,left_wrist,1.37878513336182,0,-4,8513,92
8517,87,0.234723277907473,id34e056c8,left_hip,1.39668393135071,-4,1,8513,92
8513,92,0.778278273771842,id34e056c8,left_ankle,1.40119385719299,0,0,8513,92
8513,93,0.541755733748553,id34e056c8,right_ankle,1.41586112976074,0,-1,8513,92
19344,93,0.225863043086529,id34e056c8,left_wrist,1.37878513336182,-7,1,19337,101
19348,88,0.271446319608251,id34e056c8,left_hip,1.39668393135071,-11,2,19337,101
19340,97,0.792428433762075,id34e056c8,left_ankle,1.40119385719299,-3,1,19337,101
19342,98,0.606603370283604,id34e056c8,right_ankle,1.41586112976074,-5,-2,19337,101
7596,93,0.219856956258358,id34e056c8,left_wrist,1.37878513336182,3,3,7599,93
7600,93,0.308234833204615,id34e056c8,left_hip,1.39668393135071,-1,-1,7599,93
7597,93,0.845191731616485,id34e056c8,left_ankle,1.40119385719299,2,2,7599,93
7598,93,0.731792225454117,id34e056c8,right_ankle,1.41586112976074,1,1,7599,93
10799,96,0.195500013318141,id34e056c8,left_wrist,1.37878513336182,3,-1,10802,92
10804,92,0.345775289543592,id34e056c8,left_hip,1.39668393135071,-2,-2,10802,92
10801,91,0.72226161430376,id34e056c8,left_ankle,1.40119385719299,1,2,10802,92
10800,92,0.683454280409562,id34e056c8,right_ankle,1.41586112976074,2,2,10802,92
13352,90,0.293014057173648,id34e056c8,left_wrist,1.37878513336182,1,3,13353,92
13357,90,0.359328066308765,id34e056c8,left_hip,1.39668393135071,-4,-2,13353,92
13352,92,0.800781247098918,id34e056c8,left_ankle,1.40119385719299,1,1,13353,92
13352,92,0.744031946339676,id34e056c8,right_ankle,1.41586112976074,1,1,13353,92
10984,94,0.266626681460274,id34e056c8,left_wrist,1.37878513336182,-1,-5,10983,90
10987,93,0.365237181219803,id34e056c8,left_hip,1.39668393135071,-4,-7,10983,90
10982,90,0.765548907427419,id34e056c8,left_ankle,1.40119385719299,1,1,10983,90
10982,91,0.663575475698256,id34e056c8,right_ankle,1.41586112976074,1,0,10983,90
4189,95,0.291348541353537,id34e056c8,left_wrist,1.37878513336182,5,3,4194,93
4193,92,0.363314114931731,id34e056c8,left_hip,1.39668393135071,1,2,4194,93
4191,93,0.819723770859005,id34e056c8,left_ankle,1.40119385719299,3,3,4194,93
4192,93,0.628409936805087,id34e056c8,right_ankle,1.41586112976074,2,2,4194,93
18397,95,0.312020918047951,id34e056c8,left_wrist,1.37878513336182,-2,-2,18395,95
18401,95,0.362871345143174,id34e056c8,left_hip,1.39668393135071,-6,-6,18395,95
18394,95,0.731241829233881,id34e056c8,left_ankle,1.40119385719299,1,1,18395,95
18396,95,0.626040839142572,id34e056c8,right_ankle,1.41586112976074,-1,-1,18395,95
14892,94,0.203840323083603,id34e056c8,left_wrist,1.37878513336182,3,2,14895,93
14900,90,0.303031940940922,id34e056c8,left_hip,1.39668393135071,-5,-2,14895,93
14894,92,0.839508918951642,id34e056c8,left_ankle,1.40119385719299,1,2,14895,93
14894,91,0.626006262149272,id34e056c8,right_ankle,1.41586112976074,1,3,14895,93
17736,93,0.289908153107286,id34e056c8,left_wrist,1.37878513336182,0,2,17736,95
17742,95,0.395798272670189,id34e056c8,left_hip,1.39668393135071,-6,-6,17736,95
17734,95,0.786278329073471,id34e056c8,left_ankle,1.40119385719299,2,2,17736,95
17736,95,0.633905553344441,id34e056c8,right_ankle,1.41586112976074,0,0,17736,95
2441,92,0.202503747014792,id34e056c8,left_wrist,1.37878513336182,1,3,2442,94
2442,93,0.332972721272322,id34e056c8,left_hip,1.39668393135071,0,1,2442,94
2441,92,0.668487168682892,id34e056c8,left_ankle,1.40119385719299,1,3,2442,94
2441,94,0.632940370285225,id34e056c8,right_ankle,1.41586112976074,1,1,2442,94
16173,92,0.259085924542089,id34e056c8,left_wrist,1.37878513336182,0,0,16173,92
16177,93,0.309067522679173,id34e056c8,left_hip,1.39668393135071,-4,-5,16173,92
16172,93,0.825037837311996,id34e056c8,left_ankle,1.40119385719299,1,0,16173,92
16173,93,0.727291094750901,id34e056c8,right_ankle,1.41586112976074,0,-1,16173,92
9162,97,0.177631570352553,id34e056c8,left_wrist,1.37878513336182,3,1,9165,95
9164,97,0.302898534209656,id34e056c8,left_hip,1.39668393135071,1,-1,9165,95
9164,93,0.748508374320202,id34e056c8,left_ankle,1.40119385719299,1,3,9165,95
9164,94,0.687995609891484,id34e056c8,right_ankle,1.41586112976074,1,2,9165,95
14330,107,0.341541594774739,idc735fc09,left_wrist,0.875278949737549,0,-3,14330,104
14331,105,0.337508487217045,idc735fc09,left_hip,0.862326860427856,-1,-2,14330,104
14330,105,0.678750972319651,idc735fc09,left_ankle,0.853281021118164,0,-1,14330,104
14330,103,0.713858373549807,idc735fc09,right_ankle,0.876928091049194,0,1,14330,104
11333,109,0.157171679592069,idc735fc09,left_wrist,0.875278949737549,1,-3,11334,105
11333,105,0.336721077948668,idc735fc09,left_hip,0.862326860427856,1,1,11334,105
11332,105,0.709414772089148,idc735fc09,left_ankle,0.853281021118164,2,2,11334,105
11331,105,0.877634089094093,idc735fc09,right_ankle,0.876928091049194,3,3,11334,105
13810,105,0.316724803734796,idc735fc09,left_wrist,0.875278949737549,-2,-2,13808,105
13810,105,0.367816652094361,idc735fc09,left_hip,0.862326860427856,-2,-2,13808,105
13809,105,0.63136718554249,idc735fc09,left_ankle,0.853281021118164,-1,-1,13808,105
13808,105,0.778503504398735,idc735fc09,right_ankle,0.876928091049194,0,0,13808,105
9678,105,0.286071479539842,idc735fc09,left_wrist,0.875278949737549,2,1,9680,104
9680,103,0.3738463242956,idc735fc09,left_hip,0.862326860427856,0,1,9680,104
9679,103,0.708365485330908,idc735fc09,left_ankle,0.853281021118164,1,2,9680,104
9678,102,0.886006158875356,idc735fc09,right_ankle,0.876928091049194,2,4,9680,104
9269,103,0.314930513626154,idc735fc09,left_wrist,0.875278949737549,-2,-2,9267,103
9268,104,0.38055242234334,idc735fc09,left_hip,0.862326860427856,-1,-2,9267,103
9266,104,0.666685151847358,idc735fc09,left_ankle,0.853281021118164,1,0,9267,103
9266,104,0.741939673914001,idc735fc09,right_ankle,0.876928091049194,1,0,9267,103
13709,102,0.287710310355167,idc735fc09,left_wrist,0.875278949737549,-2,-2,13707,102
13708,103,0.373359673304863,idc735fc09,left_hip,0.862326860427856,-1,-2,13707,102
13705,105,0.687108078301661,idc735fc09,left_ankle,0.853281021118164,2,-1,13707,102
13706,103,0.873438675097398,idc735fc09,right_ankle,0.876928091049194,1,0,13707,102
576,106,0.281665199800974,idc735fc09,left_wrist,0.875278949737549,0,0,576,106
575,107,0.298032520640447,idc735fc09,left_hip,0.862326860427856,1,0,576,106
574,108,0.721975858767223,idc735fc09,left_ankle,0.853281021118164,2,0,576,106
575,105,0.709625439328599,idc735fc09,right_ankle,0.876928091049194,1,2,576,106
8335,104,0.234986110305661,idc735fc09,left_wrist,0.875278949737549,-1,-1,8334,104
8335,104,0.354078499595763,idc735fc09,left_hip,0.862326860427856,-1,-1,8334,104
8333,105,0.679207643999312,idc735fc09,left_ankle,0.853281021118164,1,0,8334,104
8330,109,0.859085679825633,idc735fc09,right_ankle,0.876928091049194,4,-1,8334,104
12783,105,0.299332129751554,idc735fc09,left_wrist,0.875278949737549,-2,0,12781,107
12783,106,0.35178564483252,idc735fc09,left_hip,0.862326860427856,-2,-1,12781,107
12782,105,0.630603787036781,idc735fc09,left_ankle,0.853281021118164,-1,1,12781,107
12783,105,0.746174137935555,idc735fc09,right_ankle,0.876928091049194,-2,0,12781,107
12157,104,0.181154959096339,idc735fc09,left_wrist,0.875278949737549,2,2,12159,104
12159,104,0.32321558433813,idc735fc09,left_hip,0.862326860427856,0,0,12159,104
12158,105,0.657271545774326,idc735fc09,left_ankle,0.853281021118164,1,0,12159,104
12158,104,0.911497568407704,idc735fc09,right_ankle,0.876928091049194,1,1,12159,104
8335,104,0.234986110305661,idc735fc09,left_wrist,0.875278949737549,-1,-1,8334,104
8335,104,0.354078499595763,idc735fc09,left_hip,0.862326860427856,-1,-1,8334,104
8333,105,0.679207643999312,idc735fc09,left_ankle,0.853281021118164,1,0,8334,104
8330,109,0.859085679825633,idc735fc09,right_ankle,0.876928091049194,4,-1,8334,104
14957,106,0.410521266066358,idc735fc09,left_wrist,0.875278949737549,-1,-2,14956,105
14957,104,0.371261282863838,idc735fc09,left_hip,0.862326860427856,-1,0,14956,105
14955,105,0.623506092634411,idc735fc09,left_ankle,0.853281021118164,1,1,14956,105
14955,105,0.765435096138643,idc735fc09,right_ankle,0.876928091049194,1,1,14956,105
7598,105,0.257922927723512,idc735fc09,left_wrist,0.875278949737549,2,2,7600,105
7600,105,0.325779593841561,idc735fc09,left_hip,0.862326860427856,0,0,7600,105
7598,107,0.755676316901941,idc735fc09,left_ankle,0.853281021118164,2,0,7600,105
7599,103,0.789009673990312,idc735fc09,right_ankle,0.876928091049194,1,3,7600,105
4273,106,0.203828646982844,idc735fc09,left_wrist,0.875278949737549,3,2,4276,105
4276,105,0.297851554324863,idc735fc09,left_hip,0.862326860427856,0,0,4276,105
4274,106,0.738636375353815,idc735fc09,left_ankle,0.853281021118164,2,1,4276,105
4273,106,0.81797992923658,idc735fc09,right_ankle,0.876928091049194,3,2,4276,105
1311,108,0.27656114217099,idc735fc09,left_wrist,0.875278949737549,2,1,1313,107
1312,108,0.290025717534355,idc735fc09,left_hip,0.862326860427856,1,0,1313,107
1312,107,0.6771477472296,idc735fc09,left_ankle,0.853281021118164,1,1,1313,107
1311,107,0.784270187194937,idc735fc09,right_ankle,0.876928091049194,2,2,1313,107
1735,108,0.255563464189204,idc735fc09,left_wrist,0.875278949737549,4,4,1739,108
1738,108,0.28630315499771,idc735fc09,left_hip,0.862326860427856,1,1,1739,108
1735,108,0.716339593861792,idc735fc09,left_ankle,0.853281021118164,4,4,1739,108
1737,107,0.85276889311451,idc735fc09,right_ankle,0.876928091049194,2,3,1739,108
5532,106,0.181316691044369,idc735fc09,left_wrist,0.875278949737549,2,2,5534,106
5534,106,0.283047022163199,idc735fc09,left_hip,0.862326860427856,0,0,5534,106
5531,107,0.712901379352768,idc735fc09,left_ankle,0.853281021118164,3,2,5534,106
5532,105,0.767363233505257,idc735fc09,right_ankle,0.876928091049194,2,3,5534,106
9061,105,0.297319358969021,idc735fc09,left_wrist,0.875278949737549,2,-1,9063,102
9062,105,0.358233162154687,idc735fc09,left_hip,0.862326860427856,1,-2,9063,102
9060,105,0.636709124884352,idc735fc09,left_ankle,0.853281021118164,3,0,9063,102
9061,103,0.766921864753937,idc735fc09,right_ankle,0.876928091049194,2,1,9063,102
11540,100,0.190305528406278,idc735fc09,left_wrist,0.875278949737549,1,-2,11541,97
11540,104,0.34714053031359,idc735fc09,left_hip,0.862326860427856,1,-6,11541,97
11539,101,0.725217889925872,idc735fc09,left_ankle,0.853281021118164,2,-2,11541,97
11538,101,0.694799632651726,idc735fc09,right_ankle,0.876928091049194,3,-1,11541,97
7079,104,0.268563716621085,idc735fc09,left_wrist,0.875278949737549,2,3,7081,105
7081,105,0.320647866228283,idc735fc09,left_hip,0.862326860427856,0,0,7081,105
7080,105,0.767779348275298,idc735fc09,left_ankle,0.853281021118164,1,1,7081,105
7078,106,0.832661335345229,idc735fc09,right_ankle,0.876928091049194,3,2,7081,105
18595,105,0.330168416376871,id86237981,left_wrist,1.1580011844635,-3,-2,18592,106
18596,105,0.355263252927055,id86237981,left_hip,1.11717796325684,-4,-3,18592,106
18592,106,0.792762251134504,id86237981,left_ankle,1.09108901023865,0,0,18592,106
18593,104,0.791862122755899,id86237981,right_ankle,1.09040784835815,-1,1,18592,106
6002,104,0.283809469533969,id86237981,left_wrist,1.1580011844635,-1,0,6001,105
6001,105,0.350549218164886,id86237981,left_hip,1.11717796325684,0,0,6001,105
5999,106,0.767970006667979,id86237981,left_ankle,1.09108901023865,2,1,6001,105
5999,105,0.786853508365188,id86237981,right_ankle,1.09040784835815,2,2,6001,105
9334,106,0.290732245705141,id86237981,left_wrist,1.1580011844635,0,0,9334,106
9335,107,0.350080896304744,id86237981,left_hip,1.11717796325684,-1,-2,9334,106
9334,106,0.77747033655401,id86237981,left_ankle,1.09108901023865,0,0,9334,106
9332,107,0.836927894088146,id86237981,right_ankle,1.09040784835815,2,1,9334,106
6840,105,0.324245282778336,id86237981,left_wrist,1.1580011844635,0,-1,6840,104
6842,105,0.349290867280136,id86237981,left_hip,1.11717796325684,-2,-3,6840,104
6840,104,0.71803874552553,id86237981,left_ankle,1.09108901023865,0,0,6840,104
6837,108,0.803833373278011,id86237981,right_ankle,1.09040784835815,3,-1,6840,104
13270,105,0.287323512293683,id86237981,left_wrist,1.1580011844635,0,-1,13270,104
13274,104,0.352908062367833,id86237981,left_hip,1.11717796325684,-4,-4,13270,104
13270,102,0.774642204277612,id86237981,left_ankle,1.09108901023865,0,2,13270,104
13270,103,0.825149245079802,id86237981,right_ankle,1.09040784835815,0,1,13270,104
5275,105,0.293330667275767,id86237981,left_wrist,1.1580011844635,-3,-2,5272,106
5274,104,0.355467550865874,id86237981,left_hip,1.11717796325684,-2,0,5272,106
5272,104,0.693141305986469,id86237981,left_ankle,1.09108901023865,0,2,5272,106
5270,106,0.823496442752742,id86237981,right_ankle,1.09040784835815,2,2,5272,106
9750,105,0.296274336747432,id86237981,left_wrist,1.1580011844635,0,-2,9750,103
9754,103,0.356417685958095,id86237981,left_hip,1.11717796325684,-4,-4,9750,103
9750,103,0.719718431769536,id86237981,left_ankle,1.09108901023865,0,0,9750,103
9749,103,0.794055630349309,id86237981,right_ankle,1.09040784835815,1,1,9750,103
15565,105,0.321927262369778,id86237981,left_wrist,1.1580011844635,-5,-5,15560,105
15564,105,0.373562870031218,id86237981,left_hip,1.11717796325684,-4,-4,15560,105
15561,105,0.733089649973391,id86237981,left_ankle,1.09108901023865,-1,-1,15560,105
15560,103,0.764043819243137,id86237981,right_ankle,1.09040784835815,0,2,15560,105
1728,105,0.27955438405331,id86237981,left_wrist,1.1580011844635,-2,-1,1726,106
1725,105,0.331970388023004,id86237981,left_hip,1.11717796325684,1,2,1726,106
1723,108,0.780925258791906,id86237981,left_ankle,1.09108901023865,3,1,1726,106
1724,108,0.797565324693086,id86237981,right_ankle,1.09040784835815,2,0,1726,106
17760,102,0.328003794392528,id86237981,left_wrist,1.1580011844635,-5,-2,17755,105
17759,105,0.374662117536615,id86237981,left_hip,1.11717796325684,-4,-4,17755,105
17755,105,0.778251621587358,id86237981,left_ankle,1.09108901023865,0,0,17755,105
17756,104,0.786407422324217,id86237981,right_ankle,1.09040784835815,-1,0,17755,105
6944,107,0.278204850781437,id86237981,left_wrist,1.1580011844635,-1,-2,6943,106
6946,105,0.368920892266378,id86237981,left_hip,1.11717796325684,-3,-2,6943,106
6943,106,0.774995926995576,id86237981,left_ankle,1.09108901023865,0,0,6943,106
6944,104,0.706291452261464,id86237981,right_ankle,1.09040784835815,-1,1,6943,106
17126,105,0.319002578774013,id86237981,left_wrist,1.1580011844635,-2,-1,17124,106
17127,105,0.370646266030697,id86237981,left_hip,1.11717796325684,-3,-2,17124,106
17124,106,0.738957168229155,id86237981,left_ankle,1.09108901023865,0,0,17124,106
17123,106,0.736393506940746,id86237981,right_ankle,1.09040784835815,1,1,17124,106
7050,105,0.328556381510506,id86237981,left_wrist,1.1580011844635,-2,-2,7048,105
7050,106,0.359122127356279,id86237981,left_hip,1.11717796325684,-2,-3,7048,105
7048,105,0.73672575833117,id86237981,left_ankle,1.09108901023865,0,0,7048,105
7047,106,0.808074288255928,id86237981,right_ankle,1.09040784835815,1,0,7048,105
6840,105,0.324245282778336,id86237981,left_wrist,1.1580011844635,0,-1,6840,104
6842,105,0.349290867280136,id86237981,left_hip,1.11717796325684,-2,-3,6840,104
6840,104,0.71803874552553,id86237981,left_ankle,1.09108901023865,0,0,6840,104
6837,108,0.803833373278011,id86237981,right_ankle,1.09040784835815,3,-1,6840,104
9750,105,0.296274336747432,id86237981,left_wrist,1.1580011844635,0,-2,9750,103
9754,103,0.356417685958095,id86237981,left_hip,1.11717796325684,-4,-4,9750,103
9750,103,0.719718431769536,id86237981,left_ankle,1.09108901023865,0,0,9750,103
9749,103,0.794055630349309,id86237981,right_ankle,1.09040784835815,1,1,9750,103
18177,105,0.269988398879355,id86237981,left_wrist,1.1580011844635,-2,-2,18175,105
18176,107,0.387500035557519,id86237981,left_hip,1.11717796325684,-1,-3,18175,105
18175,106,0.752253388594287,id86237981,left_ankle,1.09108901023865,0,-1,18175,105
18173,105,0.800138424074625,id86237981,right_ankle,1.09040784835815,2,2,18175,105
17550,108,0.308497584130514,id86237981,left_wrist,1.1580011844635,-4,-5,17546,107
17547,108,0.37201752698792,id86237981,left_hip,1.11717796325684,-1,-2,17546,107
17546,107,0.746421884692596,id86237981,left_ankle,1.09108901023865,0,0,17546,107
17546,106,0.798022013917841,id86237981,right_ankle,1.09040784835815,0,1,17546,107
7980,105,0.24698743492017,id86237981,left_wrist,1.1580011844635,-1,-2,7979,104
7982,103,0.347684010002294,id86237981,left_hip,1.11717796325684,-3,-2,7979,104
7979,105,0.819077209148003,id86237981,left_ankle,1.09108901023865,0,-1,7979,104
7978,105,0.78555688129108,id86237981,right_ankle,1.09040784835815,1,0,7979,104
15876,105,0.281753019132006,id86237981,left_wrist,1.1580011844635,-3,-2,15873,106
15877,105,0.360247603280085,id86237981,left_hip,1.11717796325684,-4,-3,15873,106
15874,105,0.70630591353523,id86237981,left_ankle,1.09108901023865,-1,0,15873,106
15874,104,0.781290004512883,id86237981,right_ankle,1.09040784835815,-1,1,15873,106
19539,106,0.349208630813942,id86237981,left_wrist,1.1580011844635,-3,-2,19536,107
19538,106,0.400707571128583,id86237981,left_hip,1.11717796325684,-2,-1,19536,107
19536,108,0.777120604326939,id86237981,left_ankle,1.09108901023865,0,-1,19536,107
19536,104,0.738287365185907,id86237981,right_ankle,1.09040784835815,0,3,19536,107
8582,121,0.136637345171648,idf5e3678b,left_wrist,1.03319811820984,9,-4,8591,108
8591,108,0.311631642837773,idf5e3678b,left_hip,1.04713487625122,0,0,8591,108
8590,109,0.625043202927856,idf5e3678b,left_ankle,1.02644300460815,1,0,8591,108
8590,106,0.732909499811897,idf5e3678b,right_ankle,1.0176260471344,1,3,8591,108
14151,110,0.15692786836966,idf5e3678b,left_wrist,1.03319811820984,-9,-11,14142,108
14144,107,0.310602527319134,idf5e3678b,left_hip,1.04713487625122,-2,-1,14142,108
14143,108,0.67449103658352,idf5e3678b,left_ankle,1.02644300460815,-1,-1,14142,108
14143,108,0.642331898212864,idf5e3678b,right_ankle,1.0176260471344,-1,-1,14142,108
7940,106,0.123840262514396,idf5e3678b,left_wrist,1.03319811820984,8,10,7948,108
7948,108,0.313599437853996,idf5e3678b,left_hip,1.04713487625122,0,0,7948,108
7947,108,0.65508653487974,idf5e3678b,left_ankle,1.02644300460815,1,1,7948,108
7946,110,0.696975969756162,idf5e3678b,right_ankle,1.0176260471344,2,0,7948,108
6453,115,0.134017562912898,idf5e3678b,left_wrist,1.03319811820984,-5,-14,6448,106
6448,110,0.276987262139404,idf5e3678b,left_hip,1.04713487625122,0,-4,6448,106
6447,110,0.631973363516703,idf5e3678b,left_ankle,1.02644300460815,1,-3,6448,106
6448,109,0.632896034920821,idf5e3678b,right_ankle,1.0176260471344,0,-3,6448,106
14997,106,0.16566010610111,idf5e3678b,left_wrist,1.03319811820984,-7,-7,14990,106
14992,106,0.336926480536565,idf5e3678b,left_hip,1.04713487625122,-2,-2,14990,106
14991,106,0.689509501075097,idf5e3678b,left_ankle,1.02644300460815,-1,-1,14990,106
14989,105,0.743809245498327,idf5e3678b,right_ankle,1.0176260471344,1,2,14990,106
4038,108,0.160950248658106,idf5e3678b,left_wrist,1.03319811820984,-5,-3,4033,110
4035,109,0.309986166705609,idf5e3678b,left_hip,1.04713487625122,-2,-1,4033,110
4033,109,0.612869547745097,idf5e3678b,left_ankle,1.02644300460815,0,1,4033,110
4033,108,0.63699791029369,idf5e3678b,right_ankle,1.0176260471344,0,2,4033,110
14151,110,0.15692786836966,idf5e3678b,left_wrist,1.03319811820984,-9,-11,14142,108
14144,107,0.310602527319134,idf5e3678b,left_hip,1.04713487625122,-2,-1,14142,108
14143,108,0.67449103658352,idf5e3678b,left_ankle,1.02644300460815,-1,-1,14142,108
14143,108,0.642331898212864,idf5e3678b,right_ankle,1.0176260471344,-1,-1,14142,108
2485,114,0.169285678641493,idf5e3678b,left_wrist,1.03319811820984,-2,-3,2483,113
2483,114,0.265643490391172,idf5e3678b,left_hip,1.04713487625122,0,-1,2483,113
2481,115,0.601230330470084,idf5e3678b,left_ankle,1.02644300460815,2,0,2483,113
2484,113,0.660604377585401,idf5e3678b,right_ankle,1.0176260471344,-1,-1,2483,113
4908,111,0.158781853801889,idf5e3678b,left_wrist,1.03319811820984,-9,-8,4899,112
4901,111,0.289730247271402,idf5e3678b,left_hip,1.04713487625122,-2,-1,4899,112
4899,112,0.611098007608702,idf5e3678b,left_ankle,1.02644300460815,0,0,4899,112
4900,112,0.655102283806161,idf5e3678b,right_ankle,1.0176260471344,-1,-1,4899,112
2933,113,0.171222335324537,idf5e3678b,left_wrist,1.03319811820984,-3,-5,2930,111
2931,111,0.327455447902154,idf5e3678b,left_hip,1.04713487625122,-1,-1,2930,111
2929,111,0.58370080818893,idf5e3678b,left_ankle,1.02644300460815,1,1,2930,111
2929,113,0.608802110523461,idf5e3678b,right_ankle,1.0176260471344,1,-1,2930,111
4794,115,0.141170633179823,idf5e3678b,left_wrist,1.03319811820984,-5,-9,4789,111
4791,111,0.286985843604115,idf5e3678b,left_hip,1.04713487625122,-2,-2,4789,111
4789,111,0.571839301820185,idf5e3678b,left_ankle,1.02644300460815,0,0,4789,111
4790,111,0.649900908425704,idf5e3678b,right_ankle,1.0176260471344,-1,-1,4789,111
1254,111,0.131934461805454,idf5e3678b,left_wrist,1.03319811820984,-4,-4,1250,111
1251,111,0.268369333041242,idf5e3678b,left_hip,1.04713487625122,-1,-1,1250,111
1250,110,0.627763914050507,idf5e3678b,left_ankle,1.02644300460815,0,1,1250,111
1250,111,0.692354924124694,idf5e3678b,right_ankle,1.0176260471344,0,0,1250,111
12740,107,0.139947152927711,idf5e3678b,left_wrist,1.03319811820984,-10,-9,12730,108
12730,110,0.304993899881381,idf5e3678b,left_hip,1.04713487625122,0,-2,12730,108
12731,108,0.647388950405631,idf5e3678b,left_ankle,1.02644300460815,-1,-1,12730,108
12730,108,0.725795245023578,idf5e3678b,right_ankle,1.0176260471344,0,0,12730,108
17425,108,0.227180494368538,idf5e3678b,left_wrist,1.03319811820984,-4,-5,17421,107
17422,108,0.331098730872638,idf5e3678b,left_hip,1.04713487625122,-1,-2,17421,107
17421,108,0.653905968076458,idf5e3678b,left_ankle,1.02644300460815,0,-1,17421,107
17421,108,0.702034838319587,idf5e3678b,right_ankle,1.0176260471344,0,-1,17421,107
15416,104,0.180994848986768,idf5e3678b,left_wrist,1.03319811820984,-10,-6,15406,108
15410,106,0.301593193091514,idf5e3678b,left_hip,1.04713487625122,-4,-2,15406,108
15408,107,0.655192234873453,idf5e3678b,left_ankle,1.02644300460815,-2,-1,15406,108
15406,106,0.659685850005902,idf5e3678b,right_ankle,1.0176260471344,0,2,15406,108
15834,104,0.217645117521931,idf5e3678b,left_wrist,1.03319811820984,-5,-4,15829,105
15830,106,0.336722864686559,idf5e3678b,left_hip,1.04713487625122,-1,-2,15829,105
15830,104,0.623603503811187,idf5e3678b,left_ankle,1.02644300460815,-1,0,15829,105
15827,106,0.672072053106743,idf5e3678b,right_ankle,1.0176260471344,2,1,15829,105
9028,107,0.10703514792818,idf5e3678b,left_wrist,1.03319811820984,-12,-11,9016,108
9016,109,0.272464547974046,idf5e3678b,left_hip,1.04713487625122,0,-1,9016,108
9017,107,0.594694680802743,idf5e3678b,left_ankle,1.02644300460815,-1,0,9016,108
9014,109,0.64294736651313,idf5e3678b,right_ankle,1.0176260471344,2,1,9016,108
8153,108,0.11736754043607,idf5e3678b,left_wrist,1.03319811820984,9,10,8162,109
8163,108,0.305870345483303,idf5e3678b,left_hip,1.04713487625122,-1,0,8162,109
8163,108,0.667436964099262,idf5e3678b,left_ankle,1.02644300460815,-1,0,8162,109
8160,109,0.739485660862368,idf5e3678b,right_ankle,1.0176260471344,2,2,8162,109
16045,106,0.209176828113166,idf5e3678b,left_wrist,1.03319811820984,-7,-4,16038,109
16041,107,0.311653670133337,idf5e3678b,left_hip,1.04713487625122,-3,-1,16038,109
16039,107,0.604202440002853,idf5e3678b,left_ankle,1.02644300460815,-1,1,16038,109
16039,106,0.724347094680089,idf5e3678b,right_ankle,1.0176260471344,-1,2,16038,109
12092,107,0.111538195991035,idf5e3678b,left_wrist,1.03319811820984,-9,-8,12083,108
12084,108,0.324057264793741,idf5e3678b,left_hip,1.04713487625122,-1,-1,12083,108
12082,109,0.657784544942479,idf5e3678b,left_ankle,1.02644300460815,1,0,12083,108
12082,109,0.735801574766723,idf5e3678b,right_ankle,1.0176260471344,1,0,12083,108
14694,104,0.117671412120478,id37a54bbf,left_wrist,1.28541398048401,-4,-4,14690,104
14687,104,0.219784744409409,id37a54bbf,left_hip,1.2941210269928,3,3,14690,104
14689,103,0.748207384029493,id37a54bbf,left_ankle,1.30873799324036,1,2,14690,104
14689,105,0.657296785168484,id37a54bbf,right_ankle,1.31948804855347,1,0,14690,104
7988,101,0.143990594680726,id37a54bbf,left_wrist,1.28541398048401,-4,-3,7984,102
7981,103,0.228489153985939,id37a54bbf,left_hip,1.2941210269928,3,2,7984,102
7979,105,0.631786456319923,id37a54bbf,left_ankle,1.30873799324036,5,2,7984,102
7982,104,0.672687881055497,id37a54bbf,right_ankle,1.31948804855347,2,0,7984,102
6135,102,0.102012569177612,id37a54bbf,left_wrist,1.28541398048401,8,8,6143,102
6139,102,0.254764044466215,id37a54bbf,left_hip,1.2941210269928,4,4,6143,102
6141,101,0.737852675419876,id37a54bbf,left_ankle,1.30873799324036,2,3,6143,102
6138,103,0.654428017889674,id37a54bbf,right_ankle,1.31948804855347,5,4,6143,102
22286,103,0.121254079710245,id37a54bbf,left_wrist,1.28541398048401,-5,-4,22281,104
22278,104,0.251470190883005,id37a54bbf,left_hip,1.2941210269928,3,3,22281,104
22279,105,0.800757042562947,id37a54bbf,left_ankle,1.30873799324036,2,1,22281,104
22279,104,0.573162568902319,id37a54bbf,right_ankle,1.31948804855347,2,2,22281,104
14179,112,0.0913080906260488,id37a54bbf,left_wrist,1.28541398048401,3,-6,14182,103
14178,103,0.205244703074285,id37a54bbf,left_hip,1.2941210269928,4,4,14182,103
14180,104,0.805019999817309,id37a54bbf,left_ankle,1.30873799324036,2,1,14182,103
14179,104,0.663008986051553,id37a54bbf,right_ankle,1.31948804855347,3,2,14182,103
4835,88,0.0775587740063012,id37a54bbf,left_wrist,1.28541398048401,-5,8,4830,101
4826,102,0.252960317104612,id37a54bbf,left_hip,1.2941210269928,4,3,4830,101
4826,104,0.745367446710325,id37a54bbf,left_ankle,1.30873799324036,4,1,4830,101
4828,99,0.681449180923559,id37a54bbf,right_ankle,1.31948804855347,2,4,4830,101
3018,139,0.109949689540792,id37a54bbf,left_wrist,1.28541398048401,-6,-44,3012,101
3007,102,0.253423494040945,id37a54bbf,left_hip,1.2941210269928,5,4,3012,101
3010,102,0.69957904459177,id37a54bbf,left_ankle,1.30873799324036,2,1,3012,101
3007,102,0.598870161216297,id37a54bbf,right_ankle,1.31948804855347,5,4,3012,101
10742,101,0.0964351394306371,id37a54bbf,left_wrist,1.28541398048401,-6,-6,10736,101
10732,103,0.267293818470956,id37a54bbf,left_hip,1.2941210269928,4,2,10736,101
10735,101,0.829196909884852,id37a54bbf,left_ankle,1.30873799324036,1,1,10736,101
10735,103,0.706670772010274,id37a54bbf,right_ankle,1.31948804855347,1,-1,10736,101
20660,104,0.119982345414941,id37a54bbf,left_wrist,1.28541398048401,-5,-6,20655,103
20656,99,0.211602308881282,id37a54bbf,left_hip,1.2941210269928,-1,3,20655,103
20653,104,0.713164938336407,id37a54bbf,left_ankle,1.30873799324036,2,1,20655,103
20656,99,0.582620909935553,id37a54bbf,right_ankle,1.31948804855347,-1,3,20655,103
13465,111,0.1165894199419,id37a54bbf,left_wrist,1.28541398048401,7,-1,13472,103
13468,103,0.214188884910119,id37a54bbf,left_hip,1.2941210269928,4,4,13472,103
13470,103,0.715439258285884,id37a54bbf,left_ankle,1.30873799324036,2,2,13472,103
13469,101,0.560573233066437,id37a54bbf,right_ankle,1.31948804855347,3,5,13472,103
21876,103,0.0994649925258915,id37a54bbf,left_wrist,1.28541398048401,-4,-5,21872,102
21869,101,0.243743346129061,id37a54bbf,left_hip,1.2941210269928,3,4,21872,102
21868,104,0.78552153579652,id37a54bbf,left_ankle,1.30873799324036,4,2,21872,102
21869,104,0.630634339087407,id37a54bbf,right_ankle,1.31948804855347,3,1,21872,102
16457,57,0.200301771925211,id37a54bbf,left_wrist,1.28541398048401,-45,1,16412,103
16408,103,0.184384407489591,id37a54bbf,left_hip,1.2941210269928,4,4,16412,103
16411,102,0.795401902996676,id37a54bbf,left_ankle,1.30873799324036,1,2,16412,103
16410,102,0.681875641461207,id37a54bbf,right_ankle,1.31948804855347,2,3,16412,103
8134,99,0.12554328715189,id37a54bbf,left_wrist,1.28541398048401,-49,-45,8085,103
8083,100,0.259988186419692,id37a54bbf,left_hip,1.2941210269928,2,5,8085,103
8083,103,0.735326653220369,id37a54bbf,left_ankle,1.30873799324036,2,2,8085,103
8085,100,0.690236022788097,id37a54bbf,right_ankle,1.31948804855347,0,3,8085,103
9716,101,0.0812528457590368,id37a54bbf,left_wrist,1.28541398048401,-4,-2,9712,103
9709,103,0.25256258934539,id37a54bbf,left_hip,1.2941210269928,3,3,9712,103
9711,99,0.672111115571838,id37a54bbf,left_ankle,1.30873799324036,1,5,9712,103
9709,104,0.640568424640756,id37a54bbf,right_ankle,1.31948804855347,3,2,9712,103
3459,62,0.0731652477776182,id37a54bbf,left_wrist,1.28541398048401,-42,-1,3417,103
3414,102,0.238219868250339,id37a54bbf,left_hip,1.2941210269928,3,4,3417,103
3413,105,0.780277858381485,id37a54bbf,left_ankle,1.30873799324036,4,2,3417,103
3414,102,0.646791575744995,id37a54bbf,right_ankle,1.31948804855347,3,4,3417,103
401,93,0.0993414275449236,id37a54bbf,left_wrist,1.28541398048401,-10,-5,391,98
392,93,0.296015113127004,id37a54bbf,left_hip,1.2941210269928,-1,4,391,98
387,100,0.859109944092327,id37a54bbf,left_ankle,1.30873799324036,4,2,391,98
387,101,0.811390808129844,id37a54bbf,right_ankle,1.31948804855347,4,1,391,98
15961,155,0.242672079556842,id37a54bbf,left_wrist,1.28541398048401,48,-6,16009,101
16005,102,0.240751130459682,id37a54bbf,left_hip,1.2941210269928,4,3,16009,101
16008,102,0.724431897356015,id37a54bbf,left_ankle,1.30873799324036,1,0,16009,101
16006,105,0.678672795584375,id37a54bbf,right_ankle,1.31948804855347,3,-1,16009,101
2446,103,0.0992817868357947,id37a54bbf,left_wrist,1.28541398048401,-42,-44,2404,101
2400,102,0.254765630974394,id37a54bbf,left_hip,1.2941210269928,4,3,2404,101
2400,102,0.63720219121221,id37a54bbf,left_ankle,1.30873799324036,4,3,2404,101
2400,102,0.619148464678738,id37a54bbf,right_ankle,1.31948804855347,4,3,2404,101
10026,103,0.102280516691043,id37a54bbf,left_wrist,1.28541398048401,-6,-4,10020,105
10017,105,0.245382117089897,id37a54bbf,left_hip,1.2941210269928,3,3,10020,105
10020,104,0.800833700219374,id37a54bbf,left_ankle,1.30873799324036,0,1,10020,105
10019,105,0.672853190755662,id37a54bbf,right_ankle,1.31948804855347,1,1,10020,105
14389,101,0.116949210581242,id37a54bbf,left_wrist,1.28541398048401,-3,-3,14386,101
14383,102,0.206878835817594,id37a54bbf,left_hip,1.2941210269928,3,2,14386,101
14381,105,0.631976672865989,id37a54bbf,left_ankle,1.30873799324036,5,1,14386,101
14383,104,0.651983238291873,id37a54bbf,right_ankle,1.31948804855347,3,0,14386,101
17387,96,0.232988010753648,id3e3e50c7,left_wrist,1.01423501968384,1,-2,17388,93
17390,94,0.388920995550729,id3e3e50c7,left_hip,1.11150193214417,-2,-3,17388,93
17386,95,0.673346854704673,id3e3e50c7,left_ankle,0.935372114181519,2,0,17388,93
17387,94,0.728215948317766,id3e3e50c7,right_ankle,0.922698974609375,1,0,17388,93
8649,94,0.221949185421646,id3e3e50c7,left_wrist,1.01423501968384,1,1,8650,94
8652,93,0.363411276322833,id3e3e50c7,left_hip,1.11150193214417,-2,-1,8650,94
8649,94,0.686389556040811,id3e3e50c7,left_ankle,0.935372114181519,1,1,8650,94
8647,93,0.741680339256835,id3e3e50c7,right_ankle,0.922698974609375,3,4,8650,94
8465,93,0.190624702521465,id3e3e50c7,left_wrist,1.01423501968384,2,1,8467,92
8468,93,0.360820289541525,id3e3e50c7,left_hip,1.11150193214417,-1,-2,8467,92
8465,94,0.744991678423077,id3e3e50c7,left_ankle,0.935372114181519,2,0,8467,92
8463,93,0.765428556258772,id3e3e50c7,right_ankle,0.922698974609375,4,3,8467,92
3095,95,0.189789317033172,id3e3e50c7,left_wrist,1.01423501968384,3,2,3098,94
3098,94,0.360697094095151,id3e3e50c7,left_hip,1.11150193214417,0,0,3098,94
3096,95,0.720851833810676,id3e3e50c7,left_ankle,0.935372114181519,2,1,3098,94
3092,95,0.73987731927707,id3e3e50c7,right_ankle,0.922698974609375,6,5,3098,94
13112,87,0.18809208957379,id3e3e50c7,left_wrist,1.01423501968384,-1,3,13111,91
13114,91,0.398984131436915,id3e3e50c7,left_hip,1.11150193214417,-3,-3,13111,91
13110,90,0.680107035909761,id3e3e50c7,left_ankle,0.935372114181519,1,2,13111,91
13108,94,0.758256187745412,id3e3e50c7,right_ankle,0.922698974609375,3,0,13111,91
7910,90,0.160712804862118,id3e3e50c7,left_wrist,1.01423501968384,1,4,7911,93
7913,93,0.324012845743692,id3e3e50c7,left_hip,1.11150193214417,-2,-2,7911,93
7909,93,0.655193779501623,id3e3e50c7,left_ankle,0.935372114181519,2,2,7911,93
7908,94,0.739404771965161,id3e3e50c7,right_ankle,0.922698974609375,3,2,7911,93
8929,90,0.256082312301455,id3e3e50c7,left_wrist,1.01423501968384,0,2,8929,92
8931,91,0.38561447913915,id3e3e50c7,left_hip,1.11150193214417,-2,-1,8929,92
8926,92,0.732321461447617,id3e3e50c7,left_ankle,0.935372114181519,3,3,8929,92
8926,91,0.741438583298957,id3e3e50c7,right_ankle,0.922698974609375,3,4,8929,92
3661,90,0.188223691989037,id3e3e50c7,left_wrist,1.01423501968384,0,4,3661,94
3662,93,0.379929094190401,id3e3e50c7,left_hip,1.11150193214417,-1,0,3661,94
3660,93,0.789245598204579,id3e3e50c7,left_ankle,0.935372114181519,1,2,3661,94
3657,94,0.739434403650147,id3e3e50c7,right_ankle,0.922698974609375,4,4,3661,94
4032,98,0.221239950456535,id3e3e50c7,left_wrist,1.01423501968384,3,-1,4035,94
4035,94,0.392272031851494,id3e3e50c7,left_hip,1.11150193214417,0,0,4035,94
4033,95,0.724329318413388,id3e3e50c7,left_ankle,0.935372114181519,2,1,4035,94
4029,93,0.73839689465133,id3e3e50c7,right_ankle,0.922698974609375,6,7,4035,94
10382,90,0.207675880652516,id3e3e50c7,left_wrist,1.01423501968384,-1,2,10381,93
10383,92,0.393371351348447,id3e3e50c7,left_hip,1.11150193214417,-2,-1,10381,93
10380,92,0.721667958135658,id3e3e50c7,left_ankle,0.935372114181519,1,2,10381,93
10379,91,0.779006932282307,id3e3e50c7,right_ankle,0.922698974609375,2,4,10381,93
10104,93,0.195325784699935,id3e3e50c7,left_wrist,1.01423501968384,0,0,10104,93
10106,93,0.385316425056288,id3e3e50c7,left_hip,1.11150193214417,-2,-2,10104,93
10103,93,0.663828571300127,id3e3e50c7,left_ankle,0.935372114181519,1,1,10104,93
10101,95,0.716542334969312,id3e3e50c7,right_ankle,0.922698974609375,3,1,10104,93
1405,94,0.170734391350948,id3e3e50c7,left_wrist,1.01423501968384,1,2,1406,95
1407,94,0.404435926981709,id3e3e50c7,left_hip,1.11150193214417,-1,0,1406,95
1406,95,0.804274888912304,id3e3e50c7,left_ankle,0.935372114181519,0,0,1406,95
1404,93,0.772467806903137,id3e3e50c7,right_ankle,0.922698974609375,2,4,1406,95
649,95,0.186041272955693,id3e3e50c7,left_wrist,1.01423501968384,2,1,651,94
652,95,0.354154401782268,id3e3e50c7,left_hip,1.11150193214417,-1,-2,651,94
649,95,0.642030059410458,id3e3e50c7,left_ankle,0.935372114181519,2,1,651,94
647,96,0.701232210520293,id3e3e50c7,right_ankle,0.922698974609375,4,2,651,94
11196,89,0.230587673651707,id3e3e50c7,left_wrist,1.01423501968384,1,2,11197,90
11198,91,0.381921868799557,id3e3e50c7,left_hip,1.11150193214417,-1,-2,11197,90
11195,90,0.694922306078916,id3e3e50c7,left_ankle,0.935372114181519,2,2,11197,90
11194,92,0.754012119820384,id3e3e50c7,right_ankle,0.922698974609375,3,1,11197,90
16110,92,0.224162092360085,id3e3e50c7,left_wrist,1.01423501968384,1,0,16111,91
16113,91,0.407672686292492,id3e3e50c7,left_hip,1.11150193214417,-2,-2,16111,91
16109,91,0.664032814578341,id3e3e50c7,left_ankle,0.935372114181519,2,2,16111,91
16110,91,0.766246219446144,id3e3e50c7,right_ankle,0.922698974609375,1,1,16111,91
10471,91,0.220068729563753,id3e3e50c7,left_wrist,1.01423501968384,2,3,10473,92
10474,92,0.395373022336209,id3e3e50c7,left_hip,1.11150193214417,-1,-1,10473,92
10471,92,0.661017487982443,id3e3e50c7,left_ankle,0.935372114181519,2,2,10473,92
10469,95,0.760276928972956,id3e3e50c7,right_ankle,0.922698974609375,4,1,10473,92
9740,95,0.215961557040526,id3e3e50c7,left_wrist,1.01423501968384,2,-2,9742,91
9744,91,0.387895112034391,id3e3e50c7,left_hip,1.11150193214417,-2,-2,9742,91
9740,92,0.789025849473052,id3e3e50c7,left_ankle,0.935372114181519,2,1,9742,91
9738,92,0.748498550160104,id3e3e50c7,right_ankle,0.922698974609375,4,3,9742,91
9199,92,0.186891459961517,id3e3e50c7,left_wrist,1.01423501968384,1,1,9200,92
9203,91,0.396060605731268,id3e3e50c7,left_hip,1.11150193214417,-3,-2,9200,92
9197,93,0.757851638156704,id3e3e50c7,left_ankle,0.935372114181519,3,2,9200,92
9199,91,0.704042458873482,id3e3e50c7,right_ankle,0.922698974609375,1,2,9200,92
17112,92,0.179929542484083,id3e3e50c7,left_wrist,1.01423501968384,1,0,17113,91
17115,92,0.391437999456206,id3e3e50c7,left_hip,1.11150193214417,-2,-3,17113,91
17112,91,0.681060070176796,id3e3e50c7,left_ankle,0.935372114181519,1,1,17113,91
17112,91,0.716986896716083,id3e3e50c7,right_ankle,0.922698974609375,1,1,17113,91
8929,90,0.256082312301455,id3e3e50c7,left_wrist,1.01423501968384,0,2,8929,92
8931,91,0.38561447913915,id3e3e50c7,left_hip,1.11150193214417,-2,-1,8929,92
8926,92,0.732321461447617,id3e3e50c7,left_ankle,0.935372114181519,3,3,8929,92
8926,91,0.741438583298957,id3e3e50c7,right_ankle,0.922698974609375,3,4,8929,92
15082,97,0.170610288887069,idf1ce9a0f,left_wrist,1.33248686790466,-3,-5,15079,95
15076,98,0.246328627771958,idf1ce9a0f,left_hip,1.39485216140747,3,0,15079,95
15077,98,0.94518600838198,idf1ce9a0f,left_ankle,1.33595395088196,2,-1,15079,95
15079,97,0.761722460364759,idf1ce9a0f,right_ankle,1.33191299438477,0,-2,15079,95
13358,96,0.151776188138,idf1ce9a0f,left_wrist,1.33248686790466,-5,-3,13353,98
13352,96,0.255658927045649,idf1ce9a0f,left_hip,1.39485216140747,1,3,13353,98
13352,98,0.985195549349174,idf1ce9a0f,left_ankle,1.33595395088196,1,1,13353,98
13354,97,0.805370004118339,idf1ce9a0f,right_ankle,1.33191299438477,-1,0,13353,98
5316,97,0.0986208632874256,idf1ce9a0f,left_wrist,1.33248686790466,-5,-6,5311,96
5309,98,0.238208368509593,idf1ce9a0f,left_hip,1.39485216140747,2,0,5311,96
5309,98,0.877597825939419,idf1ce9a0f,left_ankle,1.33595395088196,2,0,5311,96
5311,98,0.73670946913606,idf1ce9a0f,right_ankle,1.33191299438477,0,-2,5311,96
5804,101,0.139985806123355,idf1ce9a0f,left_wrist,1.33248686790466,-6,-9,5798,98
5796,100,0.225206906724608,idf1ce9a0f,left_hip,1.39485216140747,2,0,5798,98
5796,100,0.965098680095394,idf1ce9a0f,left_ankle,1.33595395088196,2,0,5798,98
5799,100,0.716366659498511,idf1ce9a0f,right_ankle,1.33191299438477,-1,-3,5798,98
16134,95,0.257207936396796,idf1ce9a0f,left_wrist,1.33248686790466,-7,-6,16127,96
16126,96,0.290053009501848,idf1ce9a0f,left_hip,1.39485216140747,1,1,16127,96
16128,95,0.891723314391447,idf1ce9a0f,left_ankle,1.33595395088196,-1,0,16127,96
16128,96,0.78405894915383,idf1ce9a0f,right_ankle,1.33191299438477,-1,-1,16127,96
10084,96,0.242210052987814,idf1ce9a0f,left_wrist,1.33248686790466,2,3,10086,97
10085,96,0.255255511938734,idf1ce9a0f,left_hip,1.39485216140747,1,2,10086,97
10086,97,0.909646026077721,idf1ce9a0f,left_ankle,1.33595395088196,0,0,10086,97
10087,97,0.645873295133618,idf1ce9a0f,right_ankle,1.33191299438477,-1,-1,10086,97
3950,87,0.126700918379092,idf1ce9a0f,left_wrist,1.33248686790466,-9,2,3941,98
3941,98,0.257187526346973,idf1ce9a0f,left_hip,1.39485216140747,0,0,3941,98
3940,98,0.972979950405452,idf1ce9a0f,left_ankle,1.33595395088196,1,1,3941,98
3942,99,0.737045405563211,idf1ce9a0f,right_ankle,1.33191299438477,-1,-2,3941,98
16508,99,0.211629917882837,idf1ce9a0f,left_wrist,1.33248686790466,-6,-10,16502,95
16503,94,0.260282208214046,idf1ce9a0f,left_hip,1.39485216140747,-1,0,16502,95
16504,95,0.905255517513011,idf1ce9a0f,left_ankle,1.33595395088196,-2,-2,16502,95
16506,94,0.786784850196528,idf1ce9a0f,right_ankle,1.33191299438477,-4,-3,16502,95
2397,96,0.133267717055779,idf1ce9a0f,left_wrist,1.33248686790466,-6,-6,2391,96
2391,95,0.256812721750491,idf1ce9a0f,left_hip,1.39485216140747,0,1,2391,96
2391,96,1.01658360181648,idf1ce9a0f,left_ankle,1.33595395088196,0,0,2391,96
2391,98,0.787742313017847,idf1ce9a0f,right_ankle,1.33191299438477,0,-2,2391,96
19146,71,0.225811365802003,idf1ce9a0f,left_wrist,1.33248686790466,-24,-2,19122,93
19120,95,0.307825908821937,idf1ce9a0f,left_hip,1.39485216140747,2,0,19122,93
19123,95,0.935047724375136,idf1ce9a0f,left_ankle,1.33595395088196,-1,-3,19122,93
19123,95,0.790896084016654,idf1ce9a0f,right_ankle,1.33191299438477,-1,-3,19122,93
13647,96,0.19477444294757,idf1ce9a0f,left_wrist,1.33248686790466,-8,-5,13639,99
13641,96,0.252030927969887,idf1ce9a0f,left_hip,1.39485216140747,-2,1,13639,99
13641,97,0.865628936514519,idf1ce9a0f,left_ankle,1.33595395088196,-2,0,13639,99
13644,95,0.673018435403277,idf1ce9a0f,right_ankle,1.33191299438477,-5,-1,13639,99
12392,97,0.242713864214501,idf1ce9a0f,left_wrist,1.33248686790466,-6,-4,12386,99
12385,97,0.26472753403812,idf1ce9a0f,left_hip,1.39485216140747,1,3,12386,99
12386,97,0.884634230718936,idf1ce9a0f,left_ankle,1.33595395088196,0,2,12386,99
12387,97,0.632764961133576,idf1ce9a0f,right_ankle,1.33191299438477,-1,1,12386,99
7374,98,0.134636488046005,idf1ce9a0f,left_wrist,1.33248686790466,-6,-5,7368,99
7368,99,0.230623476703545,idf1ce9a0f,left_hip,1.39485216140747,0,0,7368,99
7369,98,0.919815826607433,idf1ce9a0f,left_ankle,1.33595395088196,-1,0,7368,99
7370,100,0.653125672796048,idf1ce9a0f,right_ankle,1.33191299438477,-2,-3,7368,99
10084,96,0.242210052987814,idf1ce9a0f,left_wrist,1.33248686790466,2,3,10086,97
10085,96,0.255255511938734,idf1ce9a0f,left_hip,1.39485216140747,1,2,10086,97
10086,97,0.909646026077721,idf1ce9a0f,left_ankle,1.33595395088196,0,0,10086,97
10087,97,0.645873295133618,idf1ce9a0f,right_ankle,1.33191299438477,-1,-1,10086,97
11081,162,0.289032934978409,idf1ce9a0f,left_wrist,1.33248686790466,65,1,11146,98
11143,98,0.238472666070437,idf1ce9a0f,left_hip,1.39485216140747,3,3,11146,98
11144,98,0.906626006862681,idf1ce9a0f,left_ankle,1.33595395088196,2,2,11146,98
11147,97,0.778023136854738,idf1ce9a0f,right_ankle,1.33191299438477,-1,0,11146,98
4047,99,0.153205894293437,idf1ce9a0f,left_wrist,1.33248686790466,-9,-8,4038,100
4038,100,0.247159965931202,idf1ce9a0f,left_hip,1.39485216140747,0,0,4038,100
4037,101,0.815749167481246,idf1ce9a0f,left_ankle,1.33595395088196,1,0,4038,100
4040,101,0.760381316735952,idf1ce9a0f,right_ankle,1.33191299438477,-2,-3,4038,100
11723,100,0.261255488346114,idf1ce9a0f,left_wrist,1.33248686790466,-4,-7,11719,97
11718,96,0.257017059073504,idf1ce9a0f,left_hip,1.39485216140747,1,2,11719,97
11719,96,0.919926629300851,idf1ce9a0f,left_ankle,1.33595395088196,0,1,11719,97
11721,97,0.644823905754219,idf1ce9a0f,right_ankle,1.33191299438477,-2,-2,11719,97
1717,100,0.152193754112379,idf1ce9a0f,left_wrist,1.33248686790466,-7,-10,1710,97
1708,99,0.22252438905974,idf1ce9a0f,left_hip,1.39485216140747,2,0,1710,97
1709,99,0.881367178697208,idf1ce9a0f,left_ankle,1.33595395088196,1,-1,1710,97
1711,98,0.676532928027795,idf1ce9a0f,right_ankle,1.33191299438477,-1,-2,1710,97
6193,100,0.144456253873762,idf1ce9a0f,left_wrist,1.33248686790466,-4,-6,6189,98
6187,99,0.229652415532631,idf1ce9a0f,left_hip,1.39485216140747,2,1,6189,98
6187,99,0.873884758269407,idf1ce9a0f,left_ankle,1.33595395088196,2,1,6189,98
6188,100,0.622678974229541,idf1ce9a0f,right_ankle,1.33191299438477,1,-1,6189,98
4734,95,0.11551183777797,idf1ce9a0f,left_wrist,1.33248686790466,-6,-2,4728,99
4727,97,0.279994265244363,idf1ce9a0f,left_hip,1.39485216140747,1,3,4728,99
4727,97,0.865942639602142,idf1ce9a0f,left_ankle,1.33595395088196,1,3,4728,99
4729,97,0.7543880687971,idf1ce9a0f,right_ankle,1.33191299438477,-1,1,4728,99
6145,117,0.142315670982257,idecc9265e,left_wrist,1.10599398612976,6,3,6151,114
6149,115,0.236031737676052,idecc9265e,left_hip,1.09542679786682,2,1,6151,114
6146,115,0.615781210276147,idecc9265e,left_ankle,1.11482191085815,5,4,6151,114
6145,115,0.665460025506492,idecc9265e,right_ankle,1.12344193458557,6,5,6151,114
18996,113,0.185944331348646,idecc9265e,left_wrist,1.10599398612976,-8,-9,18988,112
18995,112,0.252199270126057,idecc9265e,left_hip,1.09542679786682,-7,-7,18988,112
18992,112,0.62584793127871,idecc9265e,left_ankle,1.11482191085815,-4,-4,18988,112
18992,112,0.708686709640825,idecc9265e,right_ankle,1.12344193458557,-4,-4,18988,112
9602,58,0.138431235342649,idecc9265e,left_wrist,1.10599398612976,-14,49,9588,121
9593,123,0.18939262593496,idecc9265e,left_hip,1.09542679786682,-5,-7,9588,121
9594,118,0.551953668059317,idecc9265e,left_ankle,1.11482191085815,-6,-3,9588,121
9588,122,0.532974248921196,idecc9265e,right_ankle,1.12344193458557,0,-1,9588,121
16638,117,0.229747892026756,idecc9265e,left_wrist,1.10599398612976,-10,-14,16628,113
16635,113,0.222354764704484,idecc9265e,left_hip,1.09542679786682,-7,-7,16628,113
16631,119,0.633416070410138,idecc9265e,left_ankle,1.11482191085815,-3,-9,16628,113
16631,114,0.726625570507734,idecc9265e,right_ankle,1.12344193458557,-3,-4,16628,113
18886,111,0.231839264169228,idecc9265e,left_wrist,1.10599398612976,-9,-8,18877,112
18883,113,0.248005542059155,idecc9265e,left_hip,1.09542679786682,-6,-7,18877,112
18880,113,0.643296368576191,idecc9265e,left_ankle,1.11482191085815,-3,-4,18877,112
18880,113,0.636068085400074,idecc9265e,right_ankle,1.12344193458557,-3,-4,18877,112
8887,123,0.197455139059007,idecc9265e,left_wrist,1.10599398612976,-2,-8,8885,117
8889,118,0.22046298455753,idecc9265e,left_hip,1.09542679786682,-4,-5,8885,117
8889,117,0.659512589615256,idecc9265e,left_ankle,1.11482191085815,-4,-4,8885,117
8887,117,0.657558462631786,idecc9265e,right_ankle,1.12344193458557,-2,-2,8885,117
1374,112,0.176540647620918,idecc9265e,left_wrist,1.10599398612976,-13,-10,1361,115
1367,116,0.220264826025,idecc9265e,left_hip,1.09542679786682,-6,-7,1361,115
1365,115,0.61881409547206,idecc9265e,left_ankle,1.11482191085815,-4,-4,1361,115
1366,114,0.68830053382259,idecc9265e,right_ankle,1.12344193458557,-5,-4,1361,115
7185,117,0.154007352714994,idecc9265e,left_wrist,1.10599398612976,-9,-11,7176,115
7183,114,0.225430813219461,idecc9265e,left_hip,1.09542679786682,-7,-6,7176,115
7179,116,0.63768031542747,idecc9265e,left_ankle,1.11482191085815,-3,-4,7176,115
7179,115,0.64132992384546,idecc9265e,right_ankle,1.12344193458557,-3,-3,7176,115
15502,115,0.206704937552178,idecc9265e,left_wrist,1.10599398612976,-9,-9,15493,115
15499,117,0.235510486834656,idecc9265e,left_hip,1.09542679786682,-6,-8,15493,115
15497,115,0.649245950334659,idecc9265e,left_ankle,1.11482191085815,-4,-4,15493,115
15496,116,0.726056625931542,idecc9265e,right_ankle,1.12344193458557,-3,-4,15493,115
7301,115,0.130899223499801,idecc9265e,left_wrist,1.10599398612976,-11,-11,7290,115
7296,116,0.204892404574267,idecc9265e,left_hip,1.09542679786682,-6,-7,7290,115
7294,116,0.622567105655291,idecc9265e,left_ankle,1.11482191085815,-4,-5,7290,115
7293,116,0.715348205586613,idecc9265e,right_ankle,1.12344193458557,-3,-4,7290,115
13593,111,0.192487266976136,idecc9265e,left_wrist,1.10599398612976,-11,-7,13582,115
13587,116,0.224657019361832,idecc9265e,left_hip,1.09542679786682,-5,-6,13582,115
13586,115,0.654787486226319,idecc9265e,left_ankle,1.11482191085815,-4,-4,13582,115
13584,115,0.709287606759598,idecc9265e,right_ankle,1.12344193458557,-2,-2,13582,115
17875,114,0.221543292533438,idecc9265e,left_wrist,1.10599398612976,-8,-9,17867,113
17874,113,0.251645335828844,idecc9265e,left_hip,1.09542679786682,-7,-7,17867,113
17870,113,0.661429733863582,idecc9265e,left_ankle,1.11482191085815,-3,-3,17867,113
17871,113,0.671930558749422,idecc9265e,right_ankle,1.12344193458557,-4,-4,17867,113
18209,116,0.171375791933132,idecc9265e,left_wrist,1.10599398612976,-7,-9,18202,114
18209,112,0.245764134525332,idecc9265e,left_hip,1.09542679786682,-7,-5,18202,114
18205,117,0.635766676901507,idecc9265e,left_ankle,1.11482191085815,-3,-6,18202,114
18206,113,0.697561600340601,idecc9265e,right_ankle,1.12344193458557,-4,-3,18202,114
8325,110,0.177616150559059,idecc9265e,left_wrist,1.10599398612976,-9,-5,8316,114
8321,116,0.240315369042581,idecc9265e,left_hip,1.09542679786682,-5,-7,8316,114
8319,114,0.570857693039994,idecc9265e,left_ankle,1.11482191085815,-3,-3,8316,114
8319,114,0.710849911084233,idecc9265e,right_ankle,1.12344193458557,-3,-3,8316,114
8208,118,0.141802159725817,idecc9265e,left_wrist,1.10599398612976,-7,-9,8201,116
8207,115,0.22318377632173,idecc9265e,left_hip,1.09542679786682,-6,-5,8201,116
8205,115,0.640527796567639,idecc9265e,left_ankle,1.11482191085815,-4,-3,8201,116
8203,117,0.698179114158106,idecc9265e,right_ankle,1.12344193458557,-2,-3,8201,116
19108,118,0.201532277536324,idecc9265e,left_wrist,1.10599398612976,-9,-11,19099,116
19106,115,0.23304365404803,idecc9265e,left_hip,1.09542679786682,-7,-6,19099,116
19103,116,0.603200766897485,idecc9265e,left_ankle,1.11482191085815,-4,-4,19099,116
19103,114,0.640396342435639,idecc9265e,right_ankle,1.12344193458557,-4,-2,19099,116
13703,109,0.145851487801049,idecc9265e,left_wrist,1.10599398612976,-7,-4,13696,112
13702,112,0.223334217947089,idecc9265e,left_hip,1.09542679786682,-6,-6,13696,112
13700,110,0.596328818356302,idecc9265e,left_ankle,1.11482191085815,-4,-2,13696,112
13698,114,0.636525389461752,idecc9265e,right_ankle,1.12344193458557,-2,-4,13696,112
15841,115,0.198696588578764,idecc9265e,left_wrist,1.10599398612976,-9,-10,15832,114
15840,114,0.231330925025072,idecc9265e,left_hip,1.09542679786682,-8,-8,15832,114
15836,114,0.554106568246553,idecc9265e,left_ankle,1.11482191085815,-4,-4,15832,114
15836,115,0.640054858701746,idecc9265e,right_ankle,1.12344193458557,-4,-5,15832,114
12910,116,0.161708026476602,idecc9265e,left_wrist,1.10599398612976,-11,-11,12899,116
12907,114,0.223080394057695,idecc9265e,left_hip,1.09542679786682,-8,-6,12899,116
12903,116,0.625195790024861,idecc9265e,left_ankle,1.11482191085815,-4,-4,12899,116
12903,116,0.607016034573266,idecc9265e,right_ankle,1.12344193458557,-4,-4,12899,116
19225,113,0.174327672368182,idecc9265e,left_wrist,1.10599398612976,-11,-10,19214,114
19220,114,0.238494413209548,idecc9265e,left_hip,1.09542679786682,-6,-6,19214,114
19218,113,0.639932851749414,idecc9265e,left_ankle,1.11482191085815,-4,-3,19214,114
19216,115,0.686089477624005,idecc9265e,right_ankle,1.12344193458557,-2,-3,19214,114
5804,102,0.129494269229894,id687ab496,left_wrist,1.0899829864502,-4,-4,5800,102
5791,109,0.279590949989038,id687ab496,left_hip,1.07318615913391,9,2,5800,102
5796,103,0.744875438107,id687ab496,left_ankle,1.06276798248291,4,3,5800,102
5797,103,0.706455911705636,id687ab496,right_ankle,1.05741000175476,3,2,5800,102
3786,104,0.121876044435017,id687ab496,left_wrist,1.0899829864502,4,1,3790,101
3787,103,0.281171201859502,id687ab496,left_hip,1.07318615913391,3,1,3790,101
3784,103,0.757231501511161,id687ab496,left_ankle,1.06276798248291,6,4,3790,101
3787,100,0.701751911314053,id687ab496,right_ankle,1.05741000175476,3,4,3790,101
17475,103,0.335728556181974,id687ab496,left_wrist,1.0899829864502,-5,-7,17470,101
17469,102,0.27691983756351,id687ab496,left_hip,1.07318615913391,1,0,17470,101
17469,102,0.737085581780159,id687ab496,left_ankle,1.06276798248291,1,0,17470,101
17469,101,0.671595496057757,id687ab496,right_ankle,1.05741000175476,1,1,17470,101
9959,99,0.187531674028809,id687ab496,left_wrist,1.0899829864502,-3,-1,9956,101
9956,100,0.321598660014853,id687ab496,left_hip,1.07318615913391,0,1,9956,101
9952,104,0.71586494769523,id687ab496,left_ankle,1.06276798248291,4,1,9956,101
9954,99,0.649833098424661,id687ab496,right_ankle,1.05741000175476,2,4,9956,101
17276,98,0.160019496528454,id687ab496,left_wrist,1.0899829864502,-4,-3,17272,99
17271,101,0.328884808046159,id687ab496,left_hip,1.07318615913391,1,-1,17272,99
17271,100,0.754872416817849,id687ab496,left_ankle,1.06276798248291,1,0,17272,99
17270,98,0.679159459686069,id687ab496,right_ankle,1.05741000175476,2,3,17272,99
3786,104,0.121876044435017,id687ab496,left_wrist,1.0899829864502,3,1,3789,102
3787,103,0.281171201859502,id687ab496,left_hip,1.07318615913391,2,1,3789,102
3784,103,0.757231501511161,id687ab496,left_ankle,1.06276798248291,5,4,3789,102
3787,100,0.701751911314053,id687ab496,right_ankle,1.05741000175476,2,4,3789,102
14962,102,0.242501612580855,id687ab496,left_wrist,1.0899829864502,-2,-4,14960,100
14961,99,0.303947259456453,id687ab496,left_hip,1.07318615913391,-1,0,14960,100
14959,101,0.663339428104948,id687ab496,left_ankle,1.06276798248291,1,0,14960,100
14957,100,0.643815170615076,id687ab496,right_ankle,1.05741000175476,3,3,14960,100
14264,105,0.189322726759814,id687ab496,left_wrist,1.0899829864502,2,-4,14266,99
14265,100,0.290527346950326,id687ab496,left_hip,1.07318615913391,1,0,14266,99
14265,101,0.792089048576777,id687ab496,left_ankle,1.06276798248291,1,-1,14266,99
14262,99,0.688950880464138,id687ab496,right_ankle,1.05741000175476,4,4,14266,99
18573,100,0.230837065704201,id687ab496,left_wrist,1.0899829864502,-4,-3,18569,101
18569,101,0.330947075393692,id687ab496,left_hip,1.07318615913391,0,0,18569,101
18569,100,0.790834076418048,id687ab496,left_ankle,1.06276798248291,0,1,18569,101
18566,101,0.592659846420271,id687ab496,right_ankle,1.05741000175476,3,3,18569,101
10858,106,0.186379442207368,id687ab496,left_wrist,1.0899829864502,2,-2,10860,102
10858,102,0.257702755133097,id687ab496,left_hip,1.07318615913391,2,2,10860,102
10858,101,0.675929255358068,id687ab496,left_ankle,1.06276798248291,2,3,10860,102
10856,103,0.638909743753634,id687ab496,right_ankle,1.05741000175476,4,3,10860,102
14072,99,0.138626985323351,id687ab496,left_wrist,1.0899829864502,-3,-2,14069,100
14069,99,0.300692556825903,id687ab496,left_hip,1.07318615913391,0,1,14069,100
14069,99,0.775105318416625,id687ab496,left_ankle,1.06276798248291,0,1,14069,100
14065,99,0.673920774899401,id687ab496,right_ankle,1.05741000175476,4,5,14069,100
7729,102,0.174579442902315,id687ab496,left_wrist,1.0899829864502,-4,-4,7725,102
7725,102,0.292079860943219,id687ab496,left_hip,1.07318615913391,0,0,7725,102
7722,102,0.776055180204678,id687ab496,left_ankle,1.06276798248291,3,3,7725,102
7723,101,0.647668597161776,id687ab496,right_ankle,1.05741000175476,2,3,7725,102
2176,104,0.176764373203958,id687ab496,left_wrist,1.0899829864502,1,0,2177,103
2176,102,0.284136025753987,id687ab496,left_hip,1.07318615913391,1,2,2177,103
2173,102,0.711111038755604,id687ab496,left_ankle,1.06276798248291,4,5,2177,103
2174,101,0.605947051905412,id687ab496,right_ankle,1.05741000175476,3,5,2177,103
18228,98,0.26655442453144,id687ab496,left_wrist,1.0899829864502,45,46,18273,99
18272,101,0.304039037873172,id687ab496,left_hip,1.07318615913391,1,-1,18273,99
18271,101,0.754734595731125,id687ab496,left_ankle,1.06276798248291,2,0,18273,99
18268,102,0.693812225430414,id687ab496,right_ankle,1.05741000175476,5,2,18273,99
5700,105,0.134015490508401,id687ab496,left_wrist,1.0899829864502,-3,-4,5697,104
5688,104,0.192024617705846,id687ab496,left_hip,1.07318615913391,9,9,5697,104
5693,104,0.798019425007482,id687ab496,left_ankle,1.06276798248291,4,4,5697,104
5696,102,0.653876965456892,id687ab496,right_ankle,1.05741000175476,1,3,5697,104
11756,103,0.14469988202928,id687ab496,left_wrist,1.0899829864502,2,1,11758,102
11758,102,0.261255091370237,id687ab496,left_hip,1.07318615913391,0,0,11758,102
11758,101,0.767485425600649,id687ab496,left_ankle,1.06276798248291,0,1,11758,102
11756,102,0.617440572685607,id687ab496,right_ankle,1.05741000175476,2,2,11758,102
2176,104,0.176764373203958,id687ab496,left_wrist,1.0899829864502,-5,-7,2171,102
2176,102,0.284136025753987,id687ab496,left_hip,1.07318615913391,-5,-5,2171,102
2173,102,0.711111038755604,id687ab496,left_ankle,1.06276798248291,-2,-2,2171,102
2174,101,0.605947051905412,id687ab496,right_ankle,1.05741000175476,-3,-2,2171,102
16568,101,0.215324958427291,id687ab496,left_wrist,1.0899829864502,-5,-3,16563,103
16564,102,0.274818684917906,id687ab496,left_hip,1.07318615913391,-1,0,16563,103
16560,103,0.734538242253998,id687ab496,left_ankle,1.06276798248291,3,3,16563,103
16561,103,0.66348518633893,id687ab496,right_ankle,1.05741000175476,2,2,16563,103
6312,107,0.261431883111581,id687ab496,left_wrist,1.0899829864502,3,-3,6315,101
6312,103,0.296900421521907,id687ab496,left_hip,1.07318615913391,3,1,6315,101
6313,99,0.746805381814799,id687ab496,left_ankle,1.06276798248291,2,4,6315,101
6311,101,0.599660452291617,id687ab496,right_ankle,1.05741000175476,4,4,6315,101
15457,105,0.18251400553063,id687ab496,left_wrist,1.0899829864502,1,1,15458,105
15458,104,0.263836484126575,id687ab496,left_hip,1.07318615913391,0,1,15458,105
15455,105,0.658432163840717,id687ab496,left_ankle,1.06276798248291,3,3,15458,105
15458,100,0.621466685917512,id687ab496,right_ankle,1.05741000175476,0,5,15458,105
6046,103,0.185292084941454,id1f372081,left_wrist,1.401034116745,-1,3,6045,107
6044,107,0.260260864646713,id1f372081,left_hip,1.20928883552551,1,1,6045,107
6044,107,0.601872500955038,id1f372081,left_ankle,1.22508001327515,1,1,6045,107
6044,105,0.56162543023025,id1f372081,right_ankle,1.25053405761719,1,3,6045,107
4787,101,0.21441806973548,id1f372081,left_wrist,1.401034116745,-2,5,4785,108
4785,107,0.27076555212353,id1f372081,left_hip,1.20928883552551,0,1,4785,108
4784,108,0.633281586615917,id1f372081,left_ankle,1.22508001327515,1,1,4785,108
4784,107,0.52858987227111,id1f372081,right_ankle,1.25053405761719,1,2,4785,108
11299,104,0.289544640728637,id1f372081,left_wrist,1.401034116745,-12,-13,11287,103
11296,104,0.287279576296271,id1f372081,left_hip,1.20928883552551,-9,-10,11287,103
11294,103,0.544183555762887,id1f372081,left_ankle,1.22508001327515,-7,-7,11287,103
11291,106,0.496744713681717,id1f372081,right_ankle,1.25053405761719,-4,-7,11287,103
5940,107,0.200370480612359,id1f372081,left_wrist,1.401034116745,-1,-1,5939,107
5937,108,0.256091050506652,id1f372081,left_hip,1.20928883552551,2,1,5939,107
5937,108,0.646403068332531,id1f372081,left_ankle,1.22508001327515,2,1,5939,107
5937,108,0.550049220926554,id1f372081,right_ankle,1.25053405761719,2,1,5939,107
4059,101,0.11826431266353,id1f372081,left_wrist,1.401034116745,-13,-6,4046,108
4045,107,0.267694710739867,id1f372081,left_hip,1.20928883552551,1,2,4046,108
4046,106,0.653249185506284,id1f372081,left_ankle,1.22508001327515,0,2,4046,108
4046,103,0.556719227250708,id1f372081,right_ankle,1.25053405761719,0,5,4046,108
11402,108,0.295051795485743,id1f372081,left_wrist,1.401034116745,-13,-14,11389,107
11399,105,0.259143246283195,id1f372081,left_hip,1.20928883552551,-10,-8,11389,107
11396,106,0.589180126486849,id1f372081,left_ankle,1.22508001327515,-7,-6,11389,107
11396,104,0.501555247630547,id1f372081,right_ankle,1.25053405761719,-7,-4,11389,107
12335,106,0.160330712908674,id1f372081,left_wrist,1.401034116745,-7,-9,12328,104
12333,105,0.248749283191874,id1f372081,left_hip,1.20928883552551,-5,-6,12328,104
12334,106,0.553449292210905,id1f372081,left_ankle,1.22508001327515,-6,-8,12328,104
12334,104,0.534277580311142,id1f372081,right_ankle,1.25053405761719,-6,-6,12328,104
2873,113,0.161199379387749,id1f372081,left_wrist,1.401034116745,0,-6,2873,107
2871,106,0.26930793236209,id1f372081,left_hip,1.20928883552551,2,3,2873,107
2872,104,0.620691623132044,id1f372081,left_ankle,1.22508001327515,1,4,2873,107
2871,106,0.558403952677552,id1f372081,right_ankle,1.25053405761719,2,3,2873,107
5729,106,0.216660205736559,id1f372081,left_wrist,1.401034116745,0,0,5729,106
5728,106,0.280168607606751,id1f372081,left_hip,1.20928883552551,1,1,5729,106
5728,105,0.709735260818851,id1f372081,left_ankle,1.22508001327515,1,2,5729,106
5727,105,0.641182614213452,id1f372081,right_ankle,1.25053405761719,2,3,5729,106
15687,104,0.29540249579849,id1f372081,left_wrist,1.401034116745,-11,-13,15676,102
15684,106,0.24478274987186,id1f372081,left_hip,1.20928883552551,-8,-12,15676,102
15682,102,0.513929918171079,id1f372081,left_ankle,1.22508001327515,-6,-6,15676,102
15680,106,0.511994959356021,id1f372081,right_ankle,1.25053405761719,-4,-8,15676,102
20985,103,0.253658445918906,id1f372081,left_wrist,1.401034116745,-10,-10,20975,103
20983,104,0.26225571098931,id1f372081,left_hip,1.20928883552551,-8,-9,20975,103
20982,102,0.606406269592843,id1f372081,left_ankle,1.22508001327515,-7,-6,20975,103
20980,105,0.53457171882266,id1f372081,right_ankle,1.25053405761719,-5,-7,20975,103
2230,113,0.219753067164271,id1f372081,left_wrist,1.401034116745,-2,-7,2228,108
2232,109,0.266072481561271,id1f372081,left_hip,1.20928883552551,-4,-5,2228,108
2232,108,0.622383260246276,id1f372081,left_ankle,1.22508001327515,-4,-4,2228,108
2229,108,0.561290666659876,id1f372081,right_ankle,1.25053405761719,-1,-1,2228,108
16737,107,0.258465326583373,id1f372081,left_wrist,1.401034116745,-14,-17,16723,104
16732,111,0.249507043662267,id1f372081,left_hip,1.20928883552551,-9,-16,16723,104
16729,106,0.561806059882335,id1f372081,left_ankle,1.22508001327515,-6,-8,16723,104
16731,105,0.550944797026044,id1f372081,right_ankle,1.25053405761719,-8,-9,16723,104
20783,97,0.291397466124426,id1f372081,left_wrist,1.401034116745,-6,-1,20777,102
20781,100,0.303119764071561,id1f372081,left_hip,1.20928883552551,-4,-2,20777,102
20779,99,0.671295746303326,id1f372081,left_ankle,1.22508001327515,-2,1,20777,102
20775,105,0.524502638831646,id1f372081,right_ankle,1.25053405761719,2,-1,20777,102
17892,104,0.311696627930442,id1f372081,left_wrist,1.401034116745,-14,-12,17878,106
17886,106,0.261040610423322,id1f372081,left_hip,1.20928883552551,-8,-8,17878,106
17885,104,0.603067227973494,id1f372081,left_ankle,1.22508001327515,-7,-5,17878,106
17886,106,0.482831895593652,id1f372081,right_ankle,1.25053405761719,-8,-8,17878,106
6790,105,0.220938741140231,id1f372081,left_wrist,1.401034116745,-7,-6,6783,106
6788,106,0.278481087218966,id1f372081,left_hip,1.20928883552551,-5,-5,6783,106
6784,107,0.686815625923597,id1f372081,left_ankle,1.22508001327515,-1,-2,6783,106
6787,107,0.599228744007008,id1f372081,right_ankle,1.25053405761719,-4,-5,6783,106
14210,103,0.212379833942746,id1f372081,left_wrist,1.401034116745,-11,-10,14199,104
14206,104,0.226234011620057,id1f372081,left_hip,1.20928883552551,-7,-7,14199,104
14204,104,0.639552601522642,id1f372081,left_ankle,1.22508001327515,-5,-5,14199,104
14202,103,0.568853311598354,id1f372081,right_ankle,1.25053405761719,-3,-2,14199,104
20783,97,0.291397466124426,id1f372081,left_wrist,1.401034116745,-6,-1,20777,102
20781,100,0.303119764071561,id1f372081,left_hip,1.20928883552551,-4,-2,20777,102
20779,99,0.671295746303326,id1f372081,left_ankle,1.22508001327515,-2,1,20777,102
20775,105,0.524502638831646,id1f372081,right_ankle,1.25053405761719,2,-1,20777,102
20985,103,0.253658445918906,id1f372081,left_wrist,1.401034116745,-3,-2,20982,104
20983,104,0.26225571098931,id1f372081,left_hip,1.20928883552551,-1,-1,20982,104
20982,102,0.606406269592843,id1f372081,left_ankle,1.22508001327515,0,2,20982,104
20980,105,0.53457171882266,id1f372081,right_ankle,1.25053405761719,2,1,20982,104
7527,104,0.225763826753724,id1f372081,left_wrist,1.401034116745,-8,-8,7519,104
7525,104,0.268016485628972,id1f372081,left_hip,1.20928883552551,-6,-6,7519,104
7524,104,0.651593227055647,id1f372081,left_ankle,1.22508001327515,-5,-5,7519,104
7523,104,0.561282573306783,id1f372081,right_ankle,1.25053405761719,-4,-4,7519,104
5555,101,0.087579466858368,id079c763c,left_wrist,1.17885518074036,8,10,5563,103
5564,102,0.239138950663713,id079c763c,left_hip,1.25334787368774,-1,0,5563,103
5566,102,0.588574277643825,id079c763c,left_ankle,1.24386692047119,-3,-2,5563,103
5563,104,0.704605807583273,id079c763c,right_ankle,1.22873592376709,0,-1,5563,103
3590,109,0.0754727982457196,id079c763c,left_wrist,1.17885518074036,-31,-40,3559,100
3560,101,0.277702252328591,id079c763c,left_hip,1.25334787368774,-1,-2,3559,100
3562,100,0.725239869484204,id079c763c,left_ankle,1.24386692047119,-3,-3,3559,100
3562,99,0.782950249675979,id079c763c,right_ankle,1.22873592376709,-3,-2,3559,100
6778,106,0.131770075307018,id079c763c,left_wrist,1.17885518074036,9,7,6787,104
6789,104,0.239090967006161,id079c763c,left_hip,1.25334787368774,-2,-2,6787,104
6789,106,0.62924923166045,id079c763c,left_ankle,1.24386692047119,-2,-4,6787,104
6787,103,0.668406059702656,id079c763c,right_ankle,1.22873592376709,0,1,6787,104
10751,95,0.174626285896355,id079c763c,left_wrist,1.17885518074036,7,6,10758,94
10759,96,0.346955546520529,id079c763c,left_hip,1.25334787368774,-1,-3,10758,94
10760,97,0.747309110213349,id079c763c,left_ankle,1.24386692047119,-2,-5,10758,94
10761,96,0.652847576214699,id079c763c,right_ankle,1.22873592376709,-3,-5,10758,94
19308,95,0.177007699495355,id079c763c,left_wrist,1.17885518074036,-5,-5,19303,95
19309,93,0.371861145604579,id079c763c,left_hip,1.25334787368774,-6,-4,19303,95
19307,95,0.788790519564996,id079c763c,left_ankle,1.24386692047119,-4,-4,19303,95
19309,94,0.715230817202816,id079c763c,right_ankle,1.22873592376709,-6,-5,19303,95
10751,95,0.174626285896355,id079c763c,left_wrist,1.17885518074036,7,6,10758,94
10759,96,0.346955546520529,id079c763c,left_hip,1.25334787368774,-1,-3,10758,94
10760,97,0.747309110213349,id079c763c,left_ankle,1.24386692047119,-2,-5,10758,94
10761,96,0.652847576214699,id079c763c,right_ankle,1.22873592376709,-3,-5,10758,94
5454,102,0.115597057570198,id079c763c,left_wrist,1.17885518074036,8,8,5462,102
5464,101,0.283984975254341,id079c763c,left_hip,1.25334787368774,-2,-1,5462,102
5465,102,0.681030118991457,id079c763c,left_ankle,1.24386692047119,-3,-3,5462,102
5462,102,0.651526552416581,id079c763c,right_ankle,1.22873592376709,0,0,5462,102
1048,73,0.093099256764633,id079c763c,left_wrist,1.17885518074036,9,30,1057,94
1058,94,0.282346599350346,id079c763c,left_hip,1.25334787368774,-1,-1,1057,94
1059,93,0.76890235930789,id079c763c,left_ankle,1.24386692047119,-2,-1,1057,94
1062,95,0.737131235627783,id079c763c,right_ankle,1.22873592376709,-5,-6,1057,94
8835,98,0.126872820830955,id079c763c,left_wrist,1.17885518074036,8,7,8843,97
8844,97,0.265765740378712,id079c763c,left_hip,1.25334787368774,-1,-1,8843,97
8846,96,0.71436795087425,id079c763c,left_ankle,1.24386692047119,-3,-2,8843,97
8848,94,0.724555019825733,id079c763c,right_ankle,1.22873592376709,-5,-2,8843,97
17924,88,0.170027258861152,id079c763c,left_wrist,1.17885518074036,-6,-3,17918,91
17924,91,0.391759114258129,id079c763c,left_hip,1.25334787368774,-6,-6,17918,91
17920,92,0.774627686375841,id079c763c,left_ankle,1.24386692047119,-2,-3,17918,91
17923,91,0.748013728757179,id079c763c,right_ankle,1.22873592376709,-5,-5,17918,91
7284,100,0.132714659342044,id079c763c,left_wrist,1.17885518074036,7,6,7291,99
7293,99,0.286114254913662,id079c763c,left_hip,1.25334787368774,-2,-2,7291,99
7295,99,0.70974126756444,id079c763c,left_ankle,1.24386692047119,-4,-4,7291,99
7294,99,0.62214602472175,id079c763c,right_ankle,1.22873592376709,-3,-3,7291,99
2763,102,0.172418012944612,id079c763c,left_wrist,1.17885518074036,8,6,2771,100
2771,101,0.329511327505389,id079c763c,left_hip,1.25334787368774,0,-1,2771,100
2772,101,0.741686906089931,id079c763c,left_ankle,1.24386692047119,-1,-2,2771,100
2771,100,0.740821882696756,id079c763c,right_ankle,1.22873592376709,0,0,2771,100
7866,100,0.0537837467641788,id079c763c,left_wrist,1.17885518074036,9,8,7875,99
7877,98,0.307932099181061,id079c763c,left_hip,1.25334787368774,-2,-1,7875,99
7879,98,0.695274964865915,id079c763c,left_ankle,1.24386692047119,-4,-3,7875,99
7880,97,0.73409990223357,id079c763c,right_ankle,1.22873592376709,-5,-3,7875,99
13417,97,0.0820400033662905,id079c763c,left_wrist,1.17885518074036,7,8,13424,98
13427,95,0.307932190041951,id079c763c,left_hip,1.25334787368774,-3,0,13424,98
13428,97,0.765776494567303,id079c763c,left_ankle,1.24386692047119,-4,-3,13424,98
13429,96,0.752018491093928,id079c763c,right_ankle,1.22873592376709,-5,-3,13424,98
8353,98,0.136928952858603,id079c763c,left_wrist,1.17885518074036,-88,-89,8265,97
8267,95,0.281533323535693,id079c763c,left_hip,1.25334787368774,-2,0,8265,97
8267,97,0.637729172781463,id079c763c,left_ankle,1.24386692047119,-2,-2,8265,97
8268,97,0.69458160380986,id079c763c,right_ankle,1.22873592376709,-3,-3,8265,97
14484,85,0.10857941634089,id079c763c,left_wrist,1.17885518074036,-5,8,14479,98
14478,100,0.234725817463979,id079c763c,left_hip,1.25334787368774,1,-1,14479,98
14481,100,0.757173585958017,id079c763c,left_ankle,1.24386692047119,-2,-4,14479,98
14482,96,0.62467115151135,id079c763c,right_ankle,1.22873592376709,-3,-1,14479,98
14665,110,0.141026942072258,id079c763c,left_wrist,1.17885518074036,8,-3,14673,99
14677,97,0.24370534920387,id079c763c,left_hip,1.25334787368774,-4,-2,14673,99
14675,100,0.755396834561632,id079c763c,left_ankle,1.24386692047119,-2,-3,14673,99
14676,98,0.721657713523998,id079c763c,right_ankle,1.22873592376709,-3,-2,14673,99
11630,91,0.223988256624013,id079c763c,left_wrist,1.17885518074036,-10,-4,11620,97
11622,99,0.326196919891466,id079c763c,left_hip,1.25334787368774,-2,-4,11620,97
11624,96,0.705468869191081,id079c763c,left_ankle,1.24386692047119,-4,-3,11620,97
11623,97,0.724241517797329,id079c763c,right_ankle,1.22873592376709,-3,-3,11620,97
9026,98,0.142456477944883,id079c763c,left_wrist,1.17885518074036,9,7,9035,96
9037,95,0.288429131305612,id079c763c,left_hip,1.25334787368774,-2,-1,9035,96
9037,97,0.74384491377137,id079c763c,left_ankle,1.24386692047119,-2,-3,9035,96
9038,97,0.736293261774115,id079c763c,right_ankle,1.22873592376709,-3,-4,9035,96
9605,93,0.0986497306988698,id079c763c,left_wrist,1.17885518074036,6,8,9611,95
9611,96,0.262141466427704,id079c763c,left_hip,1.25334787368774,0,-1,9611,95
9614,95,0.707786868138509,id079c763c,left_ankle,1.24386692047119,-3,-3,9611,95
9613,97,0.699237929616593,id079c763c,right_ankle,1.22873592376709,-2,-4,9611,95
5465,98,0.18178500110957,idbae5a811,left_wrist,0.960937023162842,-2,-6,5463,94
5459,97,0.252272979152135,idbae5a811,left_hip,0.977320909500122,4,1,5463,94
5462,99,0.640714978425456,idbae5a811,left_ankle,0.982759952545166,1,-4,5463,94
5460,99,0.593257935981104,idbae5a811,right_ankle,0.99410605430603,3,-2,5463,94
10342,90,0.172762475757004,idbae5a811,left_wrist,0.960937023162842,-4,-3,10338,91
10343,93,0.295319878025616,idbae5a811,left_hip,0.977320909500122,-5,-7,10338,91
10340,91,0.636621948228702,idbae5a811,left_ankle,0.982759952545166,-2,-2,10338,91
10340,92,0.647236622174949,idbae5a811,right_ankle,0.99410605430603,-2,-3,10338,91
16240,92,0.149899581495036,idbae5a811,left_wrist,0.960937023162842,-2,0,16238,94
16238,96,0.278222987076961,idbae5a811,left_hip,0.977320909500122,0,-2,16238,94
16237,93,0.639956286280095,idbae5a811,left_ankle,0.982759952545166,1,2,16238,94
16238,93,0.522204088784476,idbae5a811,right_ankle,0.99410605430603,0,1,16238,94
2597,91,0.151254664680017,idbae5a811,left_wrist,0.960937023162842,-3,2,2594,96
2598,91,0.309143736324095,idbae5a811,left_hip,0.977320909500122,-4,1,2594,96
2595,94,0.713214622656237,idbae5a811,left_ankle,0.982759952545166,-1,1,2594,96
2598,91,0.647826759531589,idbae5a811,right_ankle,0.99410605430603,-4,1,2594,96
7496,95,0.168672641397186,idbae5a811,left_wrist,0.960937023162842,-4,-5,7492,94
7498,92,0.267012772246985,idbae5a811,left_hip,0.977320909500122,-6,-4,7492,94
7496,94,0.628319224065873,idbae5a811,left_ankle,0.982759952545166,-4,-4,7492,94
7496,93,0.546160014974998,idbae5a811,right_ankle,0.99410605430603,-4,-3,7492,94
3771,91,0.21390368977663,idbae5a811,left_wrist,0.960937023162842,2,1,3773,90
3773,91,0.284438869092131,idbae5a811,left_hip,0.977320909500122,0,-1,3773,90
3771,91,0.733935481410819,idbae5a811,left_ankle,0.982759952545166,2,1,3773,90
3772,91,0.563062923570688,idbae5a811,right_ankle,0.99410605430603,1,0,3773,90
7685,90,0.175460159364325,idbae5a811,left_wrist,0.960937023162842,-5,-4,7680,91
7683,96,0.268108237116786,idbae5a811,left_hip,0.977320909500122,-3,-8,7680,91
7682,92,0.704775321714067,idbae5a811,left_ankle,0.982759952545166,-2,-3,7680,91
7683,93,0.618517253082492,idbae5a811,right_ankle,0.99410605430603,-3,-5,7680,91
2506,92,0.201850530715994,idbae5a811,left_wrist,0.960937023162842,-4,-3,2502,93
2505,94,0.280469866137429,idbae5a811,left_hip,0.977320909500122,-3,-4,2502,93
2506,90,0.725136698796641,idbae5a811,left_ankle,0.982759952545166,-4,-1,2502,93
2506,93,0.645313510985749,idbae5a811,right_ankle,0.99410605430603,-4,-4,2502,93
8237,97,0.143354117026422,idbae5a811,left_wrist,0.960937023162842,-4,-2,8233,99
8236,94,0.263226515363427,idbae5a811,left_hip,0.977320909500122,-3,2,8233,99
8235,95,0.661492514663783,idbae5a811,left_ankle,0.982759952545166,-2,2,8233,99
8234,95,0.612137604051912,idbae5a811,right_ankle,0.99410605430603,-1,3,8233,99
16789,93,0.107228441552058,idbae5a811,left_wrist,0.960937023162842,-3,-2,16786,94
16791,91,0.288461981520836,idbae5a811,left_hip,0.977320909500122,-5,-2,16786,94
16785,94,0.663726675500528,idbae5a811,left_ankle,0.982759952545166,1,1,16786,94
16787,92,0.572564809938513,idbae5a811,right_ankle,0.99410605430603,-1,1,16786,94
13599,92,0.131160528535059,idbae5a811,left_wrist,0.960937023162842,0,0,13599,92
13599,94,0.291915834582892,idbae5a811,left_hip,0.977320909500122,0,-2,13599,92
13597,92,0.686264395078165,idbae5a811,left_ankle,0.982759952545166,2,2,13599,92
13597,93,0.57654920040013,idbae5a811,right_ankle,0.99410605430603,2,1,13599,92
16607,92,0.14877004047604,idbae5a811,left_wrist,0.960937023162842,-2,-2,16605,92
16607,92,0.319895346650827,idbae5a811,left_hip,0.977320909500122,-2,-2,16605,92
16604,92,0.639034141675047,idbae5a811,left_ankle,0.982759952545166,1,1,16605,92
16605,92,0.580815385366476,idbae5a811,right_ankle,0.99410605430603,0,0,16605,92
8424,94,0.147064714229188,idbae5a811,left_wrist,0.960937023162842,1,1,8425,94
8424,94,0.277095141313284,idbae5a811,left_hip,0.977320909500122,1,1,8425,94
8424,93,0.675972344409914,idbae5a811,left_ankle,0.982759952545166,1,2,8425,94
8424,94,0.527137567495978,idbae5a811,right_ankle,0.99410605430603,1,1,8425,94
10787,91,0.196998158512293,idbae5a811,left_wrist,0.960937023162842,3,-3,10790,85
10791,92,0.249530462572308,idbae5a811,left_hip,0.977320909500122,-1,-8,10790,85
10789,89,0.714841420483167,idbae5a811,left_ankle,0.982759952545166,1,-3,10790,85
10790,89,0.624975667395927,idbae5a811,right_ankle,0.99410605430603,0,-4,10790,85
8702,91,0.181312264392182,idbae5a811,left_wrist,0.960937023162842,0,-5,8702,86
8702,93,0.285327480103793,idbae5a811,left_hip,0.977320909500122,0,-7,8702,86
8701,91,0.637307946380441,idbae5a811,left_ankle,0.982759952545166,1,-4,8702,86
8699,93,0.614658377590168,idbae5a811,right_ankle,0.99410605430603,3,-4,8702,86
1953,93,0.142862205417539,idbae5a811,left_wrist,0.960937023162842,0,-5,1953,88
1951,94,0.327061285011442,idbae5a811,left_hip,0.977320909500122,2,-4,1953,88
1951,94,0.709385717403242,idbae5a811,left_ankle,0.982759952545166,2,-4,1953,88
1951,94,0.670104029341623,idbae5a811,right_ankle,0.99410605430603,2,-4,1953,88
4412,97,0.197358259458432,idbae5a811,left_wrist,0.960937023162842,-1,-6,4411,92
4412,93,0.281386720185097,idbae5a811,left_hip,0.977320909500122,-1,-2,4411,92
4410,97,0.660342627815891,idbae5a811,left_ankle,0.982759952545166,1,-4,4411,92
4411,95,0.559148661550749,idbae5a811,right_ankle,0.99410605430603,0,-3,4411,92
8886,90,0.11454538558717,idbae5a811,left_wrist,0.960937023162842,-2,5,8884,97
8884,94,0.272099614457415,idbae5a811,left_hip,0.977320909500122,0,3,8884,97
8883,97,0.687195749321199,idbae5a811,left_ankle,0.982759952545166,1,1,8884,97
8883,94,0.496757246139564,idbae5a811,right_ankle,0.99410605430603,1,4,8884,97
6679,95,0.123083814914071,idbae5a811,left_wrist,0.960937023162842,5,-1,6684,89
6682,92,0.240730876810269,idbae5a811,left_hip,0.977320909500122,2,-1,6684,89
6680,93,0.657348667746694,idbae5a811,left_ankle,0.982759952545166,4,0,6684,89
6679,91,0.557770209787092,idbae5a811,right_ankle,0.99410605430603,5,3,6684,89
16607,92,0.14877004047604,idbae5a811,left_wrist,0.960937023162842,-2,-2,16605,92
16607,92,0.319895346650827,idbae5a811,left_hip,0.977320909500122,-2,-2,16605,92
16604,92,0.639034141675047,idbae5a811,left_ankle,0.982759952545166,1,1,16605,92
16605,92,0.580815385366476,idbae5a811,right_ankle,0.99410605430603,0,0,16605,92
11757,119,0.203825083529267,id7c20ee7a,left_wrist,1.29445600509644,1,-15,11758,103
11752,110,0.169782688811549,id7c20ee7a,left_hip,1.27044200897217,6,-1,11758,103
11758,102,0.614394138880045,id7c20ee7a,left_ankle,1.2545759677887,0,1,11758,103
11760,101,0.653118214300045,id7c20ee7a,right_ankle,1.25089883804321,-2,0,11758,103
7325,109,0.166919852866462,id7c20ee7a,left_wrist,1.29445600509644,-50,-50,7275,109
7268,111,0.155873499786037,id7c20ee7a,left_hip,1.27044200897217,7,5,7275,109
7273,110,0.670912868456163,id7c20ee7a,left_ankle,1.2545759677887,2,1,7275,109
7272,110,0.603852089335447,id7c20ee7a,right_ankle,1.25089883804321,3,2,7275,109
6332,109,0.185244770207084,id7c20ee7a,left_wrist,1.29445600509644,-49,-50,6283,108
6277,110,0.175439239739425,id7c20ee7a,left_hip,1.27044200897217,6,4,6283,108
6280,110,0.611777073953867,id7c20ee7a,left_ankle,1.2545759677887,3,1,6283,108
6280,109,0.52958763612256,id7c20ee7a,right_ankle,1.25089883804321,3,2,6283,108
17722,106,0.10200977726913,id7c20ee7a,left_wrist,1.29445600509644,-1,0,17721,107
17719,106,0.16422910955654,id7c20ee7a,left_hip,1.27044200897217,2,3,17721,107
17722,105,0.557122899537592,id7c20ee7a,left_ankle,1.2545759677887,-1,1,17721,107
17719,108,0.534586023896029,id7c20ee7a,right_ankle,1.25089883804321,2,1,17721,107
15827,98,0.106190621026718,id7c20ee7a,left_wrist,1.29445600509644,-4,4,15823,106
15823,106,0.173690326198655,id7c20ee7a,left_hip,1.27044200897217,0,0,15823,106
15825,105,0.637210783029307,id7c20ee7a,left_ankle,1.2545759677887,-2,-1,15823,106
15823,106,0.670523120319224,id7c20ee7a,right_ankle,1.25089883804321,0,0,15823,106
3831,56,0.1408536908385,id7c20ee7a,left_wrist,1.29445600509644,-51,4,3780,111
3775,112,0.176052379592977,id7c20ee7a,left_hip,1.27044200897217,5,4,3780,111
3778,110,0.526421756531925,id7c20ee7a,left_ankle,1.2545759677887,2,3,3780,111
3778,109,0.561923340806771,id7c20ee7a,right_ankle,1.25089883804321,2,4,3780,111
1634,107,0.151624674678088,id7c20ee7a,left_wrist,1.29445600509644,5,4,1639,106
1632,105,0.151791038121974,id7c20ee7a,left_hip,1.27044200897217,7,8,1639,106
1637,106,0.576361483905738,id7c20ee7a,left_ankle,1.2545759677887,2,2,1639,106
1637,106,0.537791926713409,id7c20ee7a,right_ankle,1.25089883804321,2,2,1639,106
17086,101,0.101723965389205,id7c20ee7a,left_wrist,1.29445600509644,-2,4,17084,107
17087,104,0.203442601132999,id7c20ee7a,left_hip,1.27044200897217,-3,0,17084,107
17085,105,0.66386077353888,id7c20ee7a,left_ankle,1.2545759677887,-1,1,17084,107
17084,106,0.610486876707656,id7c20ee7a,right_ankle,1.25089883804321,0,1,17084,107
13937,105,0.10366474501023,id7c20ee7a,left_wrist,1.29445600509644,4,5,13941,106
13937,105,0.145740816146624,id7c20ee7a,left_hip,1.27044200897217,4,5,13941,106
13940,105,0.575709886515627,id7c20ee7a,left_ankle,1.2545759677887,1,2,13941,106
13940,106,0.68071653559958,id7c20ee7a,right_ankle,1.25089883804321,1,1,13941,106
3886,113,0.176731983859112,id7c20ee7a,left_wrist,1.29445600509644,4,1,3890,110
3886,109,0.169250978049865,id7c20ee7a,left_hip,1.27044200897217,4,5,3890,110
3887,112,0.494653393604466,id7c20ee7a,left_ankle,1.2545759677887,3,1,3890,110
3886,112,0.505591251182075,id7c20ee7a,right_ankle,1.25089883804321,4,2,3890,110
1428,101,0.0979746188416122,id7c20ee7a,left_wrist,1.29445600509644,4,0,1432,97
1426,103,0.108501262723031,id7c20ee7a,left_hip,1.27044200897217,6,0,1432,97
1430,103,0.675713374857339,id7c20ee7a,left_ankle,1.2545759677887,2,-4,1432,97
1432,102,0.612919218949961,id7c20ee7a,right_ankle,1.25089883804321,0,-5,1432,97
2529,109,0.149508306109084,id7c20ee7a,left_wrist,1.29445600509644,-45,-47,2484,107
2478,106,0.166003702319203,id7c20ee7a,left_hip,1.27044200897217,6,7,2484,107
2482,106,0.624387236437699,id7c20ee7a,left_ankle,1.2545759677887,2,3,2484,107
2482,107,0.576610404886523,id7c20ee7a,right_ankle,1.25089883804321,2,2,2484,107
8722,61,0.120030616680246,id7c20ee7a,left_wrist,1.29445600509644,-49,-1,8673,109
8667,108,0.126534114258311,id7c20ee7a,left_hip,1.27044200897217,6,7,8673,109
8671,109,0.665005026940081,id7c20ee7a,left_ankle,1.2545759677887,2,2,8673,109
8670,109,0.624679994444093,id7c20ee7a,right_ankle,1.25089883804321,3,3,8673,109
3886,113,0.176731983859112,id7c20ee7a,left_wrist,1.29445600509644,4,1,3890,110
3886,109,0.169250978049865,id7c20ee7a,left_hip,1.27044200897217,4,5,3890,110
3887,112,0.494653393604466,id7c20ee7a,left_ankle,1.2545759677887,3,1,3890,110
3886,112,0.505591251182075,id7c20ee7a,right_ankle,1.25089883804321,4,2,3890,110
6825,57,0.122950505562465,id7c20ee7a,left_wrist,1.29445600509644,4,60,6829,113
6823,110,0.117523875528458,id7c20ee7a,left_hip,1.27044200897217,6,9,6829,113
6827,112,0.564179568799252,id7c20ee7a,left_ankle,1.2545759677887,2,3,6829,113
6826,111,0.541032552173471,id7c20ee7a,right_ankle,1.25089883804321,3,5,6829,113
4491,57,0.111233014398983,id7c20ee7a,left_wrist,1.29445600509644,-51,3,4440,111
4435,112,0.169677288750523,id7c20ee7a,left_hip,1.27044200897217,5,4,4440,111
4437,112,0.520937256790827,id7c20ee7a,left_ankle,1.2545759677887,3,2,4440,111
4437,111,0.517273975351268,id7c20ee7a,right_ankle,1.25089883804321,3,3,4440,111
5901,107,0.202938905463522,id7c20ee7a,left_wrist,1.29445600509644,-50,-49,5851,108
5842,110,0.189328133424356,id7c20ee7a,left_hip,1.27044200897217,9,7,5851,108
5848,109,0.560805050711091,id7c20ee7a,left_ankle,1.2545759677887,3,2,5851,108
5848,111,0.513700125674936,id7c20ee7a,right_ankle,1.25089883804321,3,0,5851,108
4272,110,0.157247753236093,id7c20ee7a,left_wrist,1.29445600509644,-50,-50,4222,110
4218,108,0.166774327044677,id7c20ee7a,left_hip,1.27044200897217,4,6,4222,110
4219,111,0.56680283293246,id7c20ee7a,left_ankle,1.2545759677887,3,2,4222,110
4219,110,0.547211479703786,id7c20ee7a,right_ankle,1.25089883804321,3,3,4222,110
10810,104,0.173001339164903,id7c20ee7a,left_wrist,1.29445600509644,-1,3,10809,108
10804,107,0.134542351337941,id7c20ee7a,left_hip,1.27044200897217,5,6,10809,108
10807,108,0.550103903744942,id7c20ee7a,left_ankle,1.2545759677887,2,2,10809,108
10806,109,0.632203719792386,id7c20ee7a,right_ankle,1.25089883804321,3,2,10809,108
17408,98,0.143257622293101,id7c20ee7a,left_wrist,1.29445600509644,-6,3,17402,107
17396,113,0.177136228243673,id7c20ee7a,left_hip,1.27044200897217,6,0,17402,107
17403,107,0.637755247255389,id7c20ee7a,left_ankle,1.2545759677887,-1,-1,17402,107
17400,106,0.568896614923143,id7c20ee7a,right_ankle,1.25089883804321,2,3,17402,107
687,79,0.16054010256119,id00b70b13,left_wrist,1.03737378120422,6,25,693,98
696,98,0.271335584995387,id00b70b13,left_hip,1.02795791625977,-3,-3,693,98
696,98,0.648405815718575,id00b70b13,left_ankle,1.04918193817139,-3,-3,693,98
694,99,0.602663145997478,id00b70b13,right_ankle,1.04110598564148,-1,-2,693,98
10243,101,0.202739583721737,id00b70b13,left_wrist,1.03737378120422,7,7,10250,101
10252,102,0.321774077433212,id00b70b13,left_hip,1.02795791625977,-2,-3,10250,101
10252,101,0.639396850677597,id00b70b13,left_ankle,1.04918193817139,-2,-2,10250,101
10253,100,0.623978611370934,id00b70b13,right_ankle,1.04110598564148,-3,-2,10250,101
17100,116,0.204903332851844,id00b70b13,left_wrist,1.03737378120422,8,-7,17108,101
17111,101,0.308634701695725,id00b70b13,left_hip,1.02795791625977,-3,-3,17108,101
17110,102,0.686901261171378,id00b70b13,left_ankle,1.04918193817139,-2,-3,17108,101
17111,101,0.685823371931364,id00b70b13,right_ankle,1.04110598564148,-3,-3,17108,101
7343,68,0.151710664426407,id00b70b13,left_wrist,1.03737378120422,-7,23,7336,98
7337,101,0.315188535542849,id00b70b13,left_hip,1.02795791625977,-1,-4,7336,98
7338,99,0.621769707959891,id00b70b13,left_ankle,1.04918193817139,-2,-3,7336,98
7336,102,0.682078551551472,id00b70b13,right_ankle,1.04110598564148,0,-4,7336,98
1135,102,0.0952244489909666,id00b70b13,left_wrist,1.03737378120422,-52,-56,1083,98
1085,99,0.277454894628853,id00b70b13,left_hip,1.02795791625977,-2,-3,1083,98
1086,98,0.634140425897408,id00b70b13,left_ankle,1.04918193817139,-3,-3,1083,98
1083,98,0.665544027539682,id00b70b13,right_ankle,1.04110598564148,0,0,1083,98
2760,135,0.129746182470615,id00b70b13,left_wrist,1.03737378120422,27,-4,2787,104
2789,103,0.303975823900519,id00b70b13,left_hip,1.02795791625977,-2,-1,2787,104
2788,104,0.679976961980899,id00b70b13,left_ankle,1.04918193817139,-1,-1,2787,104
2790,103,0.578454982753736,id00b70b13,right_ankle,1.04110598564148,-3,-2,2787,104
6402,102,0.114780934462029,id00b70b13,left_wrist,1.03737378120422,26,26,6428,102
6431,103,0.289354457531159,id00b70b13,left_hip,1.02795791625977,-3,-4,6428,102
6433,100,0.702794223233478,id00b70b13,left_ankle,1.04918193817139,-5,-3,6428,102
6431,103,0.671513468619584,id00b70b13,right_ankle,1.04110598564148,-3,-4,6428,102
3113,53,0.0795687731106669,id00b70b13,left_wrist,1.03737378120422,-20,28,3093,101
3094,101,0.275467232840178,id00b70b13,left_hip,1.02795791625977,-1,-1,3093,101
3095,101,0.764307487914807,id00b70b13,left_ankle,1.04918193817139,-2,-2,3093,101
3094,100,0.546274518909067,id00b70b13,right_ankle,1.04110598564148,-1,0,3093,101
2654,107,0.235645864751568,id00b70b13,left_wrist,1.03737378120422,29,28,2683,106
2685,105,0.270916143632003,id00b70b13,left_hip,1.02795791625977,-2,-1,2683,106
2685,104,0.583631492053751,id00b70b13,left_ankle,1.04918193817139,-2,0,2683,106
2687,104,0.691136687983708,id00b70b13,right_ankle,1.04110598564148,-4,-2,2683,106
4406,62,0.0840381062839999,id00b70b13,left_wrist,1.03737378120422,-11,29,4395,102
4398,102,0.254215023156347,id00b70b13,left_hip,1.02795791625977,-3,-3,4395,102
4398,101,0.667941554477138,id00b70b13,left_ankle,1.04918193817139,-3,-2,4395,102
4398,101,0.715292028735037,id00b70b13,right_ankle,1.04110598564148,-3,-2,4395,102
4600,78,0.148882482801567,id00b70b13,left_wrist,1.03737378120422,-5,21,4595,104
4598,102,0.265448694853905,id00b70b13,left_hip,1.02795791625977,-3,-1,4595,104
4597,103,0.712789771580115,id00b70b13,left_ankle,1.04918193817139,-2,-1,4595,104
4598,103,0.663193319573901,id00b70b13,right_ankle,1.04110598564148,-3,-2,4595,104
2654,107,0.235645864751568,id00b70b13,left_wrist,1.03737378120422,29,27,2683,105
2685,105,0.270916143632003,id00b70b13,left_hip,1.02795791625977,-2,-2,2683,105
2685,104,0.583631492053751,id00b70b13,left_ankle,1.04918193817139,-2,-1,2683,105
2687,104,0.691136687983708,id00b70b13,right_ankle,1.04110598564148,-4,-3,2683,105
19097,99,0.179599958277426,id00b70b13,left_wrist,1.03737378120422,-5,-5,19092,99
19096,99,0.28126976582134,id00b70b13,left_hip,1.02795791625977,-4,-4,19092,99
19096,98,0.753095881042107,id00b70b13,left_ankle,1.04918193817139,-4,-3,19092,99
19094,100,0.708485105251767,id00b70b13,right_ankle,1.04110598564148,-2,-3,19092,99
6523,83,0.0968368671949784,id00b70b13,left_wrist,1.03737378120422,6,24,6529,101
6533,101,0.272066746057899,id00b70b13,left_hip,1.02795791625977,-4,-4,6529,101
6532,102,0.690855397267589,id00b70b13,left_ankle,1.04918193817139,-3,-4,6529,101
6533,101,0.67334270387499,id00b70b13,right_ankle,1.04110598564148,-4,-4,6529,101
9920,123,0.163414783616025,id00b70b13,left_wrist,1.03737378120422,25,5,9945,103
9948,103,0.31284478126481,id00b70b13,left_hip,1.02795791625977,-3,-3,9945,103
9948,103,0.774183997267162,id00b70b13,left_ankle,1.04918193817139,-3,-3,9945,103
9949,102,0.644571320255794,id00b70b13,right_ankle,1.04110598564148,-4,-3,9945,103
13206,114,0.250352413812108,id00b70b13,left_wrist,1.03737378120422,7,-8,13213,99
13217,100,0.286643252115756,id00b70b13,left_hip,1.02795791625977,-4,-5,13213,99
13216,100,0.761236403600306,id00b70b13,left_ankle,1.04918193817139,-3,-4,13213,99
13215,99,0.619663773846896,id00b70b13,right_ankle,1.04110598564148,-2,-2,13213,99
1952,92,0.135002079810602,id00b70b13,left_wrist,1.03737378120422,28,36,1980,100
1980,101,0.290815699547891,id00b70b13,left_hip,1.02795791625977,0,-1,1980,100
1981,101,0.620947166004476,id00b70b13,left_ankle,1.04918193817139,-1,-2,1980,100
1978,104,0.679780081675779,id00b70b13,right_ankle,1.04110598564148,2,-2,1980,100
2552,103,0.162440948460479,id00b70b13,left_wrist,1.03737378120422,31,29,2583,101
2585,101,0.286404995461016,id00b70b13,left_hip,1.02795791625977,-2,-2,2583,101
2584,102,0.652392301479503,id00b70b13,left_ankle,1.04918193817139,-1,-2,2583,101
2585,103,0.685543822827159,id00b70b13,right_ankle,1.04110598564148,-2,-4,2583,101
1135,102,0.0952244489909666,id00b70b13,left_wrist,1.03737378120422,-52,-56,1083,98
1085,99,0.277454894628853,id00b70b13,left_hip,1.02795791625977,-2,-3,1083,98
1086,98,0.634140425897408,id00b70b13,left_ankle,1.04918193817139,-3,-3,1083,98
1083,98,0.665544027539682,id00b70b13,right_ankle,1.04110598564148,0,0,1083,98
17969,93,0.36824514438664,id00b70b13,left_wrist,1.03737378120422,38,44,18007,99
18012,98,0.309544973400872,id00b70b13,left_hip,1.02795791625977,-5,-4,18007,99
18010,100,0.774901875643471,id00b70b13,left_ankle,1.04918193817139,-3,-4,18007,99
18009,101,0.695022067743262,id00b70b13,right_ankle,1.04110598564148,-2,-4,18007,99
14657,105,0.127690813069048,id1165e00c,left_wrist,1.21697783470154,-2,-3,14655,104
14655,104,0.256869691300571,id1165e00c,left_hip,1.3618049621582,0,0,14655,104
14654,106,0.692186375949298,id1165e00c,left_ankle,1.19694209098816,1,-1,14655,104
14653,106,0.754548291654107,id1165e00c,right_ankle,1.19375991821289,2,0,14655,104
2133,112,0.16641176112267,id1165e00c,left_wrist,1.21697783470154,1,-2,2134,109
2131,109,0.27528523299289,id1165e00c,left_hip,1.3618049621582,3,3,2134,109
2132,109,0.646859389834364,id1165e00c,left_ankle,1.19694209098816,2,2,2134,109
2132,109,0.668192882134736,id1165e00c,right_ankle,1.19375991821289,2,2,2134,109
10810,106,0.0593261264593222,id1165e00c,left_wrist,1.21697783470154,0,2,10810,108
10808,110,0.224985554461302,id1165e00c,left_hip,1.3618049621582,2,0,10810,108
10810,109,0.586180668939936,id1165e00c,left_ankle,1.19694209098816,0,-1,10810,108
10809,111,0.705980694084043,id1165e00c,right_ankle,1.19375991821289,1,-2,10810,108
10065,109,0.0804767540327921,id1165e00c,left_wrist,1.21697783470154,2,-1,10067,106
10062,110,0.219914566833333,id1165e00c,left_hip,1.3618049621582,5,1,10067,106
10064,109,0.584325330277082,id1165e00c,left_ankle,1.19694209098816,3,0,10067,106
10064,107,0.69080337476777,id1165e00c,right_ankle,1.19375991821289,3,2,10067,106
8254,105,0.0887057962571479,id1165e00c,left_wrist,1.21697783470154,0,3,8254,108
8253,108,0.231241459389248,id1165e00c,left_hip,1.3618049621582,1,1,8254,108
8255,107,0.635131110305732,id1165e00c,left_ankle,1.19694209098816,-1,0,8254,108
8253,107,0.685043358641334,id1165e00c,right_ankle,1.19375991821289,1,2,8254,108
21528,105,0.114602300029822,id1165e00c,left_wrist,1.21697783470154,0,2,21528,107
21526,108,0.251588325301197,id1165e00c,left_hip,1.3618049621582,2,1,21528,107
21528,108,0.677831777753496,id1165e00c,left_ankle,1.19694209098816,0,-1,21528,107
21527,108,0.723983298317586,id1165e00c,right_ankle,1.19375991821289,1,0,21528,107
3990,110,0.124930374739549,id1165e00c,left_wrist,1.21697783470154,-2,-2,3988,110
3985,114,0.238653520385489,id1165e00c,left_hip,1.3618049621582,3,-1,3988,110
3985,112,0.555607853422747,id1165e00c,left_ankle,1.19694209098816,3,1,3988,110
3985,112,0.602062911066632,id1165e00c,right_ankle,1.19375991821289,3,1,3988,110
17685,107,0.152736607080105,id1165e00c,left_wrist,1.21697783470154,-3,-4,17682,106
17683,104,0.249684710011805,id1165e00c,left_hip,1.3618049621582,-1,1,17682,106
17682,106,0.592671039354327,id1165e00c,left_ankle,1.19694209098816,0,0,17682,106
17680,106,0.726871246152293,id1165e00c,right_ankle,1.19375991821289,2,2,17682,106
1543,107,0.118975205563927,id1165e00c,left_wrist,1.21697783470154,51,52,1594,108
1592,108,0.242603637464934,id1165e00c,left_hip,1.3618049621582,2,2,1594,108
1593,108,0.635011572351396,id1165e00c,left_ankle,1.19694209098816,1,1,1594,108
1592,108,0.625087963390463,id1165e00c,right_ankle,1.19375991821289,2,2,1594,108
8772,106,0.0799579310219478,id1165e00c,left_wrist,1.21697783470154,6,6,8778,106
8779,104,0.238016702660195,id1165e00c,left_hip,1.3618049621582,-1,1,8778,106
8779,104,0.589950759966034,id1165e00c,left_ankle,1.19694209098816,-1,1,8778,106
8776,105,0.71598884491294,id1165e00c,right_ankle,1.19375991821289,2,3,8778,106
3116,107,0.15608096633207,id1165e00c,left_wrist,1.21697783470154,1,1,3117,107
3116,107,0.240918957642311,id1165e00c,left_hip,1.3618049621582,1,1,3117,107
3114,108,0.592880763810041,id1165e00c,left_ankle,1.19694209098816,3,2,3117,107
3114,108,0.634020135382082,id1165e00c,right_ankle,1.19375991821289,3,2,3117,107
4441,108,0.114972242169751,id1165e00c,left_wrist,1.21697783470154,-10,-3,4431,115
4432,114,0.225816125369369,id1165e00c,left_hip,1.3618049621582,-1,0,4431,115
4429,112,0.547050951930644,id1165e00c,left_ankle,1.19694209098816,2,5,4431,115
4433,112,0.543297156283394,id1165e00c,right_ankle,1.19375991821289,-2,1,4431,115
18318,101,0.193962336995742,id1165e00c,left_wrist,1.21697783470154,-11,-4,18307,108
18310,105,0.236083227247018,id1165e00c,left_hip,1.3618049621582,-3,0,18307,108
18308,108,0.616718072276932,id1165e00c,left_ankle,1.19694209098816,-1,-1,18307,108
18307,107,0.745730580197568,id1165e00c,right_ankle,1.19375991821289,0,1,18307,108
15713,107,0.148201620434625,id1165e00c,left_wrist,1.21697783470154,-10,-8,15703,109
15705,108,0.250702732995937,id1165e00c,left_hip,1.3618049621582,-2,-1,15703,109
15705,106,0.615362832390042,id1165e00c,left_ankle,1.19694209098816,-2,1,15703,109
15704,106,0.730655003404847,id1165e00c,right_ankle,1.19375991821289,-1,2,15703,109
5867,112,0.0954985407557554,id1165e00c,left_wrist,1.21697783470154,0,-3,5867,109
5866,108,0.234546677360017,id1165e00c,left_hip,1.3618049621582,1,2,5867,109
5864,111,0.566253792567728,id1165e00c,left_ankle,1.19694209098816,3,1,5867,109
5864,110,0.622811397495753,id1165e00c,right_ankle,1.19375991821289,3,2,5867,109
10810,106,0.0593261264593222,id1165e00c,left_wrist,1.21697783470154,0,2,10810,108
10808,110,0.224985554461302,id1165e00c,left_hip,1.3618049621582,2,0,10810,108
10810,109,0.586180668939936,id1165e00c,left_ankle,1.19694209098816,0,-1,10810,108
10809,111,0.705980694084043,id1165e00c,right_ankle,1.19375991821289,1,-2,10810,108
1917,112,0.204809749346768,id1165e00c,left_wrist,1.21697783470154,1,-2,1918,109
1917,106,0.263727214790604,id1165e00c,left_hip,1.3618049621582,1,4,1918,109
1915,110,0.622503686107443,id1165e00c,left_ankle,1.19694209098816,3,2,1918,109
1918,109,0.714362623122773,id1165e00c,right_ankle,1.19375991821289,0,0,1918,109
7728,103,0.11496717301539,id1165e00c,left_wrist,1.21697783470154,-6,-1,7722,108
7721,110,0.241096357189059,id1165e00c,left_hip,1.3618049621582,1,-1,7722,108
7722,108,0.649387672114714,id1165e00c,left_ankle,1.19694209098816,0,0,7722,108
7721,110,0.691145025545365,id1165e00c,right_ankle,1.19375991821289,1,-1,7722,108
21113,104,0.124270617646219,id1165e00c,left_wrist,1.21697783470154,-6,-4,21107,106
21109,104,0.249081885175116,id1165e00c,left_hip,1.3618049621582,-2,0,21107,106
21109,105,0.72646929723322,id1165e00c,left_ankle,1.19694209098816,-2,-1,21107,106
21106,106,0.777309740777488,id1165e00c,right_ankle,1.19375991821289,1,1,21107,106
13607,105,0.104587659698614,id1165e00c,left_wrist,1.21697783470154,4,2,13611,103
13610,106,0.267494114655816,id1165e00c,left_hip,1.3618049621582,1,-2,13611,103
13611,105,0.686603788102239,id1165e00c,left_ankle,1.19694209098816,0,-2,13611,103
13609,105,0.659488888328209,id1165e00c,right_ankle,1.19375991821289,2,0,13611,103
14015,103,0.180280917640628,id5308a7d6,left_wrist,1.20290207862854,-2,-4,14013,101
14012,103,0.288807215325447,id5308a7d6,left_hip,1.19578981399536,1,-1,14013,101
14011,103,0.715313270986013,id5308a7d6,left_ankle,1.32012510299683,2,0,14013,101
14012,101,0.744367776444135,id5308a7d6,right_ankle,1.16943407058716,1,1,14013,101
6642,108,0.164824536532475,id5308a7d6,left_wrist,1.20290207862854,-4,-4,6638,108
6638,107,0.231254034740996,id5308a7d6,left_hip,1.19578981399536,0,1,6638,108
6637,108,0.655178746131382,id5308a7d6,left_ankle,1.32012510299683,1,1,6638,108
6636,105,0.638557963392754,id5308a7d6,right_ankle,1.16943407058716,2,5,6638,108
8568,100,0.22617892094651,id5308a7d6,left_wrist,1.20290207862854,-2,-2,8566,100
8565,100,0.308507765596336,id5308a7d6,left_hip,1.19578981399536,1,1,8566,100
8564,101,0.66755362560126,id5308a7d6,left_ankle,1.32012510299683,2,1,8566,100
8564,100,0.639443287225646,id5308a7d6,right_ankle,1.16943407058716,2,2,8566,100
20869,103,0.149836886115297,id5308a7d6,left_wrist,1.20290207862854,-4,-4,20865,103
20866,101,0.260990773891307,id5308a7d6,left_hip,1.19578981399536,-1,1,20865,103
20864,102,0.785413180689041,id5308a7d6,left_ankle,1.32012510299683,1,2,20865,103
20864,102,0.659064584724981,id5308a7d6,right_ankle,1.16943407058716,1,2,20865,103
17981,101,0.243531738971932,id5308a7d6,left_wrist,1.20290207862854,-4,-4,17977,101
17977,102,0.298600608533085,id5308a7d6,left_hip,1.19578981399536,0,-1,17977,101
17976,101,0.727804098171226,id5308a7d6,left_ankle,1.32012510299683,1,1,17977,101
17977,100,0.749878554081322,id5308a7d6,right_ankle,1.16943407058716,0,1,17977,101
20076,99,0.209140232199059,id5308a7d6,left_wrist,1.20290207862854,-4,-4,20072,99
20072,100,0.301890675365878,id5308a7d6,left_hip,1.19578981399536,0,-1,20072,99
20071,98,0.79546957121306,id5308a7d6,left_ankle,1.32012510299683,1,2,20072,99
20070,102,0.675856098068183,id5308a7d6,right_ankle,1.16943407058716,2,-1,20072,99
17073,102,0.248656653327653,id5308a7d6,left_wrist,1.20290207862854,-3,-2,17070,103
17070,103,0.278679941426398,id5308a7d6,left_hip,1.19578981399536,0,0,17070,103
17069,102,0.740087386421875,id5308a7d6,left_ankle,1.32012510299683,1,2,17070,103
17067,104,0.69120455447886,id5308a7d6,right_ankle,1.16943407058716,3,2,17070,103
16553,105,0.226150221653208,id5308a7d6,left_wrist,1.20290207862854,-6,-5,16547,106
16549,105,0.236378296856828,id5308a7d6,left_hip,1.19578981399536,-2,-1,16547,106
16548,105,0.769605296874275,id5308a7d6,left_ankle,1.32012510299683,-1,0,16547,106
16545,106,0.76365109900277,id5308a7d6,right_ankle,1.16943407058716,2,2,16547,106
5670,101,0.221154760321522,id5308a7d6,left_wrist,1.20290207862854,50,52,5720,103
5770,104,0.162283594634089,id5308a7d6,left_wrist,1.20290207862854,-50,-51,5720,103
5718,103,0.281332459258689,id5308a7d6,left_hip,1.19578981399536,2,2,5720,103
5717,103,0.741918034823787,id5308a7d6,left_ankle,1.32012510299683,3,3,5720,103
5718,100,0.658876396382655,id5308a7d6,right_ankle,1.16943407058716,2,5,5720,103
16046,103,0.241523852075047,id5308a7d6,left_wrist,1.20290207862854,-5,-4,16041,104
16041,104,0.26200783660981,id5308a7d6,left_hip,1.19578981399536,0,0,16041,104
16040,104,0.778366485136727,id5308a7d6,left_ankle,1.32012510299683,1,1,16041,104
16039,104,0.709554100171193,id5308a7d6,right_ankle,1.16943407058716,2,2,16041,104
20670,100,0.210690767357629,id5308a7d6,left_wrist,1.20290207862854,-5,-3,20665,102
20666,101,0.303689598911299,id5308a7d6,left_hip,1.19578981399536,-1,0,20665,102
20665,101,0.808899855334126,id5308a7d6,left_ankle,1.32012510299683,0,1,20665,102
20665,101,0.764504097331717,id5308a7d6,right_ankle,1.16943407058716,0,1,20665,102
6181,101,0.24231832746437,id5308a7d6,left_wrist,1.20290207862854,48,51,6229,104
6229,102,0.288262656060336,id5308a7d6,left_hip,1.19578981399536,0,2,6229,104
6227,102,0.593757178865819,id5308a7d6,left_ankle,1.32012510299683,2,4,6229,104
6225,105,0.63183836999667,id5308a7d6,right_ankle,1.16943407058716,4,3,6229,104
8517,52,0.071851933851005,id5308a7d6,left_wrist,1.20290207862854,-49,-2,8468,99
8466,100,0.291646020202422,id5308a7d6,left_hip,1.19578981399536,2,1,8468,99
8465,100,0.828756220858295,id5308a7d6,left_ankle,1.32012510299683,3,2,8468,99
8466,99,0.71219862765702,id5308a7d6,right_ankle,1.16943407058716,2,2,8468,99
17073,102,0.248656653327653,id5308a7d6,left_wrist,1.20290207862854,-3,-2,17070,103
17070,103,0.278679941426398,id5308a7d6,left_hip,1.19578981399536,0,0,17070,103
17069,102,0.740087386421875,id5308a7d6,left_ankle,1.32012510299683,1,2,17070,103
17067,104,0.69120455447886,id5308a7d6,right_ankle,1.16943407058716,3,2,17070,103
1696,52,0.096517963710919,id5308a7d6,left_wrist,1.20290207862854,0,49,1696,101
1694,102,0.279187900232654,id5308a7d6,left_hip,1.19578981399536,2,1,1696,101
1693,103,0.696406883377802,id5308a7d6,left_ankle,1.32012510299683,3,1,1696,101
1693,102,0.726674754529299,id5308a7d6,right_ankle,1.16943407058716,3,2,1696,101
7669,101,0.226971340522151,id5308a7d6,left_wrist,1.20290207862854,-4,-2,7665,103
7666,101,0.28156885828023,id5308a7d6,left_hip,1.19578981399536,-1,1,7665,103
7664,102,0.768928574795315,id5308a7d6,left_ankle,1.32012510299683,1,2,7665,103
7664,102,0.713086365145654,id5308a7d6,right_ankle,1.16943407058716,1,2,7665,103
9382,105,0.204278817767966,id5308a7d6,left_wrist,1.20290207862854,-2,-3,9380,104
9380,103,0.267630203533585,id5308a7d6,left_hip,1.19578981399536,0,1,9380,104
9379,102,0.72227921308309,id5308a7d6,left_ankle,1.32012510299683,1,3,9380,104
9375,106,0.572823431174363,id5308a7d6,right_ankle,1.16943407058716,5,3,9380,104
3398,101,0.234154170713539,id5308a7d6,left_wrist,1.20290207862854,-1,-2,3397,100
3395,100,0.285497171056756,id5308a7d6,left_hip,1.19578981399536,2,2,3397,100
3394,100,0.734343403547356,id5308a7d6,left_ankle,1.32012510299683,3,3,3397,100
3394,102,0.714887795136981,id5308a7d6,right_ankle,1.16943407058716,3,1,3397,100
12270,104,0.19077170487981,id5308a7d6,left_wrist,1.20290207862854,-3,-5,12267,102
12267,103,0.25358170465721,id5308a7d6,left_hip,1.19578981399536,0,-1,12267,102
12266,103,0.703218404704594,id5308a7d6,left_ankle,1.32012510299683,1,0,12267,102
12265,102,0.741973836903002,id5308a7d6,right_ankle,1.16943407058716,2,2,12267,102
20468,101,0.220995293160624,id5308a7d6,left_wrist,1.20290207862854,-3,-2,20465,102
20465,102,0.275327978345527,id5308a7d6,left_hip,1.19578981399536,0,0,20465,102
20463,102,0.778941737425097,id5308a7d6,left_ankle,1.32012510299683,2,2,20465,102
20465,100,0.701983031188144,id5308a7d6,right_ankle,1.16943407058716,0,2,20465,102
17624,110,0.303388633179158,ida61e8ddf,left_wrist,0.876250028610229,-1,-3,17623,108
17622,109,0.348510315925656,ida61e8ddf,left_hip,0.857606887817383,1,0,17623,108
17622,108,0.847831250054666,ida61e8ddf,left_ankle,0.882250785827637,1,1,17623,108
17622,110,0.850237676998197,ida61e8ddf,right_ankle,0.986890077590942,1,-1,17623,108
3207,113,0.25288699111576,ida61e8ddf,left_wrist,0.876250028610229,0,1,3207,114
3205,114,0.299350498657115,ida61e8ddf,left_hip,0.857606887817383,2,2,3207,114
3205,114,0.921655921441197,ida61e8ddf,left_ankle,0.882250785827637,2,2,3207,114
3208,110,0.716078676347153,ida61e8ddf,right_ankle,0.986890077590942,-1,3,3207,114
9745,104,0.370954997344848,ida61e8ddf,left_wrist,0.876250028610229,-1,0,9744,105
9742,105,0.397548076674218,ida61e8ddf,left_hip,0.857606887817383,2,2,9744,105
9741,106,0.884284714134555,ida61e8ddf,left_ankle,0.882250785827637,3,2,9744,105
9740,106,0.913060939697791,ida61e8ddf,right_ankle,0.986890077590942,4,3,9744,105
6841,109,0.266051787729732,ida61e8ddf,left_wrist,0.876250028610229,-2,-2,6839,109
6840,108,0.318277507139537,ida61e8ddf,left_hip,0.857606887817383,-1,0,6839,109
6842,109,0.994494281766032,ida61e8ddf,left_ankle,0.882250785827637,-3,-3,6839,109
6839,109,0.858737584633817,ida61e8ddf,right_ankle,0.986890077590942,0,0,6839,109
12098,110,0.316730584297536,ida61e8ddf,left_wrist,0.876250028610229,0,-1,12098,109
12096,111,0.350087627843295,ida61e8ddf,left_hip,0.857606887817383,2,0,12098,109
12095,111,0.993387310932141,ida61e8ddf,left_ankle,0.882250785827637,3,1,12098,109
12096,111,0.821058994503067,ida61e8ddf,right_ankle,0.986890077590942,2,0,12098,109
4877,107,0.261885322505217,ida61e8ddf,left_wrist,0.876250028610229,1,4,4878,110
4875,111,0.330093665228224,ida61e8ddf,left_hip,0.857606887817383,3,2,4878,110
4877,109,0.94572666064852,ida61e8ddf,left_ankle,0.882250785827637,1,2,4878,110
4875,111,0.768760493319593,ida61e8ddf,right_ankle,0.986890077590942,3,2,4878,110
8472,98,0.113073026578627,ida61e8ddf,left_wrist,0.876250028610229,-9,0,8463,107
8464,103,0.316806500546565,ida61e8ddf,left_hip,0.857606887817383,-1,3,8463,107
8462,106,0.691193107004951,ida61e8ddf,left_ankle,0.882250785827637,1,2,8463,107
8464,103,0.659916547109908,ida61e8ddf,right_ankle,0.986890077590942,-1,3,8463,107
3207,113,0.25288699111576,ida61e8ddf,left_wrist,0.876250028610229,0,1,3207,114
3205,114,0.299350498657115,ida61e8ddf,left_hip,0.857606887817383,2,2,3207,114
3205,114,0.921655921441197,ida61e8ddf,left_ankle,0.882250785827637,2,2,3207,114
3208,110,0.716078676347153,ida61e8ddf,right_ankle,0.986890077590942,-1,3,3207,114
6625,110,0.299799760883876,ida61e8ddf,left_wrist,0.876250028610229,-2,-1,6623,111
6622,110,0.339239850468467,ida61e8ddf,left_hip,0.857606887817383,1,2,6623,111
6622,110,0.987170732271374,ida61e8ddf,left_ankle,0.882250785827637,1,2,6623,111
6622,109,0.814797174151056,ida61e8ddf,right_ankle,0.986890077590942,1,3,6623,111
12975,109,0.247766933186108,ida61e8ddf,left_wrist,0.876250028610229,-2,-1,12973,110
12971,110,0.325013653402554,ida61e8ddf,left_hip,0.857606887817383,2,2,12973,110
12972,108,0.842528744187226,ida61e8ddf,left_ankle,0.882250785827637,1,3,12973,110
12971,109,0.892948297400555,ida61e8ddf,right_ankle,0.986890077590942,2,3,12973,110
8676,107,0.309475786273423,ida61e8ddf,left_wrist,0.876250028610229,0,-1,8676,106
8673,108,0.346060948538646,ida61e8ddf,left_hip,0.857606887817383,3,1,8676,106
8673,108,0.921537352152987,ida61e8ddf,left_ankle,0.882250785827637,3,1,8676,106
8672,108,0.871911855210983,ida61e8ddf,right_ankle,0.986890077590942,4,2,8676,106
1204,109,0.314238671003541,ida61e8ddf,left_wrist,0.876250028610229,1,1,1205,109
1203,109,0.295627725825075,ida61e8ddf,left_hip,0.857606887817383,2,2,1205,109
1203,109,0.982890986596801,ida61e8ddf,left_ankle,0.882250785827637,2,2,1205,109
1203,108,0.779932043336076,ida61e8ddf,right_ankle,0.986890077590942,2,3,1205,109
14042,110,0.313838789792789,ida61e8ddf,left_wrist,0.876250028610229,0,-3,14042,107
14040,107,0.392995471026724,ida61e8ddf,left_hip,0.857606887817383,2,2,14042,107
14043,104,0.819896348992413,ida61e8ddf,left_ankle,0.882250785827637,-1,2,14042,107
14038,111,0.797970321727465,ida61e8ddf,right_ankle,0.986890077590942,4,0,14042,107
7587,107,0.303917463172257,ida61e8ddf,left_wrist,0.876250028610229,1,2,7588,108
7587,106,0.359158239005199,ida61e8ddf,left_hip,0.857606887817383,1,3,7588,108
7586,106,0.841577031180714,ida61e8ddf,left_ankle,0.882250785827637,2,4,7588,108
7585,108,0.851809877026015,ida61e8ddf,right_ankle,0.986890077590942,3,3,7588,108
17517,108,0.337350619721231,ida61e8ddf,left_wrist,0.876250028610229,-1,-1,17516,108
17515,108,0.383705815297488,ida61e8ddf,left_hip,0.857606887817383,1,1,17516,108
17515,108,0.953915337402598,ida61e8ddf,left_ankle,0.882250785827637,1,1,17516,108
17515,108,0.846068221890568,ida61e8ddf,right_ankle,0.986890077590942,1,1,17516,108
5202,110,0.217521738499723,ida61e8ddf,left_wrist,0.876250028610229,0,0,5202,110
5201,110,0.294754104044111,ida61e8ddf,left_hip,0.857606887817383,1,1,5202,110
5201,109,0.905784731920065,ida61e8ddf,left_ankle,0.882250785827637,1,2,5202,110
5201,110,0.827413938092491,ida61e8ddf,right_ankle,0.986890077590942,1,1,5202,110
15225,108,0.360286974019295,ida61e8ddf,left_wrist,0.876250028610229,-3,-3,15222,108
15220,110,0.343851674310432,ida61e8ddf,left_hip,0.857606887817383,2,0,15222,108
15220,109,0.932300686616338,ida61e8ddf,left_ankle,0.882250785827637,2,1,15222,108
15219,111,0.843560958834992,ida61e8ddf,right_ankle,0.986890077590942,3,0,15222,108
1637,111,0.288881563950888,ida61e8ddf,left_wrist,0.876250028610229,1,1,1638,111
1637,111,0.298636093423224,ida61e8ddf,left_hip,0.857606887817383,1,1,1638,111
1637,110,0.916393478194222,ida61e8ddf,left_ankle,0.882250785827637,1,2,1638,111
1637,111,0.725462292692054,ida61e8ddf,right_ankle,0.986890077590942,1,1,1638,111
15770,108,0.340535289947106,ida61e8ddf,left_wrist,0.876250028610229,-3,-3,15767,108
15765,109,0.389267248311593,ida61e8ddf,left_hip,0.857606887817383,2,1,15767,108
15766,108,0.888934627696102,ida61e8ddf,left_ankle,0.882250785827637,1,1,15767,108
15764,110,0.871331860537235,ida61e8ddf,right_ankle,0.986890077590942,3,1,15767,108
8569,108,0.266242859042509,ida61e8ddf,left_wrist,0.876250028610229,0,0,8569,108
8566,108,0.364279068081392,ida61e8ddf,left_hip,0.857606887817383,3,3,8569,108
8567,107,0.941682822043147,ida61e8ddf,left_ankle,0.882250785827637,2,3,8569,108
8566,107,0.863163674568658,ida61e8ddf,right_ankle,0.986890077590942,3,4,8569,108
1983,102,0.229096906597193,id9603e9c3,left_wrist,0.888286113739014,-2,-3,1981,101
1983,101,0.341282569852101,id9603e9c3,left_hip,0.914419889450073,-2,-2,1981,101
1981,102,0.833731451131568,id9603e9c3,left_ankle,0.909389972686768,0,-1,1981,101
1981,101,0.769086802697474,id9603e9c3,right_ankle,0.903512954711914,0,0,1981,101
5942,102,0.303060997114961,id9603e9c3,left_wrist,0.888286113739014,-1,-2,5941,101
5943,100,0.384587859998707,id9603e9c3,left_hip,0.914419889450073,-2,-1,5941,101
5942,100,0.780242939744716,id9603e9c3,left_ankle,0.909389972686768,-1,0,5941,101
5940,102,0.809934269847569,id9603e9c3,right_ankle,0.903512954711914,1,0,5941,101
14785,97,0.3828383657077,id9603e9c3,left_wrist,0.888286113739014,-4,-3,14781,98
14784,97,0.452730444582044,id9603e9c3,left_hip,0.914419889450073,-3,-2,14781,98
14783,97,0.887628173481876,id9603e9c3,left_ankle,0.909389972686768,-2,-1,14781,98
14780,98,0.844821307793476,id9603e9c3,right_ankle,0.903512954711914,1,1,14781,98
4942,102,0.231442022767172,id9603e9c3,left_wrist,0.888286113739014,-1,-1,4941,102
4942,101,0.33165220306253,id9603e9c3,left_hip,0.914419889450073,-1,0,4941,102
4940,102,0.839618516438146,id9603e9c3,left_ankle,0.909389972686768,1,1,4941,102
4940,99,0.643530659132102,id9603e9c3,right_ankle,0.903512954711914,1,4,4941,102
10349,100,0.314263841121291,id9603e9c3,left_wrist,0.888286113739014,-2,-1,10347,101
10349,100,0.373991169103427,id9603e9c3,left_hip,0.914419889450073,-2,-1,10347,101
10348,100,0.761857515084658,id9603e9c3,left_ankle,0.909389972686768,-1,0,10347,101
10346,102,0.783087325677214,id9603e9c3,right_ankle,0.903512954711914,1,0,10347,101
14785,97,0.3828383657077,id9603e9c3,left_wrist,0.888286113739014,-4,-3,14781,98
14784,97,0.452730444582044,id9603e9c3,left_hip,0.914419889450073,-3,-2,14781,98
14783,97,0.887628173481876,id9603e9c3,left_ankle,0.909389972686768,-2,-1,14781,98
14780,98,0.844821307793476,id9603e9c3,right_ankle,0.903512954711914,1,1,14781,98
1299,98,0.198480056960393,id9603e9c3,left_wrist,0.888286113739014,-3,-1,1296,100
1296,101,0.346512205911334,id9603e9c3,left_hip,0.914419889450073,0,-1,1296,100
1296,99,0.757425220309088,id9603e9c3,left_ankle,0.909389972686768,0,1,1296,100
1295,97,0.721341788123729,id9603e9c3,right_ankle,0.903512954711914,1,4,1296,100
12443,102,0.290387943468366,id9603e9c3,left_wrist,0.888286113739014,-2,-4,12441,100
12443,101,0.422675067699727,id9603e9c3,left_hip,0.914419889450073,-2,-3,12441,100
12442,100,0.85562804040389,id9603e9c3,left_ankle,0.909389972686768,-1,-1,12441,100
12441,101,0.761373475956924,id9603e9c3,right_ankle,0.903512954711914,0,-1,12441,100
12343,101,0.34538105339959,id9603e9c3,left_wrist,0.888286113739014,-1,-2,12342,100
12344,100,0.42502631890956,id9603e9c3,left_hip,0.914419889450073,-2,-2,12342,100
12342,101,0.795245384328982,id9603e9c3,left_ankle,0.909389972686768,0,-1,12342,100
12341,101,0.812549167030278,id9603e9c3,right_ankle,0.903512954711914,1,0,12342,100
8149,101,0.28996243616251,id9603e9c3,left_wrist,0.888286113739014,-2,-1,8147,102
8148,102,0.347733606815266,id9603e9c3,left_hip,0.914419889450073,-1,-1,8147,102
8147,102,0.782863892774254,id9603e9c3,left_ankle,0.909389972686768,0,0,8147,102
8148,101,0.751411252378847,id9603e9c3,right_ankle,0.903512954711914,-1,0,8147,102
7740,103,0.266655821108609,id9603e9c3,left_wrist,0.888286113739014,-2,-2,7738,103
7740,103,0.328603010242059,id9603e9c3,left_hip,0.914419889450073,-2,-2,7738,103
7738,103,0.704569209885231,id9603e9c3,left_ankle,0.909389972686768,0,0,7738,103
7738,102,0.652746363013515,id9603e9c3,right_ankle,0.903512954711914,0,1,7738,103
9952,99,0.364576298482119,id9603e9c3,left_wrist,0.888286113739014,-4,-3,9948,100
9952,98,0.38351118586864,id9603e9c3,left_hip,0.914419889450073,-4,-2,9948,100
9949,101,0.762090441378483,id9603e9c3,left_ankle,0.909389972686768,-1,-2,9948,100
9949,99,0.70509231878085,id9603e9c3,right_ankle,0.903512954711914,-1,0,9948,100
16415,99,0.362635019779305,id9603e9c3,left_wrist,0.888286113739014,-3,-4,16412,98
16414,98,0.434861293819748,id9603e9c3,left_hip,0.914419889450073,-2,-2,16412,98
16414,97,0.838791273195233,id9603e9c3,left_ankle,0.909389972686768,-2,-1,16412,98
16411,97,0.815857203628527,id9603e9c3,right_ankle,0.903512954711914,1,2,16412,98
4155,100,0.254561920653018,id9603e9c3,left_wrist,0.888286113739014,-3,-1,4152,102
4154,100,0.375040512924964,id9603e9c3,left_hip,0.914419889450073,-2,0,4152,102
4153,101,0.748057310151889,id9603e9c3,left_ankle,0.909389972686768,-1,0,4152,102
4153,99,0.757660712879932,id9603e9c3,right_ankle,0.903512954711914,-1,2,4152,102
3956,102,0.276190752593577,id9603e9c3,left_wrist,0.888286113739014,-1,-2,3955,101
3955,102,0.344314369980246,id9603e9c3,left_hip,0.914419889450073,0,-1,3955,101
3954,101,0.828368275420495,id9603e9c3,left_ankle,0.909389972686768,1,1,3955,101
3954,100,0.795852558224312,id9603e9c3,right_ankle,0.903512954711914,1,2,3955,101
7541,99,0.277055103978932,id9603e9c3,left_wrist,0.888286113739014,-2,-2,7539,99
7541,97,0.359094760678675,id9603e9c3,left_hip,0.914419889450073,-2,0,7539,99
7539,100,0.80385906859364,id9603e9c3,left_ankle,0.909389972686768,0,-1,7539,99
7538,99,0.709411300580266,id9603e9c3,right_ankle,0.903512954711914,1,1,7539,99
5942,102,0.303060997114961,id9603e9c3,left_wrist,0.888286113739014,-1,-2,5941,101
5943,100,0.384587859998707,id9603e9c3,left_hip,0.914419889450073,-2,-1,5941,101
5942,100,0.780242939744716,id9603e9c3,left_ankle,0.909389972686768,-1,0,5941,101
5940,102,0.809934269847569,id9603e9c3,right_ankle,0.903512954711914,1,0,5941,101
15264,98,0.379279366851497,id9603e9c3,left_wrist,0.888286113739014,-3,-4,15261,97
15262,98,0.438715433855889,id9603e9c3,left_hip,0.914419889450073,-1,-2,15261,97
15261,97,0.875211789484481,id9603e9c3,left_ankle,0.909389972686768,0,0,15261,97
15259,97,0.785724206951238,id9603e9c3,right_ankle,0.903512954711914,2,2,15261,97
3165,100,0.255126963543049,id9603e9c3,left_wrist,0.888286113739014,-2,-1,3163,101
3164,101,0.336853389321294,id9603e9c3,left_hip,0.914419889450073,-1,-1,3163,101
3163,100,0.758869207506312,id9603e9c3,left_ankle,0.909389972686768,0,1,3163,101
3163,100,0.744886795433622,id9603e9c3,right_ankle,0.903512954711914,0,1,3163,101
8762,100,0.30689905092285,id9603e9c3,left_wrist,0.888286113739014,-5,-2,8757,103
8761,102,0.385163171541691,id9603e9c3,left_hip,0.914419889450073,-4,-3,8757,103
8759,101,0.77116405399646,id9603e9c3,left_ankle,0.909389972686768,-2,0,8757,103
8758,102,0.785592477804815,id9603e9c3,right_ankle,0.903512954711914,-1,0,8757,103
6698,86,0.177378624084575,idfc5f05e4,left_wrist,0.810760021209717,2,1,6700,85
6699,85,0.268623596856416,idfc5f05e4,left_hip,0.825093984603882,1,1,6700,85
6695,87,0.922494578760454,idfc5f05e4,left_ankle,0.826153993606567,5,3,6700,85
6697,84,0.830419909720715,idfc5f05e4,right_ankle,0.876377820968628,3,4,6700,85
8870,85,0.171686494207679,idfc5f05e4,left_wrist,0.810760021209717,0,0,8870,85
8870,86,0.311146388215439,idfc5f05e4,left_hip,0.825093984603882,0,-1,8870,85
8871,84,0.935298367713485,idfc5f05e4,left_ankle,0.826153993606567,-1,0,8870,85
8869,83,0.900375133454816,idfc5f05e4,right_ankle,0.876377820968628,1,3,8870,85
10210,84,0.182358954008261,idfc5f05e4,left_wrist,0.810760021209717,1,1,10211,84
10212,84,0.290987881857818,idfc5f05e4,left_hip,0.825093984603882,-1,-1,10211,84
10208,87,0.970689800021167,idfc5f05e4,left_ankle,0.826153993606567,3,0,10211,84
10209,80,0.826966332788632,idfc5f05e4,right_ankle,0.876377820968628,2,6,10211,84
15296,85,0.204058088834619,idfc5f05e4,left_wrist,0.810760021209717,42,41,15338,84
15338,84,0.31653004894436,idfc5f05e4,left_hip,0.825093984603882,0,0,15338,84
15337,84,0.957626085966643,idfc5f05e4,left_ankle,0.826153993606567,1,1,15338,84
15334,87,0.914577783284225,idfc5f05e4,right_ankle,0.876377820968628,4,1,15338,84
3641,89,0.149413612975387,idfc5f05e4,left_wrist,0.810760021209717,2,0,3643,87
3642,87,0.276096070008165,idfc5f05e4,left_hip,0.825093984603882,1,1,3643,87
3640,89,0.966296689137793,idfc5f05e4,left_ankle,0.826153993606567,3,1,3643,87
3642,87,0.903497627278486,idfc5f05e4,right_ankle,0.876377820968628,1,1,3643,87
3818,85,0.136907395262582,idfc5f05e4,left_wrist,0.810760021209717,-2,0,3816,87
3814,88,0.251073894842357,idfc5f05e4,left_hip,0.825093984603882,2,1,3816,87
3813,88,0.915491352940079,idfc5f05e4,left_ankle,0.826153993606567,3,2,3816,87
3814,89,0.861267750697332,idfc5f05e4,right_ankle,0.876377820968628,2,0,3816,87
12450,83,0.194437771635887,idfc5f05e4,left_wrist,0.810760021209717,0,1,12450,84
12452,83,0.317951703494675,idfc5f05e4,left_hip,0.825093984603882,-2,-1,12450,84
12449,84,0.957329872433269,idfc5f05e4,left_ankle,0.826153993606567,1,1,12450,84
12448,83,0.826177913791836,idfc5f05e4,right_ankle,0.876377820968628,2,3,12450,84
12950,84,0.216129880948385,idfc5f05e4,left_wrist,0.810760021209717,0,-1,12950,83
12952,83,0.344836325434184,idfc5f05e4,left_hip,0.825093984603882,-2,-2,12950,83
12950,83,1.00122552717514,idfc5f05e4,left_ankle,0.826153993606567,0,0,12950,83
12949,80,0.897767761040334,idfc5f05e4,right_ankle,0.876377820968628,1,4,12950,83
1923,89,0.226924061617239,idfc5f05e4,left_wrist,0.810760021209717,3,2,1926,88
1923,88,0.299314169790979,idfc5f05e4,left_hip,0.825093984603882,3,3,1926,88
1921,89,0.82513992970152,idfc5f05e4,left_ankle,0.826153993606567,5,4,1926,88
1924,87,0.897149116958788,idfc5f05e4,right_ankle,0.876377820968628,2,3,1926,88
15006,84,0.182528146105158,idfc5f05e4,left_wrist,0.810760021209717,1,0,15007,83
15008,83,0.344599348144268,idfc5f05e4,left_hip,0.825093984603882,-1,-1,15007,83
15007,79,0.798448813997683,idfc5f05e4,left_ankle,0.826153993606567,0,4,15007,83
15005,85,0.939318846682048,idfc5f05e4,right_ankle,0.876377820968628,2,0,15007,83
2478,87,0.170595926529105,idfc5f05e4,left_wrist,0.810760021209717,-38,-41,2440,84
2438,85,0.316908401015151,idfc5f05e4,left_hip,0.825093984603882,2,1,2440,84
2434,90,0.949367758672186,idfc5f05e4,left_ankle,0.826153993606567,6,0,2440,84
2436,86,0.911444473436894,idfc5f05e4,right_ankle,0.876377820968628,4,2,2440,84
2394,85,0.236950168001678,idfc5f05e4,left_wrist,0.810760021209717,-40,-38,2354,87
2353,86,0.304823028190437,idfc5f05e4,left_hip,0.825093984603882,1,2,2354,87
2352,83,0.746855705171867,idfc5f05e4,left_ankle,0.826153993606567,2,6,2354,87
2352,85,0.864098050373487,idfc5f05e4,right_ankle,0.876377820968628,2,4,2354,87
14432,83,0.19959391192451,idfc5f05e4,left_wrist,0.810760021209717,0,1,14432,84
14434,84,0.371634322709965,idfc5f05e4,left_hip,0.825093984603882,-2,-2,14432,84
14431,84,0.976475891547701,idfc5f05e4,left_ankle,0.826153993606567,1,1,14432,84
14430,84,0.949426832623954,idfc5f05e4,right_ankle,0.876377820968628,2,2,14432,84
8047,82,0.146714033800279,idfc5f05e4,left_wrist,0.810760021209717,-1,1,8046,84
8048,84,0.322786560929848,idfc5f05e4,left_hip,0.825093984603882,-2,-2,8046,84
8046,80,0.852721574881341,idfc5f05e4,left_ankle,0.826153993606567,0,4,8046,84
8043,83,0.937376848655642,idfc5f05e4,right_ankle,0.876377820968628,3,4,8046,84
2478,87,0.170595926529105,idfc5f05e4,left_wrist,0.810760021209717,-38,-41,2440,84
2438,85,0.316908401015151,idfc5f05e4,left_hip,0.825093984603882,2,1,2440,84
2434,90,0.949367758672186,idfc5f05e4,left_ankle,0.826153993606567,6,0,2440,84
2436,86,0.911444473436894,idfc5f05e4,right_ankle,0.876377820968628,4,2,2440,84
5447,85,0.150325320536449,idfc5f05e4,left_wrist,0.810760021209717,-1,0,5446,86
5447,85,0.268913978557816,idfc5f05e4,left_hip,0.825093984603882,-1,0,5446,86
5444,85,0.925954423420659,idfc5f05e4,left_ankle,0.826153993606567,2,3,5446,86
5445,85,0.836629150904211,idfc5f05e4,right_ankle,0.876377820968628,1,2,5446,86
10293,82,0.18308389313928,idfc5f05e4,left_wrist,0.810760021209717,1,2,10294,83
10295,82,0.316348031452065,idfc5f05e4,left_hip,0.825093984603882,-1,0,10294,83
10294,82,0.866087024888243,idfc5f05e4,left_ankle,0.826153993606567,0,1,10294,83
10288,83,0.906547125074466,idfc5f05e4,right_ankle,0.876377820968628,6,6,10294,83
4931,87,0.173815761909531,idfc5f05e4,left_wrist,0.810760021209717,1,1,4932,87
4930,86,0.28380840056977,idfc5f05e4,left_hip,0.825093984603882,2,3,4932,87
4929,87,0.806170488666131,idfc5f05e4,left_ankle,0.826153993606567,3,3,4932,87
4928,88,0.750809637817763,idfc5f05e4,right_ankle,0.876377820968628,4,3,4932,87
5531,85,0.171496644758348,idfc5f05e4,left_wrist,0.810760021209717,0,0,5531,85
5531,87,0.283811791928413,idfc5f05e4,left_hip,0.825093984603882,0,-2,5531,85
5528,85,0.856230050626748,idfc5f05e4,left_ankle,0.826153993606567,3,3,5531,85
5529,86,0.885913285526997,idfc5f05e4,right_ankle,0.876377820968628,2,1,5531,85
2394,85,0.236950168001678,idfc5f05e4,left_wrist,0.810760021209717,-40,-38,2354,87
2353,86,0.304823028190437,idfc5f05e4,left_hip,0.825093984603882,1,2,2354,87
2352,83,0.746855705171867,idfc5f05e4,left_ankle,0.826153993606567,2,6,2354,87
2352,85,0.864098050373487,idfc5f05e4,right_ankle,0.876377820968628,2,4,2354,87
15149,100,0.271502178157934,idf540d82b,left_wrist,1.42541909217834,12,10,15161,98
15155,98,0.273071579275322,idf540d82b,left_hip,1.412917137146,6,6,15161,98
15150,99,0.451916187046536,idf540d82b,left_ankle,1.41375398635864,11,10,15161,98
15150,101,0.472309484773037,idf540d82b,right_ankle,1.3804030418396,11,8,15161,98
4326,99,0.306554761439193,idf540d82b,left_wrist,1.42541909217834,10,12,4336,101
4334,96,0.275183128246702,idf540d82b,left_hip,1.412917137146,2,7,4336,101
4326,101,0.545662382695564,idf540d82b,left_ankle,1.41375398635864,10,10,4336,101
4326,101,0.461000957047736,idf540d82b,right_ankle,1.3804030418396,10,10,4336,101
21901,97,0.254716465548224,idf540d82b,left_wrist,1.42541909217834,4,6,21905,99
21906,96,0.342690136036038,idf540d82b,left_hip,1.412917137146,-1,2,21905,99
21899,98,0.662754713409746,idf540d82b,left_ankle,1.41375398635864,6,7,21905,99
21898,97,0.602447652654396,idf540d82b,right_ankle,1.3804030418396,7,9,21905,99
20554,100,0.230390138634948,idf540d82b,left_wrist,1.42541909217834,11,4,20565,93
20561,100,0.36241510420327,idf540d82b,left_hip,1.412917137146,4,-3,20565,93
20555,97,0.645198163261214,idf540d82b,left_ankle,1.41375398635864,10,6,20565,93
20553,99,0.479474013956681,idf540d82b,right_ankle,1.3804030418396,12,6,20565,93
21712,94,0.330664324830299,idf540d82b,left_wrist,1.42541909217834,1,3,21713,96
21716,95,0.349584266874079,idf540d82b,left_hip,1.412917137146,-3,-2,21713,96
21706,97,0.59325228794073,idf540d82b,left_ankle,1.41375398635864,7,6,21713,96
21706,97,0.541485306350024,idf540d82b,right_ankle,1.3804030418396,7,6,21713,96
16609,96,0.294655237388909,idf540d82b,left_wrist,1.42541909217834,3,5,16612,98
16614,96,0.340976902494308,idf540d82b,left_hip,1.412917137146,-2,0,16612,98
16605,98,0.64974641872389,idf540d82b,left_ankle,1.41375398635864,7,7,16612,98
16605,98,0.549628322116119,idf540d82b,right_ankle,1.3804030418396,7,7,16612,98
8574,99,0.23469996466631,idf540d82b,left_wrist,1.42541909217834,11,11,8585,99
8581,96,0.263309135306658,idf540d82b,left_hip,1.412917137146,4,7,8585,99
8574,100,0.466513328814239,idf540d82b,left_ankle,1.41375398635864,11,10,8585,99
8575,98,0.513999925901267,idf540d82b,right_ankle,1.3804030418396,10,11,8585,99
17998,95,0.332237680174107,idf540d82b,left_wrist,1.42541909217834,-45,-44,17953,96
17955,94,0.382979892959842,idf540d82b,left_hip,1.412917137146,-2,0,17953,96
17947,96,0.604946084936505,idf540d82b,left_ankle,1.41375398635864,6,6,17953,96
17947,94,0.648084496525412,idf540d82b,right_ankle,1.3804030418396,6,8,17953,96
372,95,0.246055772974423,idf540d82b,left_wrist,1.42541909217834,-46,-41,326,100
322,98,0.302354797662902,idf540d82b,left_hip,1.412917137146,4,6,326,100
316,98,0.62337132531959,idf540d82b,left_ankle,1.41375398635864,10,12,326,100
317,98,0.532204760676185,idf540d82b,right_ankle,1.3804030418396,9,11,326,100
21712,94,0.330664324830299,idf540d82b,left_wrist,1.42541909217834,1,7,21713,100
21716,95,0.349584266874079,idf540d82b,left_hip,1.412917137146,-3,2,21713,100
21706,97,0.59325228794073,idf540d82b,left_ankle,1.41375398635864,7,10,21713,100
21706,97,0.541485306350024,idf540d82b,right_ankle,1.3804030418396,7,10,21713,100
22759,100,0.308118526785815,idf540d82b,left_wrist,1.42541909217834,12,9,22771,97
22768,97,0.282738885494982,idf540d82b,left_hip,1.412917137146,3,3,22771,97
22761,98,0.588655739372969,idf540d82b,left_ankle,1.41375398635864,10,9,22771,97
22760,99,0.532950249060223,idf540d82b,right_ankle,1.3804030418396,11,9,22771,97
8280,99,0.193045098803073,idf540d82b,left_wrist,1.42541909217834,9,6,8289,96
8286,100,0.279143687743798,idf540d82b,left_hip,1.412917137146,3,-1,8289,96
8281,97,0.597076282076071,idf540d82b,left_ankle,1.41375398635864,8,7,8289,96
8280,98,0.522157229565897,idf540d82b,right_ankle,1.3804030418396,9,7,8289,96
17234,99,0.317153264338394,idf540d82b,left_wrist,1.42541909217834,-45,-44,17189,100
17190,98,0.349593417241297,idf540d82b,left_hip,1.412917137146,-1,1,17189,100
17183,96,0.630521254897335,idf540d82b,left_ankle,1.41375398635864,6,10,17189,100
17182,101,0.641159506031744,idf540d82b,right_ankle,1.3804030418396,7,6,17189,100
18233,51,0.113891794675428,idf540d82b,left_wrist,1.42541909217834,2,48,18235,97
18237,98,0.357257262019024,idf540d82b,left_hip,1.412917137146,-2,-3,18235,97
18229,97,0.675117981350861,idf540d82b,left_ankle,1.41375398635864,6,6,18235,97
18232,95,0.618611746616827,idf540d82b,right_ankle,1.3804030418396,3,5,18235,97
16216,97,0.238814200110313,idf540d82b,left_wrist,1.42541909217834,8,10,16224,99
16222,97,0.312829681894791,idf540d82b,left_hip,1.412917137146,2,4,16224,99
16213,99,0.524643486816698,idf540d82b,left_ankle,1.41375398635864,11,11,16224,99
16211,101,0.547710222517299,idf540d82b,right_ankle,1.3804030418396,13,11,16224,99
11098,95,0.304523775235247,idf540d82b,left_wrist,1.42541909217834,5,7,11103,97
11102,95,0.320763481594697,idf540d82b,left_hip,1.412917137146,1,3,11103,97
11093,97,0.513222297013815,idf540d82b,left_ankle,1.41375398635864,10,10,11103,97
11095,95,0.602499730922404,idf540d82b,right_ankle,1.3804030418396,8,10,11103,97
11382,51,0.0793492078056764,idf540d82b,left_wrist,1.42541909217834,7,53,11389,97
11388,99,0.328988954648322,idf540d82b,left_hip,1.412917137146,1,-1,11389,97
11382,94,0.621665438094298,idf540d82b,left_ankle,1.41375398635864,7,10,11389,97
11382,94,0.552165756167927,idf540d82b,right_ankle,1.3804030418396,7,10,11389,97
7091,101,0.261672731010738,idf540d82b,left_wrist,1.42541909217834,16,15,7107,100
7099,102,0.258997022526193,idf540d82b,left_hip,1.412917137146,8,6,7107,100
7096,100,0.514576874421112,idf540d82b,left_ankle,1.41375398635864,11,11,7107,100
7094,102,0.448466678654798,idf540d82b,right_ankle,1.3804030418396,13,11,7107,100
15922,98,0.254780294752241,idf540d82b,left_wrist,1.42541909217834,10,8,15932,96
15927,99,0.273025639919296,idf540d82b,left_hip,1.412917137146,5,2,15932,96
15921,97,0.549743055541926,idf540d82b,left_ankle,1.41375398635864,11,10,15932,96
15922,97,0.50623114897807,idf540d82b,right_ankle,1.3804030418396,10,9,15932,96
18909,95,0.370942334443524,idf540d82b,left_wrist,1.42541909217834,4,7,18913,98
18913,95,0.358204629129402,idf540d82b,left_hip,1.412917137146,0,3,18913,98
18902,98,0.581447974888499,idf540d82b,left_ankle,1.41375398635864,11,11,18913,98
18906,94,0.547385376137703,idf540d82b,right_ankle,1.3804030418396,7,11,18913,98
7970,93,0.196371263490886,idb221f542,left_wrist,0.970026969909668,-2,-2,7968,93
7977,95,0.250849722182738,idb221f542,left_hip,0.96265697479248,-9,-11,7968,93
7967,93,0.763633501413425,idb221f542,left_ankle,0.94707202911377,1,1,7968,93
7971,94,0.689137441029631,idb221f542,right_ankle,0.958822965621948,-3,-4,7968,93
9417,97,0.265637950515857,idb221f542,left_wrist,0.970026969909668,-3,-3,9414,97
9422,97,0.321724947358491,idb221f542,left_hip,0.96265697479248,-8,-8,9414,97
9413,100,0.873194310366504,idb221f542,left_ankle,0.94707202911377,1,-2,9414,97
9416,98,0.700998888891556,idb221f542,right_ankle,0.958822965621948,-2,-3,9414,97
12125,99,0.235371967595181,idb221f542,left_wrist,0.970026969909668,-1,-2,12124,98
12131,98,0.305498396850126,idb221f542,left_hip,0.96265697479248,-7,-7,12124,98
12122,99,0.760276534782622,idb221f542,left_ankle,0.94707202911377,2,1,12124,98
12126,99,0.809771776521538,idb221f542,right_ankle,0.958822965621948,-2,-3,12124,98
2710,100,0.228050826602172,idb221f542,left_wrist,0.970026969909668,-4,-3,2706,101
2706,100,0.284157322515639,idb221f542,left_hip,0.96265697479248,0,1,2706,101
2706,100,0.790264757919758,idb221f542,left_ankle,0.94707202911377,0,1,2706,101
2704,99,0.810669117690459,idb221f542,right_ankle,0.958822965621948,2,4,2706,101
6321,99,0.257730198034565,idb221f542,left_wrist,0.970026969909668,-2,-2,6319,99
6326,98,0.308595993237092,idb221f542,left_hip,0.96265697479248,-7,-6,6319,99
6319,98,0.791062298650398,idb221f542,left_ankle,0.94707202911377,0,1,6319,99
6321,98,0.685204404436706,idb221f542,right_ankle,0.958822965621948,-2,-1,6319,99
7488,98,0.29126477410729,idb221f542,left_wrist,0.970026969909668,-1,-1,7487,98
7488,98,0.303406612010459,idb221f542,left_hip,0.96265697479248,-1,-1,7487,98
7486,97,0.795498162943052,idb221f542,left_ankle,0.94707202911377,1,2,7487,98
7486,97,0.820647189638946,idb221f542,right_ankle,0.958822965621948,1,2,7487,98
1628,100,0.189642516906278,idb221f542,left_wrist,0.970026969909668,-2,-3,1626,99
1625,100,0.269872975122649,idb221f542,left_hip,0.96265697479248,1,0,1626,99
1624,99,0.685467065063468,idb221f542,left_ankle,0.94707202911377,2,2,1626,99
1624,99,0.801326389506154,idb221f542,right_ankle,0.958822965621948,2,2,1626,99
17010,100,0.302047193946244,idb221f542,left_wrist,0.970026969909668,-3,-3,17007,100
17013,100,0.340174025044615,idb221f542,left_hip,0.96265697479248,-6,-6,17007,100
17008,101,0.834498306648898,idb221f542,left_ankle,0.94707202911377,-1,-2,17007,100
17009,99,0.785193424870297,idb221f542,right_ankle,0.958822965621948,-2,-1,17007,100
15347,99,0.313185117102102,idb221f542,left_wrist,0.970026969909668,-3,-3,15344,99
15352,97,0.308462941525196,idb221f542,left_hip,0.96265697479248,-8,-6,15344,99
15346,100,0.782177224761206,idb221f542,left_ankle,0.94707202911377,-2,-3,15344,99
15346,100,0.815484216413944,idb221f542,right_ankle,0.958822965621948,-2,-3,15344,99
16029,100,0.292712095472068,idb221f542,left_wrist,0.970026969909668,-2,-3,16027,99
16033,99,0.32980167924088,idb221f542,left_hip,0.96265697479248,-6,-6,16027,99
16028,100,0.764736686206978,idb221f542,left_ankle,0.94707202911377,-1,-2,16027,99
16029,99,0.806992680615194,idb221f542,right_ankle,0.958822965621948,-2,-2,16027,99
17109,98,0.303243558956316,idb221f542,left_wrist,0.970026969909668,-3,-2,17106,99
17112,99,0.328473374328165,idb221f542,left_hip,0.96265697479248,-6,-6,17106,99
17108,98,0.758940953437404,idb221f542,left_ankle,0.94707202911377,-2,-1,17106,99
17107,100,0.788361604824254,idb221f542,right_ankle,0.958822965621948,-1,-2,17106,99
1431,99,0.185178585139277,idb221f542,left_wrist,0.970026969909668,-3,-3,1428,99
1429,97,0.280968371818971,idb221f542,left_hip,0.96265697479248,-1,1,1428,99
1427,99,0.761372441693163,idb221f542,left_ankle,0.94707202911377,1,1,1428,99
1426,102,0.851562346261825,idb221f542,right_ankle,0.958822965621948,2,-1,1428,99
7005,96,0.259082679242444,idb221f542,left_wrist,0.970026969909668,-2,-1,7003,97
7009,98,0.298913351604679,idb221f542,left_hip,0.96265697479248,-6,-7,7003,97
7002,98,0.798949733825067,idb221f542,left_ankle,0.94707202911377,1,0,7003,97
7004,99,0.811955858841967,idb221f542,right_ankle,0.958822965621948,-1,-3,7003,97
9899,99,0.233107547118296,idb221f542,left_wrist,0.970026969909668,-2,-2,9897,99
9905,97,0.299440637175117,idb221f542,left_hip,0.96265697479248,-8,-6,9897,99
9897,98,0.830120083643769,idb221f542,left_ankle,0.94707202911377,0,1,9897,99
9899,99,0.756941674733768,idb221f542,right_ankle,0.958822965621948,-2,-2,9897,99
2021,100,0.175814624715917,idb221f542,left_wrist,0.970026969909668,-3,-3,2018,100
2018,99,0.295949588859149,idb221f542,left_hip,0.96265697479248,0,1,2018,100
2016,101,0.748372969781112,idb221f542,left_ankle,0.94707202911377,2,1,2018,100
2016,100,0.724907440461021,idb221f542,right_ankle,0.958822965621948,2,2,2018,100
14664,99,0.339518391148068,idb221f542,left_wrist,0.970026969909668,-2,-2,14662,99
14667,100,0.3151754587877,idb221f542,left_hip,0.96265697479248,-5,-6,14662,99
14661,102,0.790876925336602,idb221f542,left_ankle,0.94707202911377,1,-2,14662,99
14664,99,0.784756444509295,idb221f542,right_ankle,0.958822965621948,-2,-2,14662,99
13488,99,0.244817236285191,idb221f542,left_wrist,0.970026969909668,-4,-4,13484,99
13490,99,0.309525349867252,idb221f542,left_hip,0.96265697479248,-6,-6,13484,99
13486,99,0.754504184367027,idb221f542,left_ankle,0.94707202911377,-2,-2,13484,99
13487,99,0.799847151935962,idb221f542,right_ankle,0.958822965621948,-3,-3,13484,99
1141,98,0.189012077249442,idb221f542,left_wrist,0.970026969909668,-4,-3,1137,99
1139,96,0.265929510235268,idb221f542,left_hip,0.96265697479248,-2,1,1137,99
1136,98,0.810852811182827,idb221f542,left_ankle,0.94707202911377,1,2,1137,99
1136,98,0.830756748778815,idb221f542,right_ankle,0.958822965621948,1,2,1137,99
8836,99,0.248300071316014,idb221f542,left_wrist,0.970026969909668,-1,-2,8835,98
8844,95,0.288237313816594,idb221f542,left_hip,0.96265697479248,-9,-6,8835,98
8835,97,0.820929583906732,idb221f542,left_ankle,0.94707202911377,0,1,8835,98
8838,98,0.702378652095727,idb221f542,right_ankle,0.958822965621948,-3,-3,8835,98
16814,98,0.311436475368943,idb221f542,left_wrist,0.970026969909668,-4,-2,16810,100
16817,99,0.327330083088446,idb221f542,left_hip,0.96265697479248,-7,-6,16810,100
16812,99,0.788561745195571,idb221f542,left_ankle,0.94707202911377,-2,-1,16810,100
16811,100,0.690932857777733,idb221f542,right_ankle,0.958822965621948,-1,-1,16810,100
