tau_i,T_i,sim_i,subj_id,loc_id,exec_t,SS_start_diff,SS_end_diff,manSS_tau_i,manSS_T_i
5058,114,0.323549246109691,idabd0c53c,left_wrist,3.78247690200806,54,53,5112,113
5111,114,0.3790859845922,idabd0c53c,left_hip,3.16086006164551,1,0,5112,113
5111,114,0.671894652506979,idabd0c53c,left_ankle,3.3931770324707,1,0,5112,113
5113,116,0.602075780881914,idabd0c53c,right_ankle,3.34290504455566,-1,-4,5112,113
7155,58,0.204150574777787,idabd0c53c,left_wrist,3.78247690200806,-4,49,7151,111
7152,113,0.339040555909772,idabd0c53c,left_hip,3.16086006164551,-1,-3,7151,111
7152,110,0.641682797624064,idabd0c53c,left_ankle,3.3931770324707,-1,0,7151,111
7154,109,0.636365005491428,idabd0c53c,right_ankle,3.34290504455566,-3,-1,7151,111
10929,109,0.392179729072577,idabd0c53c,left_wrist,3.78247690200806,-3,-3,10926,109
10926,109,0.416574251223906,idabd0c53c,left_hip,3.16086006164551,0,0,10926,109
10925,109,0.751183737848847,idabd0c53c,left_ankle,3.3931770324707,1,1,10926,109
10925,109,0.653527019980477,idabd0c53c,right_ankle,3.34290504455566,1,1,10926,109
17244,108,0.445012887959177,idabd0c53c,left_wrist,3.78247690200806,-3,-3,17241,108
17244,105,0.4331635845401,idabd0c53c,left_hip,3.16086006164551,-3,0,17241,108
17241,107,0.673001886315117,idabd0c53c,left_ankle,3.3931770324707,0,1,17241,108
17241,108,0.695388231418092,idabd0c53c,right_ankle,3.34290504455566,0,0,17241,108
3798,115,0.40124627873971,idabd0c53c,left_wrist,3.78247690200806,54,54,3852,115
3851,117,0.368724111401388,idabd0c53c,left_hip,3.16086006164551,1,-1,3852,115
3850,117,0.649460004680219,idabd0c53c,left_ankle,3.3931770324707,2,0,3852,115
3856,113,0.635584448579538,idabd0c53c,right_ankle,3.34290504455566,-4,-2,3852,115
17033,107,0.440154561224546,idabd0c53c,left_wrist,3.78247690200806,-4,-4,17029,107
17030,106,0.463931378685691,idabd0c53c,left_hip,3.16086006164551,-1,0,17029,107
17030,106,0.768026078157707,idabd0c53c,left_ankle,3.3931770324707,-1,0,17029,107
17029,105,0.693118396964248,idabd0c53c,right_ankle,3.34290504455566,0,2,17029,107
17881,106,0.457179884418716,idabd0c53c,left_wrist,3.78247690200806,-3,-3,17878,106
17879,105,0.469152549353327,idabd0c53c,left_hip,3.16086006164551,-1,0,17878,106
17878,106,0.659784177495321,idabd0c53c,left_ankle,3.3931770324707,0,0,17878,106
17878,108,0.671746770283313,idabd0c53c,right_ankle,3.34290504455566,0,-2,17878,106
12567,57,0.200788790277037,idabd0c53c,left_wrist,3.78247690200806,-4,49,12563,110
12564,112,0.371712547889472,idabd0c53c,left_hip,3.16086006164551,-1,-3,12563,110
12562,111,0.665052228822704,idabd0c53c,left_ankle,3.3931770324707,1,0,12563,110
12564,109,0.662043601090417,idabd0c53c,right_ankle,3.34290504455566,-1,0,12563,110
12017,57,0.210889199188915,idabd0c53c,left_wrist,3.78247690200806,-3,51,12014,111
12015,111,0.420585953982392,idabd0c53c,left_hip,3.16086006164551,-1,-1,12014,111
12013,111,0.685556342408912,idabd0c53c,left_ankle,3.3931770324707,1,1,12014,111
12014,112,0.598649871515125,idabd0c53c,right_ankle,3.34290504455566,0,-1,12014,111
1227,108,0.388990188315883,idabd0c53c,left_wrist,3.78247690200806,50,50,1277,108
1277,107,0.367361203904852,idabd0c53c,left_hip,3.16086006164551,0,1,1277,108
1277,106,0.750895261808532,idabd0c53c,left_ankle,3.3931770324707,0,2,1277,108
1275,110,0.689056352869863,idabd0c53c,right_ankle,3.34290504455566,2,0,1277,108
3912,114,0.385358401679763,idabd0c53c,left_wrist,3.78247690200806,54,53,3966,113
3967,113,0.364412327166233,idabd0c53c,left_hip,3.16086006164551,-1,-1,3966,113
3966,113,0.729497492608656,idabd0c53c,left_ankle,3.3931770324707,0,0,3966,113
3968,115,0.620881308786323,idabd0c53c,right_ankle,3.34290504455566,-2,-4,3966,113
3346,112,0.399862089647929,idabd0c53c,left_wrist,3.78247690200806,51,52,3397,113
3397,113,0.375413295365992,idabd0c53c,left_hip,3.16086006164551,0,0,3397,113
3397,112,0.689038330781738,idabd0c53c,left_ankle,3.3931770324707,0,1,3397,113
3399,115,0.629871012732164,idabd0c53c,right_ankle,3.34290504455566,-2,-4,3397,113
13060,110,0.394075533219654,idabd0c53c,left_wrist,3.78247690200806,51,52,13111,111
13111,114,0.433295834932102,idabd0c53c,left_hip,3.16086006164551,0,-3,13111,111
13110,112,0.680957675692734,idabd0c53c,left_ankle,3.3931770324707,1,0,13111,111
13111,110,0.6632497252137,idabd0c53c,right_ankle,3.34290504455566,0,1,13111,111
7321,115,0.352415442886274,idabd0c53c,left_wrist,3.78247690200806,51,51,7372,115
7372,117,0.347347752577157,idabd0c53c,left_hip,3.16086006164551,0,-2,7372,115
7371,116,0.711960930937836,idabd0c53c,left_ankle,3.3931770324707,1,0,7372,115
7375,115,0.566999334815597,idabd0c53c,right_ankle,3.34290504455566,-3,-3,7372,115
14662,106,0.451343148966734,idabd0c53c,left_wrist,3.78247690200806,48,51,14710,109
14711,113,0.395327654856056,idabd0c53c,left_hip,3.16086006164551,-1,-5,14710,109
14710,107,0.640743403108519,idabd0c53c,left_ankle,3.3931770324707,0,2,14710,109
14711,105,0.669614464509513,idabd0c53c,right_ankle,3.34290504455566,-1,3,14710,109
9471,113,0.336275032991539,idabd0c53c,left_wrist,3.78247690200806,52,51,9523,112
9524,110,0.38335494321464,idabd0c53c,left_hip,3.16086006164551,-1,1,9523,112
9524,110,0.732260614174027,idabd0c53c,left_ankle,3.3931770324707,-1,1,9523,112
9525,112,0.665028831618111,idabd0c53c,right_ankle,3.34290504455566,-2,-2,9523,112
13607,108,0.406245470198637,idabd0c53c,left_wrist,3.78247690200806,50,47,13657,105
13659,104,0.491811060614158,idabd0c53c,left_hip,3.16086006164551,-2,-1,13657,105
13657,104,0.708500621035317,idabd0c53c,left_ankle,3.3931770324707,0,1,13657,105
13656,104,0.706565708653921,idabd0c53c,right_ankle,3.34290504455566,1,2,13657,105
18838,108,0.409005640441194,idabd0c53c,left_wrist,3.78247690200806,-2,-2,18836,108
18835,108,0.414712917686367,idabd0c53c,left_hip,3.16086006164551,1,1,18836,108
18835,108,0.713024739515182,idabd0c53c,left_ankle,3.3931770324707,1,1,18836,108
18835,108,0.716319322810928,idabd0c53c,right_ankle,3.34290504455566,1,1,18836,108
7212,110,0.39085117175737,idabd0c53c,left_wrist,3.78247690200806,49,51,7261,112
7264,109,0.390498112798336,idabd0c53c,left_hip,3.16086006164551,-3,0,7261,112
7261,111,0.672963471309352,idabd0c53c,left_ankle,3.3931770324707,0,1,7261,112
7262,114,0.601180346327291,idabd0c53c,right_ankle,3.34290504455566,-1,-3,7261,112
14662,106,0.451343148966734,idabd0c53c,left_wrist,3.78247690200806,48,51,14710,109
14711,113,0.395327654856056,idabd0c53c,left_hip,3.16086006164551,-1,-5,14710,109
14710,107,0.640743403108519,idabd0c53c,left_ankle,3.3931770324707,0,2,14710,109
14711,105,0.669614464509513,idabd0c53c,right_ankle,3.34290504455566,-1,3,14710,109
18058,95,0.296430249561502,id5993bf4a,left_wrist,3.11226797103882,-3,-7,18055,91
18061,94,0.508223205783051,id5993bf4a,left_hip,3.25046801567078,-6,-9,18055,91
18053,94,0.850057569851603,id5993bf4a,left_ankle,3.21033811569214,2,-1,18055,91
18053,92,0.733480488685487,id5993bf4a,right_ankle,3.26869797706604,2,1,18055,91
4112,98,0.235115099875948,id5993bf4a,left_wrist,3.11226797103882,0,-1,4112,97
4111,98,0.362636084514177,id5993bf4a,left_hip,3.25046801567078,1,0,4112,97
4108,98,0.871210566990025,id5993bf4a,left_ankle,3.21033811569214,4,3,4112,97
4108,99,0.680099974278302,id5993bf4a,right_ankle,3.26869797706604,4,2,4112,97
12551,98,0.216152036089189,id5993bf4a,left_wrist,3.11226797103882,0,-2,12551,96
12552,100,0.487089644407589,id5993bf4a,left_hip,3.25046801567078,-1,-5,12551,96
12549,97,0.772689951055458,id5993bf4a,left_ankle,3.21033811569214,2,1,12551,96
12550,96,0.747376898720308,id5993bf4a,right_ankle,3.26869797706604,1,1,12551,96
2485,123,0.226590901211335,id5993bf4a,left_wrist,3.11226797103882,2,-27,2487,94
2486,96,0.347779738560528,id5993bf4a,left_hip,3.25046801567078,1,-1,2487,94
2484,96,0.913872767516001,id5993bf4a,left_ankle,3.21033811569214,3,1,2487,94
2483,97,0.78182020410321,id5993bf4a,right_ankle,3.26869797706604,4,1,2487,94
5172,97,0.203162800627213,id5993bf4a,left_wrist,3.11226797103882,-1,-3,5171,95
5172,97,0.338170713417439,id5993bf4a,left_hip,3.25046801567078,-1,-3,5171,95
5168,95,0.873688231294334,id5993bf4a,left_ankle,3.21033811569214,3,3,5171,95
5169,95,0.698517095641975,id5993bf4a,right_ankle,3.26869797706604,2,2,5171,95
7464,98,0.228306699409207,id5993bf4a,left_wrist,3.11226797103882,-2,-2,7462,98
7463,98,0.382453685364391,id5993bf4a,left_hip,3.25046801567078,-1,-1,7462,98
7460,99,0.899143537712983,id5993bf4a,left_ankle,3.21033811569214,2,1,7462,98
7460,98,0.772145853110811,id5993bf4a,right_ankle,3.26869797706604,2,2,7462,98
392,95,0.235885759468395,id5993bf4a,left_wrist,3.11226797103882,-5,-4,387,96
392,95,0.442205211462949,id5993bf4a,left_hip,3.25046801567078,-5,-4,387,96
385,96,0.776742495731825,id5993bf4a,left_ankle,3.21033811569214,2,2,387,96
387,95,0.735978043479806,id5993bf4a,right_ankle,3.26869797706604,0,1,387,96
7367,98,0.208694420710886,id5993bf4a,left_wrist,3.11226797103882,-1,-2,7366,97
7368,96,0.370015811941231,id5993bf4a,left_hip,3.25046801567078,-2,-1,7366,97
7363,98,0.791647726775041,id5993bf4a,left_ankle,3.21033811569214,3,2,7366,97
7364,97,0.742619216350441,id5993bf4a,right_ankle,3.26869797706604,2,2,7366,97
16740,95,0.242322667784853,id5993bf4a,left_wrist,3.11226797103882,-3,-2,16737,96
16742,96,0.513414346903521,id5993bf4a,left_hip,3.25046801567078,-5,-5,16737,96
16735,96,0.836727636398811,id5993bf4a,left_ankle,3.21033811569214,2,2,16737,96
16735,95,0.78983038017998,id5993bf4a,right_ankle,3.26869797706604,2,3,16737,96
6606,97,0.274058477078413,id5993bf4a,left_wrist,3.11226797103882,-3,-2,6603,98
6606,96,0.413461885019937,id5993bf4a,left_hip,3.25046801567078,-3,-1,6603,98
6601,98,0.904416749046308,id5993bf4a,left_ankle,3.21033811569214,2,2,6603,98
6602,98,0.756208116738101,id5993bf4a,right_ankle,3.26869797706604,1,1,6603,98
9302,95,0.250690361351497,id5993bf4a,left_wrist,3.11226797103882,-5,-11,9297,89
9303,95,0.563826957279526,id5993bf4a,left_hip,3.25046801567078,-6,-12,9297,89
9296,88,0.88742421083561,id5993bf4a,left_ankle,3.21033811569214,1,2,9297,89
9298,90,0.794477551134352,id5993bf4a,right_ankle,3.26869797706604,-1,-2,9297,89
11584,98,0.24048176157056,id5993bf4a,left_wrist,3.11226797103882,-1,3,11583,102
11588,95,0.405038660562881,id5993bf4a,left_hip,3.25046801567078,-5,2,11583,102
11581,103,0.787591991729973,id5993bf4a,left_ankle,3.21033811569214,2,1,11583,102
11580,98,0.70803106148299,id5993bf4a,right_ankle,3.26869797706604,3,7,11583,102
9483,96,0.231761426658855,id5993bf4a,left_wrist,3.11226797103882,-5,-5,9478,96
9485,94,0.489141964538497,id5993bf4a,left_hip,3.25046801567078,-7,-5,9478,96
9477,100,0.864098398556456,id5993bf4a,left_ankle,3.21033811569214,1,-3,9478,96
9478,96,0.80430141173261,id5993bf4a,right_ankle,3.26869797706604,0,0,9478,96
3626,94,0.204840365324468,id5993bf4a,left_wrist,3.11226797103882,1,4,3627,97
3632,94,0.417671558507581,id5993bf4a,left_hip,3.25046801567078,-5,-2,3627,97
3626,96,0.754074337229343,id5993bf4a,left_ankle,3.21033811569214,1,2,3627,97
3626,96,0.737699036723033,id5993bf4a,right_ankle,3.26869797706604,1,2,3627,97
15881,98,0.29516965166693,id5993bf4a,left_wrist,3.11226797103882,-2,-1,15879,99
15884,96,0.493853887478935,id5993bf4a,left_hip,3.25046801567078,-5,-2,15879,99
15878,97,0.866214483934076,id5993bf4a,left_ankle,3.21033811569214,1,3,15879,99
15878,97,0.708445674158807,id5993bf4a,right_ankle,3.26869797706604,1,3,15879,99
12935,102,0.347651094035019,id5993bf4a,left_wrist,3.11226797103882,1,-4,12936,97
12939,98,0.508185986742864,id5993bf4a,left_hip,3.25046801567078,-3,-4,12936,97
12935,97,0.84339530355854,id5993bf4a,left_ankle,3.21033811569214,1,1,12936,97
12935,97,0.803549927255228,id5993bf4a,right_ankle,3.26869797706604,1,1,12936,97
15311,97,0.255351510718112,id5993bf4a,left_wrist,3.11226797103882,-1,-1,15310,97
15313,96,0.518771741017525,id5993bf4a,left_hip,3.25046801567078,-3,-2,15310,97
15306,98,0.861574090151819,id5993bf4a,left_ankle,3.21033811569214,4,3,15310,97
15306,97,0.773169918883038,id5993bf4a,right_ankle,3.26869797706604,4,4,15310,97
2191,103,0.219217433552733,id5993bf4a,left_wrist,3.11226797103882,5,-1,2196,97
2196,99,0.370934735933369,id5993bf4a,left_hip,3.25046801567078,0,-2,2196,97
2194,98,0.898513705689435,id5993bf4a,left_ankle,3.21033811569214,2,1,2196,97
2194,98,0.769554985710262,id5993bf4a,right_ankle,3.26869797706604,2,1,2196,97
13903,97,0.241405298867759,id5993bf4a,left_wrist,3.11226797103882,-4,-3,13899,98
13904,96,0.432490244725686,id5993bf4a,left_hip,3.25046801567078,-5,-3,13899,98
13898,97,0.77670186342449,id5993bf4a,left_ankle,3.21033811569214,1,2,13899,98
13899,97,0.739579144113002,id5993bf4a,right_ankle,3.26869797706604,0,1,13899,98
8027,126,0.213554081405059,id5993bf4a,left_wrist,3.11226797103882,1,-25,8028,100
8029,98,0.302690377066966,id5993bf4a,left_hip,3.25046801567078,-1,1,8028,100
8026,100,0.796404688714831,id5993bf4a,left_ankle,3.21033811569214,2,2,8028,100
8025,100,0.735569958041458,id5993bf4a,right_ankle,3.26869797706604,3,3,8028,100
13845,100,0.189949914187558,idd80ac2b4,left_wrist,3.03967213630676,-2,-1,13843,101
13841,100,0.356053152100154,idd80ac2b4,left_hip,2.86206579208374,2,3,13843,101
13841,101,0.799532357748926,idd80ac2b4,left_ankle,2.781329870224,2,2,13843,101
13841,100,0.704585941791839,idd80ac2b4,right_ankle,3.13747715950012,2,3,13843,101
10917,96,0.185268940061495,idd80ac2b4,left_wrist,3.03967213630676,0,3,10917,99
10913,98,0.323474374295352,idd80ac2b4,left_hip,2.86206579208374,4,5,10917,99
10915,97,0.786795561545409,idd80ac2b4,left_ankle,2.781329870224,2,4,10917,99
10915,97,0.76347827002061,idd80ac2b4,right_ankle,3.13747715950012,2,4,10917,99
13154,101,0.207357970144398,idd80ac2b4,left_wrist,3.03967213630676,0,-1,13154,100
13149,101,0.348332491561282,idd80ac2b4,left_hip,2.86206579208374,5,4,13154,100
13152,100,0.80392256803345,idd80ac2b4,left_ankle,2.781329870224,2,2,13154,100
13151,99,0.725835162677465,idd80ac2b4,right_ankle,3.13747715950012,3,4,13154,100
9355,103,0.176176758051912,idd80ac2b4,left_wrist,3.03967213630676,6,2,9361,99
9356,99,0.270611585892693,idd80ac2b4,left_hip,2.86206579208374,5,5,9361,99
9358,99,0.819905287656557,idd80ac2b4,left_ankle,2.781329870224,3,3,9361,99
9358,100,0.758374005993031,idd80ac2b4,right_ankle,3.13747715950012,3,2,9361,99
8865,105,0.140652912722168,idd80ac2b4,left_wrist,3.03967213630676,3,-3,8868,99
8862,101,0.317677021065907,idd80ac2b4,left_hip,2.86206579208374,6,4,8868,99
8866,100,0.739037597220265,idd80ac2b4,left_ankle,2.781329870224,2,1,8868,99
8864,99,0.77161816775582,idd80ac2b4,right_ankle,3.13747715950012,4,4,8868,99
13254,54,0.153989276911227,idd80ac2b4,left_wrist,3.03967213630676,-1,43,13253,98
13249,97,0.341934110359494,idd80ac2b4,left_hip,2.86206579208374,4,5,13253,98
13251,98,0.77280369320011,idd80ac2b4,left_ankle,2.781329870224,2,2,13253,98
13249,99,0.815333838149467,idd80ac2b4,right_ankle,3.13747715950012,4,3,13253,98
563,100,0.17302402317239,idd80ac2b4,left_wrist,3.03967213630676,6,4,569,98
562,98,0.310408526822481,idd80ac2b4,left_hip,2.86206579208374,7,7,569,98
565,98,0.705396289713025,idd80ac2b4,left_ankle,2.781329870224,4,4,569,98
565,99,0.739266227549837,idd80ac2b4,right_ankle,3.13747715950012,4,3,569,98
8077,96,0.180752330651847,idd80ac2b4,left_wrist,3.03967213630676,4,7,8081,99
8075,98,0.238385060573483,idd80ac2b4,left_hip,2.86206579208374,6,7,8081,99
8078,98,0.79690423583803,idd80ac2b4,left_ankle,2.781329870224,3,4,8081,99
8078,98,0.754053138914616,idd80ac2b4,right_ankle,3.13747715950012,3,4,8081,99
12375,96,0.199715286443393,idd80ac2b4,left_wrist,3.03967213630676,-2,-1,12373,97
12369,97,0.357620519755871,idd80ac2b4,left_hip,2.86206579208374,4,4,12373,97
12370,98,0.837180539892343,idd80ac2b4,left_ankle,2.781329870224,3,2,12373,97
12371,97,0.830770695266318,idd80ac2b4,right_ankle,3.13747715950012,2,2,12373,97
11691,103,0.214818760703776,idd80ac2b4,left_wrist,3.03967213630676,4,0,11695,99
11690,98,0.301978381394563,idd80ac2b4,left_hip,2.86206579208374,5,6,11695,99
11693,97,0.734421103468018,idd80ac2b4,left_ankle,2.781329870224,2,4,11695,99
11693,101,0.724735906556164,idd80ac2b4,right_ankle,3.13747715950012,2,0,11695,99
8077,96,0.180752330651847,idd80ac2b4,left_wrist,3.03967213630676,4,7,8081,99
8075,98,0.238385060573483,idd80ac2b4,left_hip,2.86206579208374,6,7,8081,99
8078,98,0.79690423583803,idd80ac2b4,left_ankle,2.781329870224,3,4,8081,99
8078,98,0.754053138914616,idd80ac2b4,right_ankle,3.13747715950012,3,4,8081,99
14443,98,0.223968333295225,idd80ac2b4,left_wrist,3.03967213630676,-3,-1,14440,100
14437,100,0.328949873095276,idd80ac2b4,left_hip,2.86206579208374,3,3,14440,100
14438,99,0.70046024491326,idd80ac2b4,left_ankle,2.781329870224,2,3,14440,100
14437,100,0.742431742325956,idd80ac2b4,right_ankle,3.13747715950012,3,3,14440,100
7503,87,0.124750254823764,idd80ac2b4,left_wrist,3.03967213630676,-7,6,7496,100
7489,99,0.220315291707791,idd80ac2b4,left_hip,2.86206579208374,7,8,7496,100
7492,100,0.690860885744892,idd80ac2b4,left_ankle,2.781329870224,4,4,7496,100
7492,100,0.670310813120927,idd80ac2b4,right_ankle,3.13747715950012,4,4,7496,100
4182,92,0.188961971107905,idd80ac2b4,left_wrist,3.03967213630676,1,9,4183,100
4177,100,0.266688485697158,idd80ac2b4,left_hip,2.86206579208374,6,6,4183,100
4179,101,0.713305449504475,idd80ac2b4,left_ankle,2.781329870224,4,3,4183,100
4178,101,0.679507726977289,idd80ac2b4,right_ankle,3.13747715950012,5,4,4183,100
1246,103,0.175110985982483,idd80ac2b4,left_wrist,3.03967213630676,9,4,1255,98
1247,100,0.296298121711741,idd80ac2b4,left_hip,2.86206579208374,8,6,1255,98
1251,99,0.725713585573098,idd80ac2b4,left_ankle,2.781329870224,4,3,1255,98
1250,101,0.695051231866832,idd80ac2b4,right_ankle,3.13747715950012,5,2,1255,98
1739,99,0.169755682033743,idd80ac2b4,left_wrist,3.03967213630676,5,5,1744,99
1738,99,0.258421329205398,idd80ac2b4,left_hip,2.86206579208374,6,6,1744,99
1740,99,0.718268974100528,idd80ac2b4,left_ankle,2.781329870224,4,4,1744,99
1741,99,0.696715901835984,idd80ac2b4,right_ankle,3.13747715950012,3,3,1744,99
5561,92,0.173298047272211,idd80ac2b4,left_wrist,3.03967213630676,-2,4,5559,98
5554,98,0.297190572652207,idd80ac2b4,left_hip,2.86206579208374,5,5,5559,98
5556,97,0.743114006499688,idd80ac2b4,left_ankle,2.781329870224,3,4,5559,98
5557,97,0.758694323973697,idd80ac2b4,right_ankle,3.13747715950012,2,3,5559,98
8673,95,0.139236190692677,idd80ac2b4,left_wrist,3.03967213630676,-4,3,8669,102
8666,100,0.330889091242133,idd80ac2b4,left_hip,2.86206579208374,3,5,8669,102
8668,100,0.789575249167279,idd80ac2b4,left_ankle,2.781329870224,1,3,8669,102
8667,100,0.761144548123656,idd80ac2b4,right_ankle,3.13747715950012,2,4,8669,102
11107,101,0.22157546550374,idd80ac2b4,left_wrist,3.03967213630676,6,3,11113,98
11108,98,0.295046980260531,idd80ac2b4,left_hip,2.86206579208374,5,5,11113,98
11110,98,0.733444549969046,idd80ac2b4,left_ankle,2.781329870224,3,3,11113,98
11110,98,0.737907682112301,idd80ac2b4,right_ankle,3.13747715950012,3,3,11113,98
6811,98,0.208631512405087,idd80ac2b4,left_wrist,3.03967213630676,6,6,6817,98
6811,98,0.279885534002088,idd80ac2b4,left_hip,2.86206579208374,6,6,6817,98
6813,98,0.80666277795018,idd80ac2b4,left_ankle,2.781329870224,4,4,6817,98
6813,98,0.741453929352512,idd80ac2b4,right_ankle,3.13747715950012,4,4,6817,98
16136,102,0.342583671682182,id82b9735c,left_wrist,2.72957706451416,1,2,16137,103
16138,102,0.481005343733662,id82b9735c,left_hip,2.78390192985535,-1,0,16137,103
16137,102,0.855427192375144,id82b9735c,left_ankle,2.94228196144104,0,1,16137,103
16135,102,0.848303970549906,id82b9735c,right_ankle,2.93185210227966,2,3,16137,103
5150,111,0.31452970211223,id82b9735c,left_wrist,2.72957706451416,4,1,5154,108
5152,109,0.362457246246204,id82b9735c,left_hip,2.78390192985535,2,1,5154,108
5150,108,0.732584188400325,id82b9735c,left_ankle,2.94228196144104,4,4,5154,108
5152,108,0.75897300463013,id82b9735c,right_ankle,2.93185210227966,2,2,5154,108
8042,105,0.309662882970765,id82b9735c,left_wrist,2.72957706451416,0,1,8042,106
8040,106,0.382542594111426,id82b9735c,left_hip,2.78390192985535,2,2,8042,106
8041,104,0.720248478973695,id82b9735c,left_ankle,2.94228196144104,1,3,8042,106
8038,107,0.801105877651023,id82b9735c,right_ankle,2.93185210227966,4,3,8042,106
5831,106,0.277807922610892,id82b9735c,left_wrist,2.72957706451416,0,2,5831,108
5830,108,0.372539478263898,id82b9735c,left_hip,2.78390192985535,1,1,5831,108
5831,108,0.77660201415744,id82b9735c,left_ankle,2.94228196144104,0,0,5831,108
5829,108,0.809343321469381,id82b9735c,right_ankle,2.93185210227966,2,2,5831,108
11481,105,0.283182617944632,id82b9735c,left_wrist,2.72957706451416,1,2,11482,106
11480,106,0.401244762163869,id82b9735c,left_hip,2.78390192985535,2,2,11482,106
11481,106,0.74756416792014,id82b9735c,left_ankle,2.94228196144104,1,1,11482,106
11479,104,0.714035584627683,id82b9735c,right_ankle,2.93185210227966,3,5,11482,106
4622,109,0.287587200242433,id82b9735c,left_wrist,2.72957706451416,4,4,4626,109
4624,108,0.367632341338739,id82b9735c,left_hip,2.78390192985535,2,3,4626,109
4625,108,0.742916358478712,id82b9735c,left_ankle,2.94228196144104,1,2,4626,109
4624,107,0.795251740577039,id82b9735c,right_ankle,2.93185210227966,2,4,4626,109
8471,98,0.235621506226043,id82b9735c,left_wrist,2.72957706451416,-2,7,8469,107
8469,106,0.405741052381722,id82b9735c,left_hip,2.78390192985535,0,1,8469,107
8468,108,0.839026649782486,id82b9735c,left_ankle,2.94228196144104,1,0,8469,107
8468,103,0.815411177928242,id82b9735c,right_ankle,2.93185210227966,1,5,8469,107
13429,102,0.297863781623548,id82b9735c,left_wrist,2.72957706451416,1,-2,13430,99
13429,102,0.473525896252408,id82b9735c,left_hip,2.78390192985535,1,-2,13430,99
13429,101,0.796861785153181,id82b9735c,left_ankle,2.94228196144104,1,-1,13430,99
13426,102,0.827049947490988,id82b9735c,right_ankle,2.93185210227966,4,1,13430,99
1521,111,0.348067971525263,id82b9735c,left_wrist,2.72957706451416,2,-2,1523,107
1520,108,0.397095924992713,id82b9735c,left_hip,2.78390192985535,3,2,1523,107
1522,104,0.747198298900773,id82b9735c,left_ankle,2.94228196144104,1,4,1523,107
1519,109,0.720915733003337,id82b9735c,right_ankle,2.93185210227966,4,2,1523,107
15330,101,0.42862279682977,id82b9735c,left_wrist,2.72957706451416,2,1,15332,100
15331,100,0.477986187198683,id82b9735c,left_hip,2.78390192985535,1,1,15332,100
15331,100,0.871087363695213,id82b9735c,left_ankle,2.94228196144104,1,1,15332,100
15328,102,0.828111970335885,id82b9735c,right_ankle,2.93185210227966,4,2,15332,100
5936,105,0.29800228870202,id82b9735c,left_wrist,2.72957706451416,2,4,5938,107
5937,107,0.377855627990887,id82b9735c,left_hip,2.78390192985535,1,1,5938,107
5938,107,0.801423474869191,id82b9735c,left_ankle,2.94228196144104,0,0,5938,107
5936,107,0.759555663680371,id82b9735c,right_ankle,2.93185210227966,2,2,5938,107
14727,103,0.39532284951533,id82b9735c,left_wrist,2.72957706451416,2,0,14729,101
14729,100,0.472159310149271,id82b9735c,left_hip,2.78390192985535,0,1,14729,101
14728,103,0.847902155039595,id82b9735c,left_ankle,2.94228196144104,1,-1,14729,101
14726,103,0.827314091920855,id82b9735c,right_ankle,2.93185210227966,3,1,14729,101
6147,108,0.286933382643581,id82b9735c,left_wrist,2.72957706451416,2,1,6149,107
6148,106,0.369232581710731,id82b9735c,left_hip,2.78390192985535,1,2,6149,107
6149,107,0.775756810578759,id82b9735c,left_ankle,2.94228196144104,0,0,6149,107
6147,106,0.821678908919425,id82b9735c,right_ankle,2.93185210227966,2,3,6149,107
5936,105,0.29800228870202,id82b9735c,left_wrist,2.72957706451416,2,4,5938,107
5937,107,0.377855627990887,id82b9735c,left_hip,2.78390192985535,1,1,5938,107
5938,107,0.801423474869191,id82b9735c,left_ankle,2.94228196144104,0,0,5938,107
5936,107,0.759555663680371,id82b9735c,right_ankle,2.93185210227966,2,2,5938,107
8361,111,0.332550325194958,id82b9735c,left_wrist,2.72957706451416,2,-1,8363,108
8361,109,0.385982387730142,id82b9735c,left_hip,2.78390192985535,2,1,8363,108
8362,107,0.658604935815321,id82b9735c,left_ankle,2.94228196144104,1,2,8363,108
8360,109,0.711920375362492,id82b9735c,right_ankle,2.93185210227966,3,2,8363,108
15733,103,0.387740178448213,id82b9735c,left_wrist,2.72957706451416,0,-1,15733,102
15734,101,0.471977400633789,id82b9735c,left_hip,2.78390192985535,-1,0,15733,102
15733,102,0.779764309011635,id82b9735c,left_ankle,2.94228196144104,0,0,15733,102
15728,106,0.774261216179771,id82b9735c,right_ankle,2.93185210227966,5,1,15733,102
15131,102,0.32755554032249,id82b9735c,left_wrist,2.72957706451416,0,0,15131,102
15132,101,0.494640576085422,id82b9735c,left_hip,2.78390192985535,-1,0,15131,102
15131,101,0.816889710372619,id82b9735c,left_ankle,2.94228196144104,0,1,15131,102
15129,98,0.832643964011277,id82b9735c,right_ankle,2.93185210227966,2,6,15131,102
6875,103,0.359393737362276,id82b9735c,left_wrist,2.72957706451416,2,5,6877,106
6875,106,0.367627406818065,id82b9735c,left_hip,2.78390192985535,2,2,6877,106
6877,106,0.820058519751615,id82b9735c,left_ankle,2.94228196144104,0,0,6877,106
6873,107,0.702828033031566,id82b9735c,right_ankle,2.93185210227966,4,3,6877,106
13731,101,0.275202753156039,id82b9735c,left_wrist,2.72957706451416,-1,-1,13730,101
13732,99,0.474717042219103,id82b9735c,left_hip,2.78390192985535,-2,0,13730,101
13729,102,0.819302770993375,id82b9735c,left_ankle,2.94228196144104,1,0,13730,101
13728,97,0.854653885985566,id82b9735c,right_ankle,2.93185210227966,2,6,13730,101
16836,103,0.370247580897961,id82b9735c,left_wrist,2.72957706451416,2,1,16838,102
16837,103,0.445899283987849,id82b9735c,left_hip,2.78390192985535,1,0,16838,102
16838,103,0.850034218687879,id82b9735c,left_ankle,2.94228196144104,0,-1,16838,102
16833,108,0.835352531998394,id82b9735c,right_ankle,2.93185210227966,5,-1,16838,102
8903,109,0.153769134914344,id8af5374b,left_wrist,3.12656998634338,-3,-4,8900,108
8894,105,0.183173334945219,id8af5374b,left_hip,3.14474296569824,6,9,8900,108
8899,106,0.677485743899156,id8af5374b,left_ankle,2.89627909660339,1,3,8900,108
8898,112,0.756727116628134,id8af5374b,right_ankle,3.09780311584473,2,-2,8900,108
14485,112,0.209629449377813,id8af5374b,left_wrist,3.12656998634338,-2,-5,14483,109
14475,111,0.272896039338799,id8af5374b,left_hip,3.14474296569824,8,6,14483,109
14481,110,0.69400187841545,id8af5374b,left_ankle,2.89627909660339,2,1,14483,109
14483,109,0.683157917561221,id8af5374b,right_ankle,3.09780311584473,0,0,14483,109
8127,113,0.161472284558718,id8af5374b,left_wrist,3.12656998634338,-3,-4,8124,112
8117,111,0.210003795121699,id8af5374b,left_hip,3.14474296569824,7,8,8124,112
8122,113,0.717082700982738,id8af5374b,left_ankle,2.89627909660339,2,1,8124,112
8123,112,0.787410729347704,id8af5374b,right_ankle,3.09780311584473,1,1,8124,112
6688,114,0.169848437350387,id8af5374b,left_wrist,3.12656998634338,-2,-4,6686,112
6677,114,0.26405894357819,id8af5374b,left_hip,3.14474296569824,9,7,6686,112
6684,113,0.719712973290656,id8af5374b,left_ankle,2.89627909660339,2,1,6686,112
6682,115,0.728428041939334,id8af5374b,right_ankle,3.09780311584473,4,1,6686,112
15372,111,0.227540399418934,id8af5374b,left_wrist,3.12656998634338,-5,-4,15367,112
15360,112,0.267830281838858,id8af5374b,left_hip,3.14474296569824,7,7,15367,112
15366,112,0.687107190306335,id8af5374b,left_ankle,2.89627909660339,1,1,15367,112
15365,113,0.698574626837483,id8af5374b,right_ankle,3.09780311584473,2,1,15367,112
4171,106,0.184155724956143,id8af5374b,left_wrist,3.12656998634338,-2,2,4169,110
4161,111,0.254991372636557,id8af5374b,left_hip,3.14474296569824,8,7,4169,110
4167,109,0.647044710171041,id8af5374b,left_ankle,2.89627909660339,2,3,4169,110
4168,109,0.739902667927212,id8af5374b,right_ankle,3.09780311584473,1,2,4169,110
14485,112,0.209629449377813,id8af5374b,left_wrist,3.12656998634338,-2,-5,14483,109
14475,111,0.272896039338799,id8af5374b,left_hip,3.14474296569824,8,6,14483,109
14481,110,0.69400187841545,id8af5374b,left_ankle,2.89627909660339,2,1,14483,109
14483,109,0.683157917561221,id8af5374b,right_ankle,3.09780311584473,0,0,14483,109
2525,112,0.176346847932135,id8af5374b,left_wrist,3.12656998634338,-3,-3,2522,112
2516,112,0.251518829634016,id8af5374b,left_hip,3.14474296569824,6,6,2522,112
2521,112,0.755946208148647,id8af5374b,left_ankle,2.89627909660339,1,1,2522,112
2522,109,0.776119318617476,id8af5374b,right_ankle,3.09780311584473,0,3,2522,112
5041,109,0.137152427797616,id8af5374b,left_wrist,3.12656998634338,0,-1,5041,108
5033,109,0.255403349546435,id8af5374b,left_hip,3.14474296569824,8,7,5041,108
5038,107,0.667501264429676,id8af5374b,left_ankle,2.89627909660339,3,4,5041,108
5039,110,0.791767623785307,id8af5374b,right_ankle,3.09780311584473,2,0,5041,108
2954,125,0.144628840204041,id8af5374b,left_wrist,3.12656998634338,10,-4,2964,111
2956,113,0.246044375045467,id8af5374b,left_hip,3.14474296569824,8,6,2964,111
2962,113,0.724483178436126,id8af5374b,left_ankle,2.89627909660339,2,0,2964,111
2963,111,0.804231800272967,id8af5374b,right_ankle,3.09780311584473,1,1,2964,111
4936,106,0.189427208437747,id8af5374b,left_wrist,3.12656998634338,-3,1,4933,110
4926,108,0.233217589085159,id8af5374b,left_hip,3.14474296569824,7,9,4933,110
4932,107,0.760414179244544,id8af5374b,left_ankle,2.89627909660339,1,4,4933,110
4931,109,0.697446421027653,id8af5374b,right_ankle,3.09780311584473,2,3,4933,110
1330,109,0.171469873011836,id8af5374b,left_wrist,3.12656998634338,-3,-3,1327,109
1320,109,0.2458487532872,id8af5374b,left_hip,3.14474296569824,7,7,1327,109
1325,109,0.69393473133713,id8af5374b,left_ankle,2.89627909660339,2,2,1327,109
1326,110,0.716608406352961,id8af5374b,right_ankle,3.09780311584473,1,0,1327,109
13037,114,0.200644740306384,id8af5374b,left_wrist,3.12656998634338,-6,-6,13031,114
13025,115,0.258782434245565,id8af5374b,left_hip,3.14474296569824,6,5,13031,114
13032,114,0.701994265558276,id8af5374b,left_ankle,2.89627909660339,-1,-1,13031,114
13031,114,0.785431773690567,id8af5374b,right_ankle,3.09780311584473,0,0,13031,114
17879,110,0.199219717947817,id8af5374b,left_wrist,3.12656998634338,-4,-3,17875,111
17868,111,0.271919025907998,id8af5374b,left_hip,3.14474296569824,7,7,17875,111
17874,111,0.676455997560605,id8af5374b,left_ankle,2.89627909660339,1,1,17875,111
17875,110,0.719756466749353,id8af5374b,right_ankle,3.09780311584473,0,1,17875,111
15809,110,0.222064481009822,id8af5374b,left_wrist,3.12656998634338,-4,-3,15805,111
15797,110,0.294189572777464,id8af5374b,left_hip,3.14474296569824,8,9,15805,111
15804,109,0.749593702612363,id8af5374b,left_ankle,2.89627909660339,1,3,15805,111
15804,111,0.73105113893265,id8af5374b,right_ankle,3.09780311584473,1,1,15805,111
16137,112,0.242351144960363,id8af5374b,left_wrist,3.12656998634338,-2,-5,16135,109
16127,110,0.287655303975552,id8af5374b,left_hip,3.14474296569824,8,7,16135,109
16133,110,0.684289281857873,id8af5374b,left_ankle,2.89627909660339,2,1,16135,109
16134,110,0.748056271166107,id8af5374b,right_ankle,3.09780311584473,1,0,16135,109
9233,118,0.167000291301357,id8af5374b,left_wrist,3.12656998634338,-2,-5,9231,115
9225,115,0.2348868492577,id8af5374b,left_hip,3.14474296569824,6,6,9231,115
9230,115,0.729491219471098,id8af5374b,left_ankle,2.89627909660339,1,1,9231,115
9226,118,0.78377100130733,id8af5374b,right_ankle,3.09780311584473,5,2,9231,115
8350,109,0.141041123797123,id8af5374b,left_wrist,3.12656998634338,-5,-3,8345,111
8338,111,0.216451821809209,id8af5374b,left_hip,3.14474296569824,7,7,8345,111
8344,110,0.637463754465819,id8af5374b,left_ankle,2.89627909660339,1,2,8345,111
8344,110,0.74688954095677,id8af5374b,right_ankle,3.09780311584473,1,2,8345,111
16466,111,0.263985160718168,id8af5374b,left_wrist,3.12656998634338,-3,-4,16463,110
16455,110,0.241766673041451,id8af5374b,left_hip,3.14474296569824,8,8,16463,110
16461,111,0.685514137548387,id8af5374b,left_ankle,2.89627909660339,2,1,16463,110
16462,111,0.705821687646313,id8af5374b,right_ankle,3.09780311584473,1,0,16463,110
12258,111,0.181242720731457,id8af5374b,left_wrist,3.12656998634338,-5,-6,12253,110
12246,111,0.245145696408021,id8af5374b,left_hip,3.14474296569824,7,6,12253,110
12252,111,0.763528394633816,id8af5374b,left_ankle,2.89627909660339,1,0,12253,110
12252,111,0.791446306891593,id8af5374b,right_ankle,3.09780311584473,1,0,12253,110
14704,109,0.247636024097762,id650857ca,left_wrist,3.63667607307434,-51,-52,14653,108
14653,107,0.244670066626797,id650857ca,left_hip,3.99069404602051,0,1,14653,108
14652,108,0.604152116192866,id650857ca,left_ankle,4.62079405784607,1,1,14653,108
14653,110,0.611843765058533,id650857ca,right_ankle,3.72305107116699,0,-2,14653,108
7856,111,0.189636018166567,id650857ca,left_wrist,3.63667607307434,54,53,7910,110
7913,107,0.261929924558601,id650857ca,left_hip,3.99069404602051,-3,0,7910,110
7910,109,0.570591124026044,id650857ca,left_ankle,4.62079405784607,0,1,7910,110
7913,107,0.582972413953783,id650857ca,right_ankle,3.72305107116699,-3,0,7910,110
6088,109,0.171943009324155,id650857ca,left_wrist,3.63667607307434,50,50,6138,109
6139,108,0.216034590798647,id650857ca,left_hip,3.99069404602051,-1,0,6138,109
6137,108,0.486233685098513,id650857ca,left_ankle,4.62079405784607,1,2,6138,109
6139,108,0.510289281729215,id650857ca,right_ankle,3.72305107116699,-1,0,6138,109
22100,110,0.219265411941272,id650857ca,left_wrist,3.63667607307434,49,53,22149,114
22156,109,0.197128979683984,id650857ca,left_hip,3.99069404602051,-7,-2,22149,114
22154,115,0.491394899198999,id650857ca,left_ankle,4.62079405784607,-5,-6,22149,114
22157,115,0.44196313473421,id650857ca,right_ankle,3.72305107116699,-8,-9,22149,114
14077,100,0.273960057435148,id650857ca,left_wrist,3.63667607307434,47,56,14124,109
14125,107,0.243606334478071,id650857ca,left_hip,3.99069404602051,-1,1,14124,109
14124,109,0.555200006217218,id650857ca,left_ankle,4.62079405784607,0,0,14124,109
14125,108,0.562729863799488,id650857ca,right_ankle,3.72305107116699,-1,0,14124,109
4820,113,0.141612106756333,id650857ca,left_wrist,3.63667607307434,-2,-4,4818,111
4817,113,0.216108318977509,id650857ca,left_hip,3.99069404602051,1,-1,4818,111
4815,113,0.53545429467813,id650857ca,left_ankle,4.62079405784607,3,1,4818,111
4820,110,0.50807484575203,id650857ca,right_ankle,3.72305107116699,-2,-1,4818,111
2985,110,0.183244196349814,id650857ca,left_wrist,3.63667607307434,-6,-4,2979,112
2976,114,0.254998448989942,id650857ca,left_hip,3.99069404602051,3,1,2979,112
2980,108,0.531738822399944,id650857ca,left_ankle,4.62079405784607,-1,3,2979,112
2981,108,0.599990611861922,id650857ca,right_ankle,3.72305107116699,-2,2,2979,112
10671,116,0.257084526021072,id650857ca,left_wrist,3.63667607307434,2,-6,10673,108
10672,111,0.269532692157238,id650857ca,left_hip,3.99069404602051,1,-2,10673,108
10672,110,0.592739408557391,id650857ca,left_ankle,4.62079405784607,1,-1,10673,108
10674,111,0.609005877767805,id650857ca,right_ankle,3.72305107116699,-1,-4,10673,108
20609,103,0.322602894183355,id650857ca,left_wrist,3.63667607307434,48,51,20657,106
20660,109,0.264798486544119,id650857ca,left_hip,3.99069404602051,-3,-6,20657,106
20656,107,0.593003798356499,id650857ca,left_ankle,4.62079405784607,1,0,20657,106
20654,109,0.547620919200318,id650857ca,right_ankle,3.72305107116699,3,0,20657,106
13396,99,0.419287983057118,id650857ca,left_wrist,3.63667607307434,-8,2,13388,109
13390,107,0.257160257105429,id650857ca,left_hip,3.99069404602051,-2,0,13388,109
13387,108,0.485129263736396,id650857ca,left_ankle,4.62079405784607,1,2,13388,109
13389,107,0.57591715459501,id650857ca,right_ankle,3.72305107116699,-1,1,13388,109
21777,108,0.24855845247374,id650857ca,left_wrist,3.63667607307434,52,51,21829,107
21830,108,0.244907765337187,id650857ca,left_hip,3.99069404602051,-1,-2,21829,107
21828,108,0.54957423866998,id650857ca,left_ankle,4.62079405784607,1,0,21829,107
21828,111,0.562454655045263,id650857ca,right_ankle,3.72305107116699,1,-3,21829,107
16333,109,0.162722315711215,id650857ca,left_wrist,3.63667607307434,49,48,16382,108
16384,109,0.237324488312234,id650857ca,left_hip,3.99069404602051,-2,-3,16382,108
16382,108,0.532903284606372,id650857ca,left_ankle,4.62079405784607,0,0,16382,108
16383,107,0.545345364161954,id650857ca,right_ankle,3.72305107116699,-1,0,16382,108
7966,107,0.297095764771592,id650857ca,left_wrist,3.63667607307434,53,51,8019,105
8072,103,0.293872724573057,id650857ca,left_wrist,3.63667607307434,-53,-51,8019,105
8019,105,0.292288037480875,id650857ca,left_hip,3.99069404602051,0,0,8019,105
8018,105,0.616821442520535,id650857ca,left_ankle,4.62079405784607,1,1,8019,105
8019,102,0.652238717725025,id650857ca,right_ankle,3.72305107116699,0,3,8019,105
9723,124,0.228194778132885,id650857ca,left_wrist,3.63667607307434,-52,-65,9671,111
9671,108,0.209385894472856,id650857ca,left_hip,3.99069404602051,0,3,9671,111
9671,108,0.512627364222625,id650857ca,left_ankle,4.62079405784607,0,3,9671,111
9671,117,0.490199835504402,id650857ca,right_ankle,3.72305107116699,0,-6,9671,111
3526,112,0.205467263924902,id650857ca,left_wrist,3.63667607307434,-6,-7,3520,111
3519,109,0.218566347188927,id650857ca,left_hip,3.99069404602051,1,3,3520,111
3519,112,0.494722063345299,id650857ca,left_ankle,4.62079405784607,1,0,3520,111
3522,111,0.479157881728739,id650857ca,right_ankle,3.72305107116699,-2,-2,3520,111
259,104,0.276916797959288,id650857ca,left_wrist,3.63667607307434,47,47,306,104
307,101,0.296941876466707,id650857ca,left_hip,3.99069404602051,-1,2,306,104
306,102,0.638558054970751,id650857ca,left_ankle,4.62079405784607,0,2,306,104
302,105,0.608011589785198,id650857ca,right_ankle,3.72305107116699,4,3,306,104
15918,103,0.21117097806761,id650857ca,left_wrist,3.63667607307434,48,49,15966,104
15968,103,0.284879853913852,id650857ca,left_hip,3.99069404602051,-2,-1,15966,104
15965,104,0.612575571424407,id650857ca,left_ankle,4.62079405784607,1,1,15966,104
15963,103,0.564887185592782,id650857ca,right_ankle,3.72305107116699,3,4,15966,104
2341,107,0.223166196449331,id650857ca,left_wrist,3.63667607307434,-6,-5,2335,108
2336,107,0.241493538091251,id650857ca,left_hip,3.99069404602051,-1,0,2335,108
2335,105,0.499604752984885,id650857ca,left_ankle,4.62079405784607,0,3,2335,108
2335,107,0.586658437875404,id650857ca,right_ankle,3.72305107116699,0,1,2335,108
10016,54,0.149769355854405,id650857ca,left_wrist,3.63667607307434,1,57,10017,110
10017,111,0.272809676069005,id650857ca,left_hip,3.99069404602051,0,-1,10017,110
10017,110,0.572759768437221,id650857ca,left_ankle,4.62079405784607,0,0,10017,110
10018,111,0.596946344241458,id650857ca,right_ankle,3.72305107116699,-1,-2,10017,110
14390,61,0.140946067595638,id650857ca,left_wrist,3.63667607307434,-51,-6,14339,106
14339,107,0.282731011204319,id650857ca,left_hip,3.99069404602051,0,-1,14339,106
14339,106,0.6268877804331,id650857ca,left_ankle,4.62079405784607,0,0,14339,106
14338,104,0.646206535065863,id650857ca,right_ankle,3.72305107116699,1,3,14339,106
20217,93,0.247151963689068,idff99de96,left_wrist,3.43164706230164,4,11,20221,100
20221,100,0.346648703817252,idff99de96,left_hip,3.06392598152161,0,0,20221,100
20218,99,0.706560857038898,idff99de96,left_ankle,3.44731116294861,3,4,20221,100
20218,102,0.800318452569876,idff99de96,right_ankle,3.13102412223816,3,1,20221,100
10143,137,0.386261665046152,idff99de96,left_wrist,3.43164706230164,-8,-46,10135,99
10142,93,0.390030354902729,idff99de96,left_hip,3.06392598152161,-7,-1,10135,99
10132,99,0.799080945429292,idff99de96,left_ankle,3.44731116294861,3,3,10135,99
10130,100,0.864122720166371,idff99de96,right_ankle,3.13102412223816,5,4,10135,99
9942,100,0.386596062368428,idff99de96,left_wrist,3.43164706230164,-12,-8,9930,104
9927,104,0.286834422126762,idff99de96,left_hip,3.06392598152161,3,3,9930,104
9927,103,0.723999016335774,idff99de96,left_ankle,3.44731116294861,3,4,9930,104
9928,103,0.788484573969241,idff99de96,right_ankle,3.13102412223816,2,3,9930,104
3586,109,0.29223681162084,idff99de96,left_wrist,3.43164706230164,6,7,3592,110
3592,113,0.403507049723264,idff99de96,left_hip,3.06392598152161,0,-3,3592,110
3591,109,0.634016093410604,idff99de96,left_ankle,3.44731116294861,1,2,3592,110
3593,109,0.788234072051407,idff99de96,right_ankle,3.13102412223816,-1,0,3592,110
15429,103,0.29562145302039,idff99de96,left_wrist,3.43164706230164,1,0,15430,102
15430,103,0.27820840102215,idff99de96,left_hip,3.06392598152161,0,-1,15430,102
15428,104,0.609608561361655,idff99de96,left_ankle,3.44731116294861,2,0,15430,102
15428,102,0.706526474403202,idff99de96,right_ankle,3.13102412223816,2,2,15430,102
9308,99,0.194607041473912,idff99de96,left_wrist,3.43164706230164,5,4,9313,98
9307,102,0.327205888884461,idff99de96,left_hip,3.06392598152161,6,2,9313,98
9309,101,0.733789978950366,idff99de96,left_ankle,3.44731116294861,4,1,9313,98
9308,104,0.738517922061715,idff99de96,right_ankle,3.13102412223816,5,-1,9313,98
10448,99,0.304579454467655,idff99de96,left_wrist,3.43164706230164,-15,-10,10433,104
10432,106,0.353430336982962,idff99de96,left_hip,3.06392598152161,1,-1,10433,104
10432,102,0.742848836438445,idff99de96,left_ankle,3.44731116294861,1,3,10433,104
10433,103,0.858625397219171,idff99de96,right_ankle,3.13102412223816,0,1,10433,104
4371,118,0.427624523642729,idff99de96,left_wrist,3.43164706230164,-47,-60,4324,105
4322,110,0.355946838560125,idff99de96,left_hip,3.06392598152161,2,-3,4324,105
4322,104,0.7782259502821,idff99de96,left_ankle,3.44731116294861,2,3,4324,105
4324,101,0.801765626539294,idff99de96,right_ankle,3.13102412223816,0,4,4324,105
4735,54,0.0724581869268494,idff99de96,left_wrist,3.43164706230164,1,46,4736,99
4734,101,0.370427500751663,idff99de96,left_hip,3.06392598152161,2,0,4736,99
4733,101,0.693728286604762,idff99de96,left_ankle,3.44731116294861,3,1,4736,99
4732,102,0.892244210188705,idff99de96,right_ankle,3.13102412223816,4,1,4736,99
12157,100,0.284436770326313,idff99de96,left_wrist,3.43164706230164,-10,-8,12147,102
12145,103,0.350800101501874,idff99de96,left_hip,3.06392598152161,2,1,12147,102
12145,101,0.791986030683663,idff99de96,left_ankle,3.44731116294861,2,3,12147,102
12144,103,0.865519698102018,idff99de96,right_ankle,3.13102412223816,3,2,12147,102
11756,103,0.355628467664671,idff99de96,left_wrist,3.43164706230164,-13,-14,11743,102
11743,102,0.332175444306959,idff99de96,left_hip,3.06392598152161,0,0,11743,102
11742,102,0.627389834151056,idff99de96,left_ankle,3.44731116294861,1,1,11743,102
11743,100,0.883157370102681,idff99de96,right_ankle,3.13102412223816,0,2,11743,102
1743,101,0.215003125087818,idff99de96,left_wrist,3.43164706230164,-40,-41,1703,100
1700,102,0.37824948863489,idff99de96,left_hip,3.06392598152161,3,1,1703,100
1698,101,0.742497963642866,idff99de96,left_ankle,3.44731116294861,5,4,1703,100
1698,101,0.799571425837791,idff99de96,right_ankle,3.13102412223816,5,4,1703,100
874,108,0.267267868213534,idff99de96,left_wrist,3.43164706230164,2,6,876,112
875,113,0.313163416019353,idff99de96,left_hip,3.06392598152161,1,0,876,112
870,116,0.707595886885467,idff99de96,left_ankle,3.44731116294861,6,2,876,112
880,107,0.754947272512424,idff99de96,right_ankle,3.13102412223816,-4,1,876,112
13141,105,0.323737086706685,idff99de96,left_wrist,3.43164706230164,3,1,13144,103
13142,103,0.378532381370681,idff99de96,left_hip,3.06392598152161,2,2,13144,103
13142,103,0.749123224082139,idff99de96,left_ankle,3.44731116294861,2,2,13144,103
13143,101,0.837154778903695,idff99de96,right_ankle,3.13102412223816,1,3,13144,103
18931,94,0.177681205374146,idff99de96,left_wrist,3.43164706230164,2,4,18933,96
18937,97,0.322745804579818,idff99de96,left_hip,3.06392598152161,-4,-5,18933,96
18930,99,0.717837850906936,idff99de96,left_ankle,3.44731116294861,3,0,18933,96
18931,97,0.740657191120731,idff99de96,right_ankle,3.13102412223816,2,1,18933,96
12256,102,0.298829710489268,idff99de96,left_wrist,3.43164706230164,-8,-6,12248,104
12247,101,0.33519806914426,idff99de96,left_hip,3.06392598152161,1,4,12248,104
12245,103,0.754174366052467,idff99de96,left_ankle,3.44731116294861,3,4,12248,104
12246,102,0.827508316048114,idff99de96,right_ankle,3.13102412223816,2,4,12248,104
11456,95,0.326285617842816,idff99de96,left_wrist,3.43164706230164,-11,-5,11445,101
11445,99,0.390313889539367,idff99de96,left_hip,3.06392598152161,0,2,11445,101
11444,99,0.685339540013444,idff99de96,left_ankle,3.44731116294861,1,3,11445,101
11442,99,0.914398792972305,idff99de96,right_ankle,3.13102412223816,3,5,11445,101
10758,97,0.418108334389303,idff99de96,left_wrist,3.43164706230164,-19,-8,10739,108
10740,105,0.344527643677374,idff99de96,left_hip,3.06392598152161,-1,2,10739,108
10740,104,0.776560404191053,idff99de96,left_ankle,3.44731116294861,-1,3,10739,108
10743,101,0.844150760149369,idff99de96,right_ankle,3.13102412223816,-4,3,10739,108
20018,103,0.332065979335648,idff99de96,left_wrist,3.43164706230164,2,1,20020,102
20021,101,0.365374528662615,idff99de96,left_hip,3.06392598152161,-1,0,20020,102
20018,102,0.745920325961877,idff99de96,left_ankle,3.44731116294861,2,2,20020,102
20017,103,0.933225797540643,idff99de96,right_ankle,3.13102412223816,3,2,20020,102
10322,86,0.251515195305305,idff99de96,left_wrist,3.43164706230164,10,26,10332,102
10328,105,0.386158936240678,idff99de96,left_hip,3.06392598152161,4,1,10332,102
10327,106,0.711549554615582,idff99de96,left_ankle,3.44731116294861,5,1,10332,102
10329,105,0.890851479087221,idff99de96,right_ankle,3.13102412223816,3,0,10332,102
12547,93,0.180488393618197,id4ea159a8,left_wrist,2.97901105880737,-1,0,12546,94
12545,96,0.354643328305123,id4ea159a8,left_hip,2.84662508964539,1,-1,12546,94
12544,96,0.84601573205221,id4ea159a8,left_ankle,2.81296896934509,2,0,12546,94
12544,96,0.772392615537825,id4ea159a8,right_ankle,2.86269116401672,2,0,12546,94
11019,96,0.208024330546928,id4ea159a8,left_wrist,2.97901105880737,-4,-1,11015,99
11016,98,0.340312883686248,id4ea159a8,left_hip,2.84662508964539,-1,0,11015,99
11015,98,0.796144070850539,id4ea159a8,left_ankle,2.81296896934509,0,1,11015,99
11014,97,0.743903801495109,id4ea159a8,right_ankle,2.86269116401672,1,3,11015,99
4380,92,0.203943238445171,id4ea159a8,left_wrist,2.97901105880737,0,4,4380,96
4381,95,0.441184054550598,id4ea159a8,left_hip,2.84662508964539,-1,0,4380,96
4379,96,0.926900136725713,id4ea159a8,left_ankle,2.81296896934509,1,1,4380,96
4377,96,0.79617675765783,id4ea159a8,right_ankle,2.86269116401672,3,3,4380,96
4758,97,0.180232822602407,id4ea159a8,left_wrist,2.97901105880737,0,0,4758,97
4759,97,0.425508521157029,id4ea159a8,left_hip,2.84662508964539,-1,-1,4758,97
4756,98,0.875428630351362,id4ea159a8,left_ankle,2.81296896934509,2,1,4758,97
4756,96,0.765141423774755,id4ea159a8,right_ankle,2.86269116401672,2,3,4758,97
13398,91,0.205339887369631,id4ea159a8,left_wrist,2.97901105880737,-4,0,13394,95
13396,94,0.385464451052382,id4ea159a8,left_hip,2.84662508964539,-2,-1,13394,95
13393,97,0.804035392067656,id4ea159a8,left_ankle,2.81296896934509,1,-1,13394,95
13393,95,0.734636028067381,id4ea159a8,right_ankle,2.86269116401672,1,1,13394,95
8356,95,0.280550903392843,id4ea159a8,left_wrist,2.97901105880737,1,1,8357,95
8357,95,0.381601407258985,id4ea159a8,left_hip,2.84662508964539,0,0,8357,95
8356,96,0.792298710569829,id4ea159a8,left_ankle,2.81296896934509,1,0,8357,95
8353,96,0.657501016933703,id4ea159a8,right_ankle,2.86269116401672,4,3,8357,95
3242,97,0.190206329958568,id4ea159a8,left_wrist,2.97901105880737,2,-3,3244,92
3243,95,0.376153794139179,id4ea159a8,left_hip,2.84662508964539,1,-2,3244,92
3243,93,0.876854344219994,id4ea159a8,left_ankle,2.81296896934509,1,0,3244,92
3242,94,0.826636053418671,id4ea159a8,right_ankle,2.86269116401672,2,0,3244,92
13684,175,0.202757799811634,id4ea159a8,left_wrist,2.97901105880737,-7,-88,13677,94
13679,93,0.377797015407257,id4ea159a8,left_hip,2.84662508964539,-2,-1,13677,94
13676,94,0.802590844265511,id4ea159a8,left_ankle,2.81296896934509,1,1,13677,94
13676,95,0.796308071752252,id4ea159a8,right_ankle,2.86269116401672,1,0,13677,94
2002,104,0.240149719679013,id4ea159a8,left_wrist,2.97901105880737,7,-2,2009,95
2007,97,0.397288782617235,id4ea159a8,left_hip,2.84662508964539,2,0,2009,95
2007,95,0.822175415708049,id4ea159a8,left_ankle,2.81296896934509,2,2,2009,95
2007,95,0.787190466685245,id4ea159a8,right_ankle,2.86269116401672,2,2,2009,95
15873,93,0.115506421992396,id4ea159a8,left_wrist,2.97901105880737,-3,0,15870,96
15871,96,0.404355356499618,id4ea159a8,left_hip,2.84662508964539,-1,-1,15870,96
15869,96,0.849480372213095,id4ea159a8,left_ankle,2.81296896934509,1,1,15870,96
15869,97,0.799816855046752,id4ea159a8,right_ankle,2.86269116401672,1,0,15870,96
11304,98,0.20470854956814,id4ea159a8,left_wrist,2.97901105880737,2,-1,11306,95
11303,97,0.33282563947983,id4ea159a8,left_hip,2.84662508964539,3,1,11306,95
11304,96,0.810287462117056,id4ea159a8,left_ankle,2.81296896934509,2,1,11306,95
11303,96,0.73388740593544,id4ea159a8,right_ankle,2.86269116401672,3,2,11306,95
10349,97,0.185516987102552,id4ea159a8,left_wrist,2.97901105880737,-3,-3,10346,97
10346,97,0.364009103930797,id4ea159a8,left_hip,2.84662508964539,0,0,10346,97
10345,97,0.793425734770295,id4ea159a8,left_ankle,2.81296896934509,1,1,10346,97
10345,96,0.802737870215431,id4ea159a8,right_ankle,2.86269116401672,1,2,10346,97
6091,95,0.201017853083137,id4ea159a8,left_wrist,2.97901105880737,2,1,6093,94
6093,94,0.381139965820517,id4ea159a8,left_hip,2.84662508964539,0,0,6093,94
6091,95,0.891037064041214,id4ea159a8,left_ankle,2.81296896934509,2,1,6093,94
6091,95,0.827596866007732,id4ea159a8,right_ankle,2.86269116401672,2,1,6093,94
8450,97,0.237315822226189,id4ea159a8,left_wrist,2.97901105880737,1,0,8451,96
8451,96,0.354844492981587,id4ea159a8,left_hip,2.84662508964539,0,0,8451,96
8451,95,0.751898669931738,id4ea159a8,left_ankle,2.81296896934509,0,1,8451,96
8448,97,0.727432744697576,id4ea159a8,right_ankle,2.86269116401672,3,2,8451,96
9213,96,0.179938994806741,id4ea159a8,left_wrist,2.97901105880737,-1,1,9212,98
9215,95,0.33848463662225,id4ea159a8,left_hip,2.84662508964539,-3,0,9212,98
9212,97,0.771736365623855,id4ea159a8,left_ankle,2.81296896934509,0,1,9212,98
9211,97,0.754960178021658,id4ea159a8,right_ankle,2.86269116401672,1,2,9212,98
3338,92,0.218942293513671,id4ea159a8,left_wrist,2.97901105880737,-3,1,3335,96
3337,93,0.39094453579794,id4ea159a8,left_hip,2.84662508964539,-2,1,3335,96
3335,95,0.833576841370385,id4ea159a8,left_ankle,2.81296896934509,0,1,3335,96
3335,94,0.797609277364177,id4ea159a8,right_ankle,2.86269116401672,0,2,3335,96
9688,100,0.18481392161055,id4ea159a8,left_wrist,2.97901105880737,-1,-5,9687,96
9688,96,0.384328500705389,id4ea159a8,left_hip,2.84662508964539,-1,-1,9687,96
9687,95,0.808674899145308,id4ea159a8,left_ankle,2.81296896934509,0,1,9687,96
9687,94,0.787386749205753,id4ea159a8,right_ankle,2.86269116401672,0,2,9687,96
1443,97,0.187482565077736,id4ea159a8,left_wrist,2.97901105880737,0,-1,1443,96
1443,96,0.398702723272385,id4ea159a8,left_hip,2.84662508964539,0,0,1443,96
1442,96,0.841414659046327,id4ea159a8,left_ankle,2.81296896934509,1,1,1443,96
1442,95,0.820855813552768,id4ea159a8,right_ankle,2.86269116401672,1,2,1443,96
5234,94,0.194747858980296,id4ea159a8,left_wrist,2.97901105880737,-1,0,5233,95
5233,95,0.411995109432816,id4ea159a8,left_hip,2.84662508964539,0,0,5233,95
5232,95,0.831323477640606,id4ea159a8,left_ankle,2.81296896934509,1,1,5233,95
5230,96,0.884217731261521,id4ea159a8,right_ankle,2.86269116401672,3,2,5233,95
4001,95,0.187497100493208,id4ea159a8,left_wrist,2.97901105880737,-2,-1,3999,96
4000,95,0.354859376299694,id4ea159a8,left_hip,2.84662508964539,-1,0,3999,96
3997,97,0.802727927741801,id4ea159a8,left_ankle,2.81296896934509,2,1,3999,96
3997,96,0.842554953785408,id4ea159a8,right_ankle,2.86269116401672,2,2,3999,96
6022,116,0.252768415976977,idc91a49d0,left_wrist,3.29673910140991,1,0,6023,115
6024,113,0.274695722450249,idc91a49d0,left_hip,4.22204208374023,-1,1,6023,115
6022,114,0.576875766406273,idc91a49d0,left_ankle,3.69789814949036,1,2,6023,115
6018,115,0.591454401114608,idc91a49d0,right_ankle,3.87671494483948,5,5,6023,115
18683,110,0.207745061378919,idc91a49d0,left_wrist,3.29673910140991,-3,-4,18680,109
18680,110,0.316633252785799,idc91a49d0,left_hip,4.22204208374023,0,-1,18680,109
18681,109,0.643946648790242,idc91a49d0,left_ankle,3.69789814949036,-1,-1,18680,109
18681,108,0.728627964208412,idc91a49d0,right_ankle,3.87671494483948,-1,0,18680,109
9342,115,0.199410655952734,idc91a49d0,left_wrist,3.29673910140991,2,5,9344,118
9345,117,0.240698941941569,idc91a49d0,left_hip,4.22204208374023,-1,0,9344,118
9342,117,0.538556735555166,idc91a49d0,left_ankle,3.69789814949036,2,3,9344,118
9342,114,0.615591502671281,idc91a49d0,right_ankle,3.87671494483948,2,6,9344,118
16279,108,0.225461224686023,idc91a49d0,left_wrist,3.29673910140991,-5,-2,16274,111
16274,111,0.304883056944006,idc91a49d0,left_hip,4.22204208374023,0,0,16274,111
16273,112,0.735031824080131,idc91a49d0,left_ankle,3.69789814949036,1,0,16274,111
16275,108,0.740287624086266,idc91a49d0,right_ankle,3.87671494483948,-1,2,16274,111
18465,110,0.244239305678957,idc91a49d0,left_wrist,3.29673910140991,-4,-3,18461,111
18462,110,0.300923069841539,idc91a49d0,left_hip,4.22204208374023,-1,0,18461,111
18462,110,0.690435515712892,idc91a49d0,left_ankle,3.69789814949036,-1,0,18461,111
18462,109,0.690077066419915,idc91a49d0,right_ankle,3.87671494483948,-1,1,18461,111
8681,110,0.266414046094156,idc91a49d0,left_wrist,3.29673910140991,-2,-1,8679,111
8679,111,0.276395275213026,idc91a49d0,left_hip,4.22204208374023,0,0,8679,111
8677,112,0.682383500811113,idc91a49d0,left_ankle,3.69789814949036,2,1,8679,111
8677,111,0.655841736936933,idc91a49d0,right_ankle,3.87671494483948,2,2,8679,111
1379,109,0.203692313207116,idc91a49d0,left_wrist,3.29673910140991,0,5,1379,114
1379,113,0.275661833307971,idc91a49d0,left_hip,4.22204208374023,0,1,1379,114
1377,113,0.636183427597602,idc91a49d0,left_ankle,3.69789814949036,2,3,1379,114
1377,112,0.690205499729568,idc91a49d0,right_ankle,3.87671494483948,2,4,1379,114
7037,112,0.178469552375545,idc91a49d0,left_wrist,3.29673910140991,-1,-2,7036,111
7036,111,0.286030711620175,idc91a49d0,left_hip,4.22204208374023,0,0,7036,111
7034,112,0.650193828212563,idc91a49d0,left_ankle,3.69789814949036,2,1,7036,111
7035,111,0.673083376822175,idc91a49d0,right_ankle,3.87671494483948,1,1,7036,111
15088,110,0.237077713457457,idc91a49d0,left_wrist,3.29673910140991,-4,-3,15084,111
15086,109,0.309163114507073,idc91a49d0,left_hip,4.22204208374023,-2,0,15084,111
15085,110,0.6403130816151,idc91a49d0,left_ankle,3.69789814949036,-1,0,15084,111
15084,110,0.667550324113773,idc91a49d0,right_ankle,3.87671494483948,0,1,15084,111
7037,112,0.178469552375545,idc91a49d0,left_wrist,3.29673910140991,-1,-2,7036,111
7036,111,0.286030711620175,idc91a49d0,left_hip,4.22204208374023,0,0,7036,111
7034,112,0.650193828212563,idc91a49d0,left_ankle,3.69789814949036,2,1,7036,111
7035,111,0.673083376822175,idc91a49d0,right_ankle,3.87671494483948,1,1,7036,111
13218,111,0.251304427954037,idc91a49d0,left_wrist,3.29673910140991,-3,-3,13215,111
13216,110,0.29408621750996,idc91a49d0,left_hip,4.22204208374023,-1,0,13215,111
13215,109,0.65253737368648,idc91a49d0,left_ankle,3.69789814949036,0,2,13215,111
13214,111,0.665237309288847,idc91a49d0,right_ankle,3.87671494483948,1,1,13215,111
17592,111,0.21610353908335,idc91a49d0,left_wrist,3.29673910140991,-2,-5,17590,108
17590,109,0.309315872427802,idc91a49d0,left_hip,4.22204208374023,0,-1,17590,108
17590,110,0.631834739429351,idc91a49d0,left_ankle,3.69789814949036,0,-2,17590,108
17590,110,0.7213968465477,idc91a49d0,right_ankle,3.87671494483948,0,-2,17590,108
17919,111,0.250389021011187,idc91a49d0,left_wrist,3.29673910140991,-2,-3,17917,110
17917,110,0.324363819449623,idc91a49d0,left_hip,4.22204208374023,0,0,17917,110
17916,110,0.732499023848453,idc91a49d0,left_ankle,3.69789814949036,1,1,17917,110
17916,112,0.736843833780253,idc91a49d0,right_ankle,3.87671494483948,1,-1,17917,110
8241,111,0.25241759018775,idc91a49d0,left_wrist,3.29673910140991,-1,-2,8240,110
8240,110,0.304579372561108,idc91a49d0,left_hip,4.22204208374023,0,0,8240,110
8239,110,0.684127331500399,idc91a49d0,left_ankle,3.69789814949036,1,1,8240,110
8238,111,0.750532272666035,idc91a49d0,right_ankle,3.87671494483948,2,1,8240,110
8022,111,0.219611587818753,idc91a49d0,left_wrist,3.29673910140991,-2,-2,8020,111
8020,111,0.289967099757964,idc91a49d0,left_hip,4.22204208374023,0,0,8020,111
8017,113,0.662708152253856,idc91a49d0,left_ankle,3.69789814949036,3,1,8020,111
8018,111,0.651246780720094,idc91a49d0,right_ankle,3.87671494483948,2,2,8020,111
18683,110,0.207745061378919,idc91a49d0,left_wrist,3.29673910140991,-3,-4,18680,109
18680,110,0.316633252785799,idc91a49d0,left_hip,4.22204208374023,0,-1,18680,109
18681,109,0.643946648790242,idc91a49d0,left_ankle,3.69789814949036,-1,-1,18680,109
18681,108,0.728627964208412,idc91a49d0,right_ankle,3.87671494483948,-1,0,18680,109
13437,112,0.237695756435458,idc91a49d0,left_wrist,3.29673910140991,-1,-3,13436,110
13436,111,0.292338794227149,idc91a49d0,left_hip,4.22204208374023,0,-1,13436,110
13436,110,0.654215337797613,idc91a49d0,left_ankle,3.69789814949036,0,0,13436,110
13434,111,0.715966673171905,idc91a49d0,right_ankle,3.87671494483948,2,1,13436,110
15524,107,0.224355588115494,idc91a49d0,left_wrist,3.29673910140991,-5,-4,15519,108
15519,109,0.322239402988442,idc91a49d0,left_hip,4.22204208374023,0,-1,15519,108
15519,109,0.69188108104652,idc91a49d0,left_ankle,3.69789814949036,0,-1,15519,108
15518,110,0.739796231991366,idc91a49d0,right_ankle,3.87671494483948,1,-1,15519,108
12668,111,0.220866926577826,idc91a49d0,left_wrist,3.29673910140991,-2,-1,12666,112
12667,111,0.265687983418158,idc91a49d0,left_hip,4.22204208374023,-1,0,12666,112
12663,115,0.642508292930626,idc91a49d0,left_ankle,3.69789814949036,3,0,12666,112
12664,113,0.712896694490439,idc91a49d0,right_ankle,3.87671494483948,2,1,12666,112
18900,110,0.249686062862297,idc91a49d0,left_wrist,3.29673910140991,-4,-4,18896,110
18897,110,0.309014504248889,idc91a49d0,left_hip,4.22204208374023,-1,-1,18896,110
18896,111,0.678858047920417,idc91a49d0,left_ankle,3.69789814949036,0,-1,18896,110
18897,110,0.692929403273136,idc91a49d0,right_ankle,3.87671494483948,-1,-1,18896,110
6992,104,0.244627645317374,id1c7e64ad,left_wrist,4.54494714736938,-1,-1,6991,104
6990,104,0.274575210646375,id1c7e64ad,left_hip,5.51428914070129,1,1,6991,104
6989,104,0.652381838360215,id1c7e64ad,left_ankle,5.21575689315796,2,2,6991,104
6987,106,0.620475187114509,id1c7e64ad,right_ankle,4.2814040184021,4,2,6991,104
4632,106,0.237416509061179,id1c7e64ad,left_wrist,4.54494714736938,-2,-2,4630,106
4630,105,0.257171769757625,id1c7e64ad,left_hip,5.51428914070129,0,1,4630,106
4629,106,0.625848284327123,id1c7e64ad,left_ankle,5.21575689315796,1,1,4630,106
4630,106,0.678633566854932,id1c7e64ad,right_ankle,4.2814040184021,0,0,4630,106
21124,105,0.294189272771661,id1c7e64ad,left_wrist,4.54494714736938,-1,-5,21123,101
21126,101,0.300644508644807,id1c7e64ad,left_hip,5.51428914070129,-3,-3,21123,101
21124,101,0.694083211154237,id1c7e64ad,left_ankle,5.21575689315796,-1,-1,21123,101
21123,101,0.712718493695916,id1c7e64ad,right_ankle,4.2814040184021,0,0,21123,101
12085,101,0.270369790694195,id1c7e64ad,left_wrist,4.54494714736938,-1,-2,12084,100
12086,98,0.285120057695072,id1c7e64ad,left_hip,5.51428914070129,-2,0,12084,100
12084,101,0.698620993590598,id1c7e64ad,left_ankle,5.21575689315796,0,-1,12084,100
12082,102,0.692545893429548,id1c7e64ad,right_ankle,4.2814040184021,2,0,12084,100
20927,99,0.315879722606479,id1c7e64ad,left_wrist,4.54494714736938,-3,-2,20924,100
20927,100,0.295912106799911,id1c7e64ad,left_hip,5.51428914070129,-3,-3,20924,100
20923,101,0.713480224575287,id1c7e64ad,left_ankle,5.21575689315796,1,0,20924,100
20921,102,0.712854176214078,id1c7e64ad,right_ankle,4.2814040184021,3,1,20924,100
4632,106,0.237416509061179,id1c7e64ad,left_wrist,4.54494714736938,-2,-2,4630,106
4630,105,0.257171769757625,id1c7e64ad,left_hip,5.51428914070129,0,1,4630,106
4629,106,0.625848284327123,id1c7e64ad,left_ankle,5.21575689315796,1,1,4630,106
4630,106,0.678633566854932,id1c7e64ad,right_ankle,4.2814040184021,0,0,4630,106
18049,102,0.236580664911195,id1c7e64ad,left_wrist,4.54494714736938,-2,-2,18047,102
18051,100,0.285037604857433,id1c7e64ad,left_hip,5.51428914070129,-4,-2,18047,102
18048,101,0.684855998505238,id1c7e64ad,left_ankle,5.21575689315796,-1,0,18047,102
18047,103,0.663021904530243,id1c7e64ad,right_ankle,4.2814040184021,0,-1,18047,102
17345,100,0.272838162278037,id1c7e64ad,left_wrist,4.54494714736938,-3,-3,17342,100
17345,101,0.306317896207438,id1c7e64ad,left_hip,5.51428914070129,-3,-4,17342,100
17342,100,0.67926707088441,id1c7e64ad,left_ankle,5.21575689315796,0,0,17342,100
17341,99,0.702298650725703,id1c7e64ad,right_ankle,4.2814040184021,1,2,17342,100
22531,100,0.252019510281307,id1c7e64ad,left_wrist,4.54494714736938,-3,-3,22528,100
22531,100,0.294122817024219,id1c7e64ad,left_hip,5.51428914070129,-3,-3,22528,100
22528,99,0.74743236755105,id1c7e64ad,left_ankle,5.21575689315796,0,1,22528,100
22528,97,0.714667982686301,id1c7e64ad,right_ankle,4.2814040184021,0,3,22528,100
13085,99,0.222411035475209,id1c7e64ad,left_wrist,4.54494714736938,-2,0,13083,101
13084,101,0.280869835514889,id1c7e64ad,left_hip,5.51428914070129,-1,-1,13083,101
13082,102,0.72640525854117,id1c7e64ad,left_ankle,5.21575689315796,1,0,13083,101
13082,101,0.663251385393676,id1c7e64ad,right_ankle,4.2814040184021,1,1,13083,101
17046,103,0.299401530709284,id1c7e64ad,left_wrist,4.54494714736938,-3,-5,17043,101
17046,101,0.290761971409927,id1c7e64ad,left_hip,5.51428914070129,-3,-3,17043,101
17044,101,0.674170331659036,id1c7e64ad,left_ankle,5.21575689315796,-1,-1,17043,101
17043,100,0.656026381547302,id1c7e64ad,right_ankle,4.2814040184021,0,1,17043,101
9350,104,0.256792384618073,id1c7e64ad,left_wrist,4.54494714736938,0,-3,9350,101
9348,103,0.275384144342812,id1c7e64ad,left_hip,5.51428914070129,2,0,9350,101
9348,103,0.706628778789705,id1c7e64ad,left_ankle,5.21575689315796,2,0,9350,101
9348,102,0.627129008077602,id1c7e64ad,right_ankle,4.2814040184021,2,1,9350,101
2546,107,0.249500705072158,id1c7e64ad,left_wrist,4.54494714736938,-2,-3,2544,106
2544,107,0.266392370684173,id1c7e64ad,left_hip,5.51428914070129,0,-1,2544,106
2544,105,0.600180435149502,id1c7e64ad,left_ankle,5.21575689315796,0,1,2544,106
2542,107,0.676963324025621,id1c7e64ad,right_ankle,4.2814040184021,2,1,2544,106
22130,101,0.241870464477338,id1c7e64ad,left_wrist,4.54494714736938,-3,-3,22127,101
22130,100,0.295300047233319,id1c7e64ad,left_hip,5.51428914070129,-3,-2,22127,101
22128,101,0.655156697347145,id1c7e64ad,left_ankle,5.21575689315796,-1,-1,22127,101
22126,102,0.635343039735559,id1c7e64ad,right_ankle,4.2814040184021,1,0,22127,101
6786,103,0.229992543733933,id1c7e64ad,left_wrist,4.54494714736938,-2,0,6784,105
6783,105,0.274333276837454,id1c7e64ad,left_hip,5.51428914070129,1,1,6784,105
6783,104,0.646929031430066,id1c7e64ad,left_ankle,5.21575689315796,1,2,6784,105
6781,106,0.744566385258954,id1c7e64ad,right_ankle,4.2814040184021,3,2,6784,105
14098,104,0.223806343131749,id1c7e64ad,left_wrist,4.54494714736938,-1,-2,14097,103
14097,104,0.250027908100445,id1c7e64ad,left_hip,5.51428914070129,0,-1,14097,103
14097,102,0.707718181521248,id1c7e64ad,left_ankle,5.21575689315796,0,1,14097,103
14096,103,0.668146781177306,id1c7e64ad,right_ankle,4.2814040184021,1,1,14097,103
2755,105,0.236412258457232,id1c7e64ad,left_wrist,4.54494714736938,-1,-3,2754,103
2753,105,0.248847501173863,id1c7e64ad,left_hip,5.51428914070129,1,-1,2754,103
2753,104,0.622514210041459,id1c7e64ad,left_ankle,5.21575689315796,1,0,2754,103
2752,106,0.630792868765547,id1c7e64ad,right_ankle,4.2814040184021,2,-1,2754,103
20112,57,0.162827439038098,id1c7e64ad,left_wrist,4.54494714736938,-2,45,20110,104
20111,105,0.288685733570025,id1c7e64ad,left_hip,5.51428914070129,-1,-2,20110,104
20110,103,0.627538305382774,id1c7e64ad,left_ankle,5.21575689315796,0,1,20110,104
20111,102,0.641996286776951,id1c7e64ad,right_ankle,4.2814040184021,-1,1,20110,104
7617,101,0.235293739905467,id1c7e64ad,left_wrist,4.54494714736938,-4,-2,7613,103
7613,102,0.248000150446004,id1c7e64ad,left_hip,5.51428914070129,0,1,7613,103
7614,103,0.688938806066389,id1c7e64ad,left_ankle,5.21575689315796,-1,-1,7613,103
7614,102,0.690940506613124,id1c7e64ad,right_ankle,4.2814040184021,-1,0,7613,103
18670,104,0.283512849412558,id1c7e64ad,left_wrist,4.54494714736938,-1,-2,18669,103
18671,103,0.243969285205611,id1c7e64ad,left_hip,5.51428914070129,-2,-2,18669,103
18668,105,0.674770953349377,id1c7e64ad,left_ankle,5.21575689315796,1,-1,18669,103
18669,104,0.610041801913545,id1c7e64ad,right_ankle,4.2814040184021,0,-1,18669,103
5115,95,0.175193168463763,id8e66893c,left_wrist,3.20908784866333,13,14,5128,96
5127,96,0.390261978872258,id8e66893c,left_hip,2.98853182792664,1,1,5128,96
5128,96,0.560873442845638,id8e66893c,left_ankle,3.09009599685669,0,0,5128,96
5125,99,0.660642040207814,id8e66893c,right_ankle,3.15286993980408,3,0,5128,96
4251,97,0.150482431608365,id8e66893c,left_wrist,3.20908784866333,12,13,4263,98
4263,97,0.37184476554034,id8e66893c,left_hip,2.98853182792664,0,1,4263,98
4264,97,0.642106846227498,id8e66893c,left_ankle,3.09009599685669,-1,0,4263,98
4263,97,0.629812296753996,id8e66893c,right_ankle,3.15286993980408,0,1,4263,98
5021,95,0.180563959274531,id8e66893c,left_wrist,3.20908784866333,12,13,5033,96
5032,96,0.397627369887569,id8e66893c,left_hip,2.98853182792664,1,1,5033,96
5033,96,0.619160034552944,id8e66893c,left_ankle,3.09009599685669,0,0,5033,96
5031,95,0.591832850275054,id8e66893c,right_ankle,3.15286993980408,2,3,5033,96
7070,97,0.186465311845639,id8e66893c,left_wrist,3.20908784866333,-7,-7,7063,97
7068,97,0.354627752525505,id8e66893c,left_hip,2.98853182792664,-5,-5,7063,97
7069,96,0.556976751959174,id8e66893c,left_ankle,3.09009599685669,-6,-5,7063,97
7066,99,0.61004384554691,id8e66893c,right_ankle,3.15286993980408,-3,-5,7063,97
10886,95,0.306069684028895,id8e66893c,left_wrist,3.20908784866333,-5,-3,10881,97
10887,99,0.263925518959912,id8e66893c,left_hip,2.98853182792664,-6,-8,10881,97
10887,96,0.515725360592174,id8e66893c,left_ankle,3.09009599685669,-6,-5,10881,97
10884,102,0.476826424370143,id8e66893c,right_ankle,3.15286993980408,-3,-8,10881,97
17187,100,0.36012986180282,id8e66893c,left_wrist,3.20908784866333,-5,-7,17182,98
17188,98,0.351948444267201,id8e66893c,left_hip,2.98853182792664,-6,-6,17182,98
17187,99,0.606505907911126,id8e66893c,left_ankle,3.09009599685669,-5,-6,17182,98
17187,99,0.682010125713691,id8e66893c,right_ankle,3.15286993980408,-5,-6,17182,98
4069,100,0.189877263158683,id8e66893c,left_wrist,3.20908784866333,-5,-6,4064,99
4068,98,0.336747274340429,id8e66893c,left_hip,2.98853182792664,-4,-3,4064,99
4070,98,0.578864377475187,id8e66893c,left_ankle,3.09009599685669,-6,-5,4064,99
4070,99,0.575602185621992,id8e66893c,right_ankle,3.15286993980408,-6,-6,4064,99
17091,97,0.259236820339448,id8e66893c,left_wrist,3.20908784866333,-4,-5,17087,96
17090,99,0.364496228282145,id8e66893c,left_hip,2.98853182792664,-3,-6,17087,96
17090,98,0.593427694943463,id8e66893c,left_ankle,3.09009599685669,-3,-5,17087,96
17090,98,0.660037673223361,id8e66893c,right_ankle,3.15286993980408,-3,-5,17087,96
17869,99,0.288443639497375,id8e66893c,left_wrist,3.20908784866333,-6,-7,17863,98
17869,98,0.405796666858743,id8e66893c,left_hip,2.98853182792664,-6,-6,17863,98
17869,98,0.665191293299137,id8e66893c,left_ankle,3.09009599685669,-6,-6,17863,98
17869,98,0.637830468457491,id8e66893c,right_ankle,3.15286993980408,-6,-6,17863,98
12541,97,0.152937607285783,id8e66893c,left_wrist,3.20908784866333,-7,-6,12534,98
12539,98,0.339984021092975,id8e66893c,left_hip,2.98853182792664,-5,-5,12534,98
12540,97,0.62927342447235,id8e66893c,left_ankle,3.09009599685669,-6,-5,12534,98
12539,99,0.649351526562144,id8e66893c,right_ankle,3.15286993980408,-5,-6,12534,98
11949,95,0.174171133057946,id8e66893c,left_wrist,3.20908784866333,2,5,11951,98
11956,98,0.34494197828632,id8e66893c,left_hip,2.98853182792664,-5,-5,11951,98
11957,97,0.579956748472751,id8e66893c,left_ankle,3.09009599685669,-6,-5,11951,98
11956,98,0.628208999694872,id8e66893c,right_ankle,3.15286993980408,-5,-5,11951,98
1257,66,0.134485212796427,id8e66893c,left_wrist,3.20908784866333,-6,25,1251,97
1255,97,0.36333370213786,id8e66893c,left_hip,2.98853182792664,-4,-4,1251,97
1256,96,0.59912350819429,id8e66893c,left_ankle,3.09009599685669,-5,-4,1251,97
1255,96,0.634551088743739,id8e66893c,right_ankle,3.15286993980408,-4,-3,1251,97
4069,100,0.189877263158683,id8e66893c,left_wrist,3.20908784866333,-5,-6,4064,99
4068,98,0.336747274340429,id8e66893c,left_hip,2.98853182792664,-4,-3,4064,99
4070,98,0.578864377475187,id8e66893c,left_ankle,3.09009599685669,-6,-5,4064,99
4070,99,0.575602185621992,id8e66893c,right_ankle,3.15286993980408,-6,-6,4064,99
3392,98,0.191297496283553,id8e66893c,left_wrist,3.20908784866333,-1,-3,3391,96
3390,99,0.312736781315876,id8e66893c,left_hip,2.98853182792664,1,-2,3391,96
3391,99,0.53697984058414,id8e66893c,left_ankle,3.09009599685669,0,-3,3391,96
3391,99,0.607409546225965,id8e66893c,right_ankle,3.15286993980408,0,-3,3391,96
13023,88,0.186452211122874,id8e66893c,left_wrist,3.20908784866333,-6,4,13017,98
13022,96,0.358659140275717,id8e66893c,left_hip,2.98853182792664,-5,-3,13017,98
13022,96,0.633251835780003,id8e66893c,left_ankle,3.09009599685669,-5,-3,13017,98
13020,96,0.588444466522462,id8e66893c,right_ankle,3.15286993980408,-3,-1,13017,98
7263,99,0.201790459053549,id8e66893c,left_wrist,3.20908784866333,-6,-7,7257,98
7261,99,0.337163092819821,id8e66893c,left_hip,2.98853182792664,-4,-5,7257,98
7263,98,0.586484390757689,id8e66893c,left_ankle,3.09009599685669,-6,-6,7257,98
7262,98,0.588168157031629,id8e66893c,right_ankle,3.15286993980408,-5,-5,7257,98
14659,98,0.304468000129469,id8e66893c,left_wrist,3.20908784866333,-3,-6,14656,95
14660,97,0.410146450330476,id8e66893c,left_hip,2.98853182792664,-4,-6,14656,95
14659,98,0.644112232736939,id8e66893c,left_ankle,3.09009599685669,-3,-6,14656,95
14657,100,0.640480107164749,id8e66893c,right_ankle,3.15286993980408,-1,-6,14656,95
9420,100,0.327447054114718,id8e66893c,left_wrist,3.20908784866333,-7,-6,9413,101
9419,100,0.29502983781639,id8e66893c,left_hip,2.98853182792664,-6,-5,9413,101
9420,98,0.55735232746321,id8e66893c,left_ankle,3.09009599685669,-7,-4,9413,101
9420,101,0.52055889154874,id8e66893c,right_ankle,3.15286993980408,-7,-7,9413,101
13600,99,0.246074302452267,id8e66893c,left_wrist,3.20908784866333,-5,-3,13595,101
13601,98,0.360579175149887,id8e66893c,left_hip,2.98853182792664,-6,-3,13595,101
13601,98,0.611770463841006,id8e66893c,left_ankle,3.09009599685669,-6,-3,13595,101
13600,98,0.634005974897588,id8e66893c,right_ankle,3.15286993980408,-5,-2,13595,101
18743,88,0.211945954127235,id8e66893c,left_wrist,3.20908784866333,-1,5,18742,94
18742,99,0.353563948435218,id8e66893c,left_hip,2.98853182792664,0,-5,18742,94
18743,98,0.59263300244942,id8e66893c,left_ankle,3.09009599685669,-1,-5,18742,94
18742,97,0.622560103277533,id8e66893c,right_ankle,3.15286993980408,0,-3,18742,94
7263,99,0.201790459053549,id8e66893c,left_wrist,3.20908784866333,-6,-7,7257,98
7261,99,0.337163092819821,id8e66893c,left_hip,2.98853182792664,-4,-5,7257,98
7263,98,0.586484390757689,id8e66893c,left_ankle,3.09009599685669,-6,-6,7257,98
7262,98,0.588168157031629,id8e66893c,right_ankle,3.15286993980408,-5,-5,7257,98
14659,98,0.304468000129469,id8e66893c,left_wrist,3.20908784866333,-3,-6,14656,95
14660,97,0.410146450330476,id8e66893c,left_hip,2.98853182792664,-4,-6,14656,95
14659,98,0.644112232736939,id8e66893c,left_ankle,3.09009599685669,-3,-6,14656,95
14657,100,0.640480107164749,id8e66893c,right_ankle,3.15286993980408,-1,-6,14656,95
20853,94,0.287856605506823,id34e056c8,left_wrist,4.48835802078247,-2,-3,20851,93
20858,93,0.350375461157787,id34e056c8,left_hip,4.67531299591064,-7,-7,20851,93
20850,95,0.771283142062357,id34e056c8,left_ankle,4.79118800163269,1,-1,20851,93
20852,93,0.669886030880823,id34e056c8,right_ankle,4.98513293266296,-1,-1,20851,93
4747,94,0.295411444504968,id34e056c8,left_wrist,4.48835802078247,3,3,4750,94
4750,95,0.357087914779407,id34e056c8,left_hip,4.67531299591064,0,-1,4750,94
4748,94,0.740876616348908,id34e056c8,left_ankle,4.79118800163269,2,2,4750,94
4749,93,0.707935677959572,id34e056c8,right_ankle,4.98513293266296,1,2,4750,94
14531,88,0.228620198972047,id34e056c8,left_wrist,4.48835802078247,1,3,14532,90
14534,91,0.36527273065644,id34e056c8,left_hip,4.67531299591064,-2,-3,14532,90
14530,91,0.795308750734074,id34e056c8,left_ankle,4.79118800163269,2,1,14532,90
14529,92,0.746192075686323,id34e056c8,right_ankle,4.98513293266296,3,1,14532,90
2809,91,0.321886782943045,id34e056c8,left_wrist,4.48835802078247,1,3,2810,93
2812,92,0.359534130732736,id34e056c8,left_hip,4.67531299591064,-2,-1,2810,93
2809,91,0.72152498541219,id34e056c8,left_ankle,4.79118800163269,1,3,2810,93
2808,94,0.780485540500471,id34e056c8,right_ankle,4.98513293266296,2,1,2810,93
6041,93,0.259002351301159,id34e056c8,left_wrist,4.48835802078247,0,0,6041,93
6038,99,0.328809813568957,id34e056c8,left_hip,4.67531299591064,3,-3,6041,93
6039,93,0.813994024732892,id34e056c8,left_ankle,4.79118800163269,2,2,6041,93
6040,94,0.678882860942779,id34e056c8,right_ankle,4.98513293266296,1,0,6041,93
8612,89,0.169247511351993,id34e056c8,left_wrist,4.48835802078247,-8,1,8604,98
8603,98,0.239843529417974,id34e056c8,left_hip,4.67531299591064,1,1,8604,98
8604,95,0.750045030421456,id34e056c8,left_ankle,4.79118800163269,0,3,8604,98
8605,96,0.572603788647543,id34e056c8,right_ankle,4.98513293266296,-1,1,8604,98
371,89,0.214998833779884,id34e056c8,left_wrist,4.48835802078247,2,2,373,89
376,88,0.340463742053554,id34e056c8,left_hip,4.67531299591064,-3,-2,373,89
370,91,0.850724866145491,id34e056c8,left_ankle,4.79118800163269,3,1,373,89
370,90,0.735035907338762,id34e056c8,right_ankle,4.98513293266296,3,2,373,89
8513,96,0.250057472008715,id34e056c8,left_wrist,4.48835802078247,0,-4,8513,92
8517,87,0.2216080762168,id34e056c8,left_hip,4.67531299591064,-4,1,8513,92
8513,92,0.716765465722044,id34e056c8,left_ankle,4.79118800163269,0,0,8513,92
8513,93,0.597424380317579,id34e056c8,right_ankle,4.98513293266296,0,-1,8513,92
19344,93,0.263123007967364,id34e056c8,left_wrist,4.48835802078247,-7,1,19337,101
19348,88,0.282857487500827,id34e056c8,left_hip,4.67531299591064,-11,2,19337,101
19340,97,0.792428433762075,id34e056c8,left_ankle,4.79118800163269,-3,1,19337,101
19342,98,0.657443326274102,id34e056c8,right_ankle,4.98513293266296,-5,-2,19337,101
7596,93,0.284429922222336,id34e056c8,left_wrist,4.48835802078247,3,3,7599,93
7600,93,0.308234833204615,id34e056c8,left_hip,4.67531299591064,-1,-1,7599,93
7597,93,0.849086452339502,id34e056c8,left_ankle,4.79118800163269,2,2,7599,93
7598,93,0.731792225454117,id34e056c8,right_ankle,4.98513293266296,1,1,7599,93
10799,96,0.220366212440567,id34e056c8,left_wrist,4.48835802078247,3,-1,10802,92
10804,92,0.347126497619542,id34e056c8,left_hip,4.67531299591064,-2,-2,10802,92
10801,91,0.743778692404946,id34e056c8,left_ankle,4.79118800163269,1,2,10802,92
10800,92,0.734701320795556,id34e056c8,right_ankle,4.98513293266296,2,2,10802,92
13352,90,0.293014057173648,id34e056c8,left_wrist,4.48835802078247,1,3,13353,92
13357,90,0.359328066308765,id34e056c8,left_hip,4.67531299591064,-4,-2,13353,92
13352,92,0.797796593938101,id34e056c8,left_ankle,4.79118800163269,1,1,13353,92
13352,92,0.763468547702141,id34e056c8,right_ankle,4.98513293266296,1,1,13353,92
10984,94,0.267269496314868,id34e056c8,left_wrist,4.48835802078247,-1,-5,10983,90
10987,93,0.370789675534077,id34e056c8,left_hip,4.67531299591064,-4,-7,10983,90
10982,90,0.765548907427419,id34e056c8,left_ankle,4.79118800163269,1,1,10983,90
10982,91,0.762595277443828,id34e056c8,right_ankle,4.98513293266296,1,0,10983,90
4189,95,0.311264384630379,id34e056c8,left_wrist,4.48835802078247,5,3,4194,93
4193,92,0.36466781764964,id34e056c8,left_hip,4.67531299591064,1,2,4194,93
4191,93,0.824630125735662,id34e056c8,left_ankle,4.79118800163269,3,3,4194,93
4192,93,0.688277932549884,id34e056c8,right_ankle,4.98513293266296,2,2,4194,93
18397,95,0.312020918047951,id34e056c8,left_wrist,4.48835802078247,-2,-2,18395,95
18401,95,0.364380513768735,id34e056c8,left_hip,4.67531299591064,-6,-6,18395,95
18394,95,0.745843582729462,id34e056c8,left_ankle,4.79118800163269,1,1,18395,95
18396,95,0.688245568627035,id34e056c8,right_ankle,4.98513293266296,-1,-1,18395,95
14892,94,0.262538042824615,id34e056c8,left_wrist,4.48835802078247,3,2,14895,93
14900,90,0.304195224073595,id34e056c8,left_hip,4.67531299591064,-5,-2,14895,93
14894,92,0.839508918951642,id34e056c8,left_ankle,4.79118800163269,1,2,14895,93
14894,91,0.675214072621877,id34e056c8,right_ankle,4.98513293266296,1,3,14895,93
17736,93,0.289908153107286,id34e056c8,left_wrist,4.48835802078247,0,2,17736,95
17742,95,0.400065792794241,id34e056c8,left_hip,4.67531299591064,-6,-6,17736,95
17734,95,0.791256370920907,id34e056c8,left_ankle,4.79118800163269,2,2,17736,95
17736,95,0.700876424978494,id34e056c8,right_ankle,4.98513293266296,0,0,17736,95
2441,92,0.244094847657043,id34e056c8,left_wrist,4.48835802078247,1,3,2442,94
2442,93,0.332972721272322,id34e056c8,left_hip,4.67531299591064,0,1,2442,94
2441,92,0.724475001843188,id34e056c8,left_ankle,4.79118800163269,1,3,2442,94
2441,94,0.713121198193566,id34e056c8,right_ankle,4.98513293266296,1,1,2442,94
16173,92,0.249925780751028,id34e056c8,left_wrist,4.48835802078247,0,0,16173,92
16177,93,0.343171242263651,id34e056c8,left_hip,4.67531299591064,-4,-5,16173,92
16172,93,0.809490404080276,id34e056c8,left_ankle,4.79118800163269,1,0,16173,92
16173,93,0.68865459404294,id34e056c8,right_ankle,4.98513293266296,0,-1,16173,92
9162,97,0.203362827969088,id34e056c8,left_wrist,4.48835802078247,3,1,9165,95
9164,97,0.302898534209656,id34e056c8,left_hip,4.67531299591064,1,-1,9165,95
9164,93,0.748508374320202,id34e056c8,left_ankle,4.79118800163269,1,3,9165,95
9164,94,0.692253128235771,id34e056c8,right_ankle,4.98513293266296,1,2,9165,95
14330,107,0.341051860957256,idc735fc09,left_wrist,2.83816909790039,0,-3,14330,104
14331,105,0.337630751163293,idc735fc09,left_hip,2.36955714225769,-1,-2,14330,104
14330,105,0.678480789803359,idc735fc09,left_ankle,2.54462099075317,0,-1,14330,104
14330,103,0.739321174038384,idc735fc09,right_ankle,2.47294592857361,0,1,14330,104
11333,109,0.166560363482328,idc735fc09,left_wrist,2.83816909790039,1,-3,11334,105
11333,105,0.343520760111145,idc735fc09,left_hip,2.36955714225769,1,1,11334,105
11332,105,0.711958659526631,idc735fc09,left_ankle,2.54462099075317,2,2,11334,105
11331,105,0.906482451368563,idc735fc09,right_ankle,2.47294592857361,3,3,11334,105
13810,105,0.318429108338861,idc735fc09,left_wrist,2.83816909790039,-2,-2,13808,105
13810,105,0.380727485950321,idc735fc09,left_hip,2.36955714225769,-2,-2,13808,105
13809,105,0.644159909460201,idc735fc09,left_ankle,2.54462099075317,-1,-1,13808,105
13808,105,0.812012892949537,idc735fc09,right_ankle,2.47294592857361,0,0,13808,105
9678,105,0.286071479539842,idc735fc09,left_wrist,2.83816909790039,2,1,9680,104
9680,103,0.381070266405028,idc735fc09,left_hip,2.36955714225769,0,1,9680,104
9679,103,0.710883672316138,idc735fc09,left_ankle,2.54462099075317,1,2,9680,104
9678,102,0.908497857651772,idc735fc09,right_ankle,2.47294592857361,2,4,9680,104
9269,103,0.314916006455665,idc735fc09,left_wrist,2.83816909790039,-2,-2,9267,103
9268,104,0.398167667939786,idc735fc09,left_hip,2.36955714225769,-1,-2,9267,103
9266,104,0.666685151847358,idc735fc09,left_ankle,2.54462099075317,1,0,9267,103
9266,104,0.839484598706932,idc735fc09,right_ankle,2.47294592857361,1,0,9267,103
13709,102,0.287710310355167,idc735fc09,left_wrist,2.83816909790039,-2,-2,13707,102
13708,103,0.373803874607961,idc735fc09,left_hip,2.36955714225769,-1,-2,13707,102
13705,105,0.687108078301661,idc735fc09,left_ankle,2.54462099075317,2,-1,13707,102
13706,103,0.877327966863141,idc735fc09,right_ankle,2.47294592857361,1,0,13707,102
576,106,0.28238940384241,idc735fc09,left_wrist,2.83816909790039,0,0,576,106
575,107,0.309316527014136,idc735fc09,left_hip,2.36955714225769,1,0,576,106
574,108,0.726860830240697,idc735fc09,left_ankle,2.54462099075317,2,0,576,106
575,105,0.74233596794994,idc735fc09,right_ankle,2.47294592857361,1,2,576,106
8335,104,0.284672709526112,idc735fc09,left_wrist,2.83816909790039,-1,-1,8334,104
8335,104,0.360352737406702,idc735fc09,left_hip,2.36955714225769,-1,-1,8334,104
8333,105,0.679207643999312,idc735fc09,left_ankle,2.54462099075317,1,0,8334,104
8330,109,0.900255408273939,idc735fc09,right_ankle,2.47294592857361,4,-1,8334,104
12783,105,0.300324465006903,idc735fc09,left_wrist,2.83816909790039,-2,0,12781,107
12783,106,0.35178564483252,idc735fc09,left_hip,2.36955714225769,-2,-1,12781,107
12782,105,0.672593599031674,idc735fc09,left_ankle,2.54462099075317,-1,1,12781,107
12783,105,0.808765593433256,idc735fc09,right_ankle,2.47294592857361,-2,0,12781,107
12157,104,0.18211077507039,idc735fc09,left_wrist,2.83816909790039,2,2,12159,104
12159,104,0.327796271974468,idc735fc09,left_hip,2.36955714225769,0,0,12159,104
12158,105,0.677573675183687,idc735fc09,left_ankle,2.54462099075317,1,0,12159,104
12158,104,0.94574614061566,idc735fc09,right_ankle,2.47294592857361,1,1,12159,104
8335,104,0.284672709526112,idc735fc09,left_wrist,2.83816909790039,-1,-1,8334,104
8335,104,0.360352737406702,idc735fc09,left_hip,2.36955714225769,-1,-1,8334,104
8333,105,0.679207643999312,idc735fc09,left_ankle,2.54462099075317,1,0,8334,104
8330,109,0.900255408273939,idc735fc09,right_ankle,2.47294592857361,4,-1,8334,104
14957,106,0.411999550480473,idc735fc09,left_wrist,2.83816909790039,-1,-2,14956,105
14957,104,0.386286275234186,idc735fc09,left_hip,2.36955714225769,-1,0,14956,105
14955,105,0.638888263206535,idc735fc09,left_ankle,2.54462099075317,1,1,14956,105
14955,105,0.850547987223334,idc735fc09,right_ankle,2.47294592857361,1,1,14956,105
7598,105,0.261655970359242,idc735fc09,left_wrist,2.83816909790039,2,2,7600,105
7600,105,0.327371140977569,idc735fc09,left_hip,2.36955714225769,0,0,7600,105
7598,107,0.747911201910855,idc735fc09,left_ankle,2.54462099075317,2,0,7600,105
7599,103,0.932087393757092,idc735fc09,right_ankle,2.47294592857361,1,3,7600,105
4273,106,0.222578406605236,idc735fc09,left_wrist,2.83816909790039,3,2,4276,105
4276,105,0.298758278478204,idc735fc09,left_hip,2.36955714225769,0,0,4276,105
4274,106,0.741198268756017,idc735fc09,left_ankle,2.54462099075317,2,1,4276,105
4273,106,0.884225197636523,idc735fc09,right_ankle,2.47294592857361,3,2,4276,105
1311,108,0.277422993730522,idc735fc09,left_wrist,2.83816909790039,2,1,1313,107
1312,108,0.291249960889872,idc735fc09,left_hip,2.36955714225769,1,0,1313,107
1312,107,0.670888607390161,idc735fc09,left_ankle,2.54462099075317,1,1,1313,107
1311,107,0.854654138534492,idc735fc09,right_ankle,2.47294592857361,2,2,1313,107
1735,108,0.231363828145109,idc735fc09,left_wrist,2.83816909790039,4,4,1739,108
1738,108,0.290971632045165,idc735fc09,left_hip,2.36955714225769,1,1,1739,108
1735,108,0.718493253896804,idc735fc09,left_ankle,2.54462099075317,4,4,1739,108
1737,107,0.803559740677649,idc735fc09,right_ankle,2.47294592857361,2,3,1739,108
5532,106,0.240154778870358,idc735fc09,left_wrist,2.83816909790039,2,2,5534,106
5534,106,0.283047022163199,idc735fc09,left_hip,2.36955714225769,0,0,5534,106
5531,107,0.717150314614583,idc735fc09,left_ankle,2.54462099075317,3,2,5534,106
5532,105,0.776517274587568,idc735fc09,right_ankle,2.47294592857361,2,3,5534,106
9061,105,0.297662854002427,idc735fc09,left_wrist,2.83816909790039,2,-1,9063,102
9062,105,0.375039586272478,idc735fc09,left_hip,2.36955714225769,1,-2,9063,102
9060,105,0.650333683704554,idc735fc09,left_ankle,2.54462099075317,3,0,9063,102
9061,103,0.844294916642085,idc735fc09,right_ankle,2.47294592857361,2,1,9063,102
11540,100,0.193524643501569,idc735fc09,left_wrist,2.83816909790039,1,-2,11541,97
11540,104,0.356976574144279,idc735fc09,left_hip,2.36955714225769,1,-6,11541,97
11539,101,0.725995207410685,idc735fc09,left_ankle,2.54462099075317,2,-2,11541,97
11538,101,0.767760836553522,idc735fc09,right_ankle,2.47294592857361,3,-1,11541,97
7079,104,0.268907490167399,idc735fc09,left_wrist,2.83816909790039,2,3,7081,105
7081,105,0.32437930160506,idc735fc09,left_hip,2.36955714225769,0,0,7081,105
7080,105,0.770680633989466,idc735fc09,left_ankle,2.54462099075317,1,1,7081,105
7078,106,0.835783333690093,idc735fc09,right_ankle,2.47294592857361,3,2,7081,105
18595,105,0.330836916923022,id86237981,left_wrist,4.12453818321228,-3,-2,18592,106
18596,105,0.357705205222806,id86237981,left_hip,4.26292490959167,-4,-3,18592,106
18592,106,0.797124268509395,id86237981,left_ankle,3.55835604667664,0,0,18592,106
18593,104,0.754168404746783,id86237981,right_ankle,2.96206903457642,-1,1,18592,106
6002,104,0.297010135651022,id86237981,left_wrist,4.12453818321228,-1,0,6001,105
6001,105,0.346699123665396,id86237981,left_hip,4.26292490959167,0,0,6001,105
5999,106,0.768731793910627,id86237981,left_ankle,3.55835604667664,2,1,6001,105
5999,105,0.760602755278434,id86237981,right_ankle,2.96206903457642,2,2,6001,105
9334,106,0.292306201896217,id86237981,left_wrist,4.12453818321228,0,0,9334,106
9335,107,0.353388095907456,id86237981,left_hip,4.26292490959167,-1,-2,9334,106
9334,106,0.781158711858167,id86237981,left_ankle,3.55835604667664,0,0,9334,106
9332,107,0.838042742099437,id86237981,right_ankle,2.96206903457642,2,1,9334,106
6840,105,0.31016942623838,id86237981,left_wrist,4.12453818321228,0,-1,6840,104
6842,105,0.354192933716922,id86237981,left_hip,4.26292490959167,-2,-3,6840,104
6840,104,0.738116355694489,id86237981,left_ankle,3.55835604667664,0,0,6840,104
6837,108,0.812402319378718,id86237981,right_ankle,2.96206903457642,3,-1,6840,104
13270,105,0.288326299146076,id86237981,left_wrist,4.12453818321228,0,-1,13270,104
13274,104,0.354940979048207,id86237981,left_hip,4.26292490959167,-4,-4,13270,104
13270,102,0.688683056673528,id86237981,left_ankle,3.55835604667664,0,2,13270,104
13270,103,0.774659792672809,id86237981,right_ankle,2.96206903457642,0,1,13270,104
5275,105,0.293489350038693,id86237981,left_wrist,4.12453818321228,-3,-2,5272,106
5274,104,0.365637957235407,id86237981,left_hip,4.26292490959167,-2,0,5272,106
5272,104,0.706868072652598,id86237981,left_ankle,3.55835604667664,0,2,5272,106
5270,106,0.885047602710897,id86237981,right_ankle,2.96206903457642,2,2,5272,106
9750,105,0.297440561569893,id86237981,left_wrist,4.12453818321228,0,-2,9750,103
9754,103,0.369138110347083,id86237981,left_hip,4.26292490959167,-4,-4,9750,103
9750,103,0.726724388549277,id86237981,left_ankle,3.55835604667664,0,0,9750,103
9749,103,0.860011418719549,id86237981,right_ankle,2.96206903457642,1,1,9750,103
15565,105,0.3234818400095,id86237981,left_wrist,4.12453818321228,-5,-5,15560,105
15564,105,0.37784365157789,id86237981,left_hip,4.26292490959167,-4,-4,15560,105
15561,105,0.733089649973391,id86237981,left_ankle,3.55835604667664,-1,-1,15560,105
15560,103,0.80534586992822,id86237981,right_ankle,2.96206903457642,0,2,15560,105
1728,105,0.281280203244332,id86237981,left_wrist,4.12453818321228,-2,-1,1726,106
1725,105,0.332143852776728,id86237981,left_hip,4.26292490959167,1,2,1726,106
1723,108,0.784542704244025,id86237981,left_ankle,3.55835604667664,3,1,1726,106
1724,108,0.841520719222659,id86237981,right_ankle,2.96206903457642,2,0,1726,106
17760,102,0.328883620779547,id86237981,left_wrist,4.12453818321228,-5,-2,17755,105
17759,105,0.378861026981553,id86237981,left_hip,4.26292490959167,-4,-4,17755,105
17755,105,0.778251621587358,id86237981,left_ankle,3.55835604667664,0,0,17755,105
17756,104,0.790948006088442,id86237981,right_ankle,2.96206903457642,-1,0,17755,105
6944,107,0.324142452634298,id86237981,left_wrist,4.12453818321228,-1,-2,6943,106
6946,105,0.374886034132962,id86237981,left_hip,4.26292490959167,-3,-2,6943,106
6943,106,0.779000637616765,id86237981,left_ankle,3.55835604667664,0,0,6943,106
6944,104,0.759693580254833,id86237981,right_ankle,2.96206903457642,-1,1,6943,106
17126,105,0.319574646415941,id86237981,left_wrist,4.12453818321228,-2,-1,17124,106
17127,105,0.382681290680634,id86237981,left_hip,4.26292490959167,-3,-2,17124,106
17124,106,0.738957168229155,id86237981,left_ankle,3.55835604667664,0,0,17124,106
17123,106,0.763619487011137,id86237981,right_ankle,2.96206903457642,1,1,17124,106
7050,105,0.329083479402443,id86237981,left_wrist,4.12453818321228,-2,-2,7048,105
7050,106,0.361771506927969,id86237981,left_hip,4.26292490959167,-2,-3,7048,105
7048,105,0.74785870193203,id86237981,left_ankle,3.55835604667664,0,0,7048,105
7047,106,0.827806682996355,id86237981,right_ankle,2.96206903457642,1,0,7048,105
6840,105,0.31016942623838,id86237981,left_wrist,4.12453818321228,0,-1,6840,104
6842,105,0.354192933716922,id86237981,left_hip,4.26292490959167,-2,-3,6840,104
6840,104,0.738116355694489,id86237981,left_ankle,3.55835604667664,0,0,6840,104
6837,108,0.812402319378718,id86237981,right_ankle,2.96206903457642,3,-1,6840,104
9750,105,0.297440561569893,id86237981,left_wrist,4.12453818321228,0,-2,9750,103
9754,103,0.369138110347083,id86237981,left_hip,4.26292490959167,-4,-4,9750,103
9750,103,0.726724388549277,id86237981,left_ankle,3.55835604667664,0,0,9750,103
9749,103,0.860011418719549,id86237981,right_ankle,2.96206903457642,1,1,9750,103
18177,105,0.269988398879355,id86237981,left_wrist,4.12453818321228,-2,-2,18175,105
18176,107,0.395597302143187,id86237981,left_hip,4.26292490959167,-1,-3,18175,105
18175,106,0.752253388594287,id86237981,left_ankle,3.55835604667664,0,-1,18175,105
18173,105,0.818230080758652,id86237981,right_ankle,2.96206903457642,2,2,18175,105
17550,108,0.309799908926668,id86237981,left_wrist,4.12453818321228,-4,-5,17546,107
17547,108,0.37858316573844,id86237981,left_hip,4.26292490959167,-1,-2,17546,107
17546,107,0.743693475490449,id86237981,left_ankle,3.55835604667664,0,0,17546,107
17546,106,0.824065022530607,id86237981,right_ankle,2.96206903457642,0,1,17546,107
7980,105,0.261245447476919,id86237981,left_wrist,4.12453818321228,-1,-2,7979,104
7982,103,0.348433926457386,id86237981,left_hip,4.26292490959167,-3,-2,7979,104
7979,105,0.818586185627756,id86237981,left_ankle,3.55835604667664,0,-1,7979,104
7978,105,0.841039394899546,id86237981,right_ankle,2.96206903457642,1,0,7979,104
15876,105,0.287886513378267,id86237981,left_wrist,4.12453818321228,-3,-2,15873,106
15877,105,0.36065848245606,id86237981,left_hip,4.26292490959167,-4,-3,15873,106
15874,105,0.747307553980986,id86237981,left_ankle,3.55835604667664,-1,0,15873,106
15874,104,0.810393422556646,id86237981,right_ankle,2.96206903457642,-1,1,15873,106
19539,106,0.350334953311221,id86237981,left_wrist,4.12453818321228,-3,-2,19536,107
19538,106,0.412616346994791,id86237981,left_hip,4.26292490959167,-2,-1,19536,107
19536,108,0.793830011976505,id86237981,left_ankle,3.55835604667664,0,-1,19536,107
19536,104,0.827923265074739,id86237981,right_ankle,2.96206903457642,0,3,19536,107
8582,121,0.146247712565004,idf5e3678b,left_wrist,3.07465600967407,9,-4,8591,108
8591,108,0.321190935021635,idf5e3678b,left_hip,2.81758499145508,0,0,8591,108
8590,109,0.658200363382117,idf5e3678b,left_ankle,3.17890310287476,1,0,8591,108
8590,106,0.759306974111409,idf5e3678b,right_ankle,3.37752795219421,1,3,8591,108
14151,110,0.156880158358314,idf5e3678b,left_wrist,3.07465600967407,-9,-11,14142,108
14144,107,0.310847146395569,idf5e3678b,left_hip,2.81758499145508,-2,-1,14142,108
14143,108,0.675549886526365,idf5e3678b,left_ankle,3.17890310287476,-1,-1,14142,108
14143,108,0.707643452184752,idf5e3678b,right_ankle,3.37752795219421,-1,-1,14142,108
7940,106,0.141694101987983,idf5e3678b,left_wrist,3.07465600967407,8,10,7948,108
7948,108,0.313921016954866,idf5e3678b,left_hip,2.81758499145508,0,0,7948,108
7947,108,0.65934597070755,idf5e3678b,left_ankle,3.17890310287476,1,1,7948,108
7946,110,0.744512584664042,idf5e3678b,right_ankle,3.37752795219421,2,0,7948,108
6453,115,0.134421298885364,idf5e3678b,left_wrist,3.07465600967407,-5,-14,6448,106
6448,110,0.275799581212595,idf5e3678b,left_hip,2.81758499145508,0,-4,6448,106
6447,110,0.639564529294732,idf5e3678b,left_ankle,3.17890310287476,1,-3,6448,106
6448,109,0.666123491000735,idf5e3678b,right_ankle,3.37752795219421,0,-3,6448,106
14997,106,0.165925920496355,idf5e3678b,left_wrist,3.07465600967407,-7,-7,14990,106
14992,106,0.3464429530979,idf5e3678b,left_hip,2.81758499145508,-2,-2,14990,106
14991,106,0.689884945388124,idf5e3678b,left_ankle,3.17890310287476,-1,-1,14990,106
14989,105,0.758456620705252,idf5e3678b,right_ankle,3.37752795219421,1,2,14990,106
4038,108,0.190632488938206,idf5e3678b,left_wrist,3.07465600967407,-5,-3,4033,110
4035,109,0.311510166553324,idf5e3678b,left_hip,2.81758499145508,-2,-1,4033,110
4033,109,0.645777219264833,idf5e3678b,left_ankle,3.17890310287476,0,1,4033,110
4033,108,0.644625922461515,idf5e3678b,right_ankle,3.37752795219421,0,2,4033,110
14151,110,0.156880158358314,idf5e3678b,left_wrist,3.07465600967407,-9,-11,14142,108
14144,107,0.310847146395569,idf5e3678b,left_hip,2.81758499145508,-2,-1,14142,108
14143,108,0.675549886526365,idf5e3678b,left_ankle,3.17890310287476,-1,-1,14142,108
14143,108,0.707643452184752,idf5e3678b,right_ankle,3.37752795219421,-1,-1,14142,108
2485,114,0.184352523449625,idf5e3678b,left_wrist,3.07465600967407,-2,-3,2483,113
2483,114,0.269034259288879,idf5e3678b,left_hip,2.81758499145508,0,-1,2483,113
2481,115,0.587252941043668,idf5e3678b,left_ankle,3.17890310287476,2,0,2483,113
2484,113,0.674108575194344,idf5e3678b,right_ankle,3.37752795219421,-1,-1,2483,113
4908,111,0.159095345565371,idf5e3678b,left_wrist,3.07465600967407,-9,-8,4899,112
4901,111,0.287273890858142,idf5e3678b,left_hip,2.81758499145508,-2,-1,4899,112
4899,112,0.611188425930254,idf5e3678b,left_ankle,3.17890310287476,0,0,4899,112
4900,112,0.632796134176839,idf5e3678b,right_ankle,3.37752795219421,-1,-1,4899,112
2933,113,0.19448623875371,idf5e3678b,left_wrist,3.07465600967407,-3,-5,2930,111
2931,111,0.33503174035377,idf5e3678b,left_hip,2.81758499145508,-1,-1,2930,111
2929,111,0.58513267714195,idf5e3678b,left_ankle,3.17890310287476,1,1,2930,111
2929,113,0.665289146363923,idf5e3678b,right_ankle,3.37752795219421,1,-1,2930,111
4794,115,0.150384555489271,idf5e3678b,left_wrist,3.07465600967407,-5,-9,4789,111
4791,111,0.301734036501647,idf5e3678b,left_hip,2.81758499145508,-2,-2,4789,111
4789,111,0.575525531120654,idf5e3678b,left_ankle,3.17890310287476,0,0,4789,111
4790,111,0.670469982307402,idf5e3678b,right_ankle,3.37752795219421,-1,-1,4789,111
1254,111,0.144179637521626,idf5e3678b,left_wrist,3.07465600967407,-4,-4,1250,111
1251,111,0.268016535250708,idf5e3678b,left_hip,2.81758499145508,-1,-1,1250,111
1250,110,0.587858169549065,idf5e3678b,left_ankle,3.17890310287476,0,1,1250,111
1250,111,0.679604459480961,idf5e3678b,right_ankle,3.37752795219421,0,0,1250,111
12740,107,0.140188787385795,idf5e3678b,left_wrist,3.07465600967407,-10,-9,12730,108
12730,110,0.312445310899519,idf5e3678b,left_hip,2.81758499145508,0,-2,12730,108
12731,108,0.646919164840796,idf5e3678b,left_ankle,3.17890310287476,-1,-1,12730,108
12730,108,0.72714521063743,idf5e3678b,right_ankle,3.37752795219421,0,0,12730,108
17425,108,0.227180494368538,idf5e3678b,left_wrist,3.07465600967407,-4,-5,17421,107
17422,108,0.342123650981347,idf5e3678b,left_hip,2.81758499145508,-1,-2,17421,107
17421,108,0.65369059492301,idf5e3678b,left_ankle,3.17890310287476,0,-1,17421,107
17421,108,0.705129312487462,idf5e3678b,right_ankle,3.37752795219421,0,-1,17421,107
15416,104,0.180994848986768,idf5e3678b,left_wrist,3.07465600967407,-10,-6,15406,108
15410,106,0.303567862704522,idf5e3678b,left_hip,2.81758499145508,-4,-2,15406,108
15408,107,0.657785281453834,idf5e3678b,left_ankle,3.17890310287476,-2,-1,15406,108
15406,106,0.703570068598683,idf5e3678b,right_ankle,3.37752795219421,0,2,15406,108
15834,104,0.217914215120908,idf5e3678b,left_wrist,3.07465600967407,-5,-4,15829,105
15830,106,0.34720623491368,idf5e3678b,left_hip,2.81758499145508,-1,-2,15829,105
15830,104,0.635424326820117,idf5e3678b,left_ankle,3.17890310287476,-1,0,15829,105
15827,106,0.735176978516602,idf5e3678b,right_ankle,3.37752795219421,2,1,15829,105
9017,118,0.135442581705694,idf5e3678b,left_wrist,3.07465600967407,-1,-11,9016,108
9016,109,0.275789078869824,idf5e3678b,left_hip,2.81758499145508,0,-1,9016,108
9017,107,0.60100751770398,idf5e3678b,left_ankle,3.17890310287476,-1,0,9016,108
9014,109,0.644448246780739,idf5e3678b,right_ankle,3.37752795219421,2,1,9016,108
8153,108,0.140076609716965,idf5e3678b,left_wrist,3.07465600967407,9,10,8162,109
8163,108,0.307594269963565,idf5e3678b,left_hip,2.81758499145508,-1,0,8162,109
8163,108,0.667408137535968,idf5e3678b,left_ankle,3.17890310287476,-1,0,8162,109
8160,109,0.751557037769543,idf5e3678b,right_ankle,3.37752795219421,2,2,8162,109
16045,106,0.209587961925502,idf5e3678b,left_wrist,3.07465600967407,-7,-4,16038,109
16041,107,0.330151686271246,idf5e3678b,left_hip,2.81758499145508,-3,-1,16038,109
16039,107,0.609005164673118,idf5e3678b,left_ankle,3.17890310287476,-1,1,16038,109
16039,106,0.685889883624375,idf5e3678b,right_ankle,3.37752795219421,-1,2,16038,109
12092,107,0.111837439411359,idf5e3678b,left_wrist,3.07465600967407,-9,-8,12083,108
12084,108,0.324057264793741,idf5e3678b,left_hip,2.81758499145508,-1,-1,12083,108
12082,109,0.653886765734193,idf5e3678b,left_ankle,3.17890310287476,1,0,12083,108
12082,109,0.736812202170461,idf5e3678b,right_ankle,3.37752795219421,1,0,12083,108
14694,104,0.104627384385691,id37a54bbf,left_wrist,4.01262593269348,-4,-4,14690,104
14687,104,0.245481515566358,id37a54bbf,left_hip,4.52509212493896,3,3,14690,104
14689,103,0.748374893563353,id37a54bbf,left_ankle,4.60535597801208,1,2,14690,104
14689,105,0.6766172875253,id37a54bbf,right_ankle,4.26087188720703,1,0,14690,104
7988,101,0.15920826148041,id37a54bbf,left_wrist,4.01262593269348,-4,-3,7984,102
7981,103,0.250203055863987,id37a54bbf,left_hip,4.52509212493896,3,2,7984,102
7979,105,0.659017158945219,id37a54bbf,left_ankle,4.60535597801208,5,2,7984,102
7982,104,0.676551538477934,id37a54bbf,right_ankle,4.26087188720703,2,0,7984,102
6135,102,0.133125644926089,id37a54bbf,left_wrist,4.01262593269348,8,8,6143,102
6139,102,0.254764044466215,id37a54bbf,left_hip,4.52509212493896,4,4,6143,102
6141,101,0.742335211447474,id37a54bbf,left_ankle,4.60535597801208,2,3,6143,102
6138,103,0.656896961293834,id37a54bbf,right_ankle,4.26087188720703,5,4,6143,102
22286,103,0.12141578308616,id37a54bbf,left_wrist,4.01262593269348,-5,-4,22281,104
22278,104,0.253822104268088,id37a54bbf,left_hip,4.52509212493896,3,3,22281,104
22279,105,0.801212953733064,id37a54bbf,left_ankle,4.60535597801208,2,1,22281,104
22279,104,0.579083082592328,id37a54bbf,right_ankle,4.26087188720703,2,2,22281,104
14179,112,0.107433367882434,id37a54bbf,left_wrist,4.01262593269348,3,-6,14182,103
14178,103,0.227403815093167,id37a54bbf,left_hip,4.52509212493896,4,4,14182,103
14180,104,0.804216265881312,id37a54bbf,left_ankle,4.60535597801208,2,1,14182,103
14179,104,0.667917161696814,id37a54bbf,right_ankle,4.26087188720703,3,2,14182,103
4835,88,0.0902960728560288,id37a54bbf,left_wrist,4.01262593269348,-5,8,4830,101
4826,102,0.253827945796806,id37a54bbf,left_hip,4.52509212493896,4,3,4830,101
4826,104,0.749762101267335,id37a54bbf,left_ankle,4.60535597801208,4,1,4830,101
4828,99,0.685938302890062,id37a54bbf,right_ankle,4.26087188720703,2,4,4830,101
3004,101,0.128984016509775,id37a54bbf,left_wrist,4.01262593269348,8,8,3012,101
3007,102,0.253899551772339,id37a54bbf,left_hip,4.52509212493896,5,4,3012,101
3010,102,0.69957904459177,id37a54bbf,left_ankle,4.60535597801208,2,1,3012,101
3007,102,0.644013569585588,id37a54bbf,right_ankle,4.26087188720703,5,4,3012,101
10742,101,0.0966792072736776,id37a54bbf,left_wrist,4.01262593269348,-6,-6,10736,101
10732,103,0.262939471287263,id37a54bbf,left_hip,4.52509212493896,4,2,10736,101
10735,101,0.832540459164246,id37a54bbf,left_ankle,4.60535597801208,1,1,10736,101
10735,103,0.728162714677237,id37a54bbf,right_ankle,4.26087188720703,1,-1,10736,101
20660,104,0.120107124623347,id37a54bbf,left_wrist,4.01262593269348,-5,-6,20655,103
20656,99,0.225663125217282,id37a54bbf,left_hip,4.52509212493896,-1,3,20655,103
20653,104,0.716422685702752,id37a54bbf,left_ankle,4.60535597801208,2,1,20655,103
20656,99,0.591938542730962,id37a54bbf,right_ankle,4.26087188720703,-1,3,20655,103
13465,111,0.134394800465975,id37a54bbf,left_wrist,4.01262593269348,7,-1,13472,103
13468,103,0.236350793555457,id37a54bbf,left_hip,4.52509212493896,4,4,13472,103
13470,103,0.723907129147806,id37a54bbf,left_ankle,4.60535597801208,2,2,13472,103
13469,101,0.608725591536225,id37a54bbf,right_ankle,4.26087188720703,3,5,13472,103
21876,103,0.105520953188295,id37a54bbf,left_wrist,4.01262593269348,-4,-5,21872,102
21869,101,0.246746242291094,id37a54bbf,left_hip,4.52509212493896,3,4,21872,102
21868,104,0.787512368392216,id37a54bbf,left_ankle,4.60535597801208,4,2,21872,102
21869,104,0.629186033267943,id37a54bbf,right_ankle,4.26087188720703,3,1,21872,102
16457,57,0.200918153872691,id37a54bbf,left_wrist,4.01262593269348,-45,1,16412,103
16408,103,0.229049305507073,id37a54bbf,left_hip,4.52509212493896,4,4,16412,103
16411,102,0.798613102371087,id37a54bbf,left_ankle,4.60535597801208,1,2,16412,103
16410,102,0.679437654173518,id37a54bbf,right_ankle,4.26087188720703,2,3,16412,103
8088,105,0.134758714692973,id37a54bbf,left_wrist,4.01262593269348,-3,-5,8085,103
8083,100,0.258269370693691,id37a54bbf,left_hip,4.52509212493896,2,5,8085,103
8083,103,0.735980451608272,id37a54bbf,left_ankle,4.60535597801208,2,2,8085,103
8085,100,0.694283588434248,id37a54bbf,right_ankle,4.26087188720703,0,3,8085,103
9716,101,0.109338623440476,id37a54bbf,left_wrist,4.01262593269348,-4,-2,9712,103
9709,103,0.252577807980495,id37a54bbf,left_hip,4.52509212493896,3,3,9712,103
9711,99,0.684138021760381,id37a54bbf,left_ankle,4.60535597801208,1,5,9712,103
9709,104,0.646274025102502,id37a54bbf,right_ankle,4.26087188720703,3,2,9712,103
3410,111,0.136623999261421,id37a54bbf,left_wrist,4.01262593269348,7,-1,3417,103
3414,102,0.238506290130874,id37a54bbf,left_hip,4.52509212493896,3,4,3417,103
3413,105,0.780363342184584,id37a54bbf,left_ankle,4.60535597801208,4,2,3417,103
3414,102,0.643934266985974,id37a54bbf,right_ankle,4.26087188720703,3,4,3417,103
401,93,0.102313929716476,id37a54bbf,left_wrist,4.01262593269348,-10,-5,391,98
392,93,0.296813589112493,id37a54bbf,left_hip,4.52509212493896,-1,4,391,98
387,100,0.862169963269104,id37a54bbf,left_ankle,4.60535597801208,4,2,391,98
387,101,0.82838974127597,id37a54bbf,right_ankle,4.26087188720703,4,1,391,98
15961,155,0.258347217567085,id37a54bbf,left_wrist,4.01262593269348,48,-6,16009,101
16005,102,0.240751130459682,id37a54bbf,left_hip,4.52509212493896,4,3,16009,101
16008,102,0.73028572991611,id37a54bbf,left_ankle,4.60535597801208,1,0,16009,101
16006,105,0.662252906409916,id37a54bbf,right_ankle,4.26087188720703,3,-1,16009,101
2404,94,0.109224728914736,id37a54bbf,left_wrist,4.01262593269348,0,7,2404,101
2400,102,0.254765630974394,id37a54bbf,left_hip,4.52509212493896,4,3,2404,101
2400,102,0.673865946895753,id37a54bbf,left_ankle,4.60535597801208,4,3,2404,101
2400,102,0.664448620886159,id37a54bbf,right_ankle,4.26087188720703,4,3,2404,101
10026,103,0.101769289614359,id37a54bbf,left_wrist,4.01262593269348,-6,-4,10020,105
10017,105,0.246044423852023,id37a54bbf,left_hip,4.52509212493896,3,3,10020,105
10020,104,0.80219460667472,id37a54bbf,left_ankle,4.60535597801208,0,1,10020,105
10019,105,0.670490938269144,id37a54bbf,right_ankle,4.26087188720703,1,1,10020,105
14389,101,0.104354219869691,id37a54bbf,left_wrist,4.01262593269348,-3,-3,14386,101
14383,102,0.227886780459724,id37a54bbf,left_hip,4.52509212493896,3,2,14386,101
14381,105,0.647836672020594,id37a54bbf,left_ankle,4.60535597801208,5,1,14386,101
14383,104,0.662033316917583,id37a54bbf,right_ankle,4.26087188720703,3,0,14386,101
17387,96,0.232988010753648,id3e3e50c7,left_wrist,2.7708580493927,1,-2,17388,93
17390,94,0.378748887553776,id3e3e50c7,left_hip,2.62665104866028,-2,-3,17388,93
17386,95,0.714966903233002,id3e3e50c7,left_ankle,2.65470886230469,2,0,17388,93
17387,94,0.736474009213123,id3e3e50c7,right_ankle,2.96678900718689,1,0,17388,93
8649,94,0.222100121800547,id3e3e50c7,left_wrist,2.7708580493927,1,1,8650,94
8652,93,0.365468578899402,id3e3e50c7,left_hip,2.62665104866028,-2,-1,8650,94
8649,94,0.691225993167038,id3e3e50c7,left_ankle,2.65470886230469,1,1,8650,94
8647,93,0.763286821001773,id3e3e50c7,right_ankle,2.96678900718689,3,4,8650,94
8465,93,0.208846488634233,id3e3e50c7,left_wrist,2.7708580493927,2,1,8467,92
8468,93,0.361276865745244,id3e3e50c7,left_hip,2.62665104866028,-1,-2,8467,92
8465,94,0.744991678423077,id3e3e50c7,left_ankle,2.65470886230469,2,0,8467,92
8463,93,0.783854332261473,id3e3e50c7,right_ankle,2.96678900718689,4,3,8467,92
3095,95,0.189789317033172,id3e3e50c7,left_wrist,2.7708580493927,3,2,3098,94
3098,94,0.360697094095151,id3e3e50c7,left_hip,2.62665104866028,0,0,3098,94
3096,95,0.729768830039479,id3e3e50c7,left_ankle,2.65470886230469,2,1,3098,94
3092,95,0.766342792950808,id3e3e50c7,right_ankle,2.96678900718689,6,5,3098,94
13112,87,0.206136147068812,id3e3e50c7,left_wrist,2.7708580493927,-1,3,13111,91
13114,91,0.405151598391639,id3e3e50c7,left_hip,2.62665104866028,-3,-3,13111,91
13110,90,0.689210732010358,id3e3e50c7,left_ankle,2.65470886230469,1,2,13111,91
13108,94,0.754292936567024,id3e3e50c7,right_ankle,2.96678900718689,3,0,13111,91
7910,90,0.193338533950964,id3e3e50c7,left_wrist,2.7708580493927,1,4,7911,93
7913,93,0.32521983011979,id3e3e50c7,left_hip,2.62665104866028,-2,-2,7911,93
7909,93,0.671996802531172,id3e3e50c7,left_ankle,2.65470886230469,2,2,7911,93
7908,94,0.758478527208974,id3e3e50c7,right_ankle,2.96678900718689,3,2,7911,93
8929,90,0.256468609776107,id3e3e50c7,left_wrist,2.7708580493927,0,2,8929,92
8931,91,0.387856033932962,id3e3e50c7,left_hip,2.62665104866028,-2,-1,8929,92
8926,92,0.734882348484231,id3e3e50c7,left_ankle,2.65470886230469,3,3,8929,92
8926,91,0.762366938411012,id3e3e50c7,right_ankle,2.96678900718689,3,4,8929,92
3661,90,0.195654378172117,id3e3e50c7,left_wrist,2.7708580493927,0,4,3661,94
3662,93,0.389197551157846,id3e3e50c7,left_hip,2.62665104866028,-1,0,3661,94
3660,93,0.789245598204579,id3e3e50c7,left_ankle,2.65470886230469,1,2,3661,94
3657,94,0.734508108862029,id3e3e50c7,right_ankle,2.96678900718689,4,4,3661,94
4032,98,0.222185329870839,id3e3e50c7,left_wrist,2.7708580493927,3,-1,4035,94
4035,94,0.392272031851494,id3e3e50c7,left_hip,2.62665104866028,0,0,4035,94
4033,95,0.746648020862795,id3e3e50c7,left_ankle,2.65470886230469,2,1,4035,94
4029,93,0.750592426757668,id3e3e50c7,right_ankle,2.96678900718689,6,7,4035,94
10382,90,0.209885943869338,id3e3e50c7,left_wrist,2.7708580493927,-1,2,10381,93
10383,92,0.401460252602085,id3e3e50c7,left_hip,2.62665104866028,-2,-1,10381,93
10380,92,0.732526057157665,id3e3e50c7,left_ankle,2.65470886230469,1,2,10381,93
10379,91,0.801552744858987,id3e3e50c7,right_ankle,2.96678900718689,2,4,10381,93
10104,93,0.20487277744772,id3e3e50c7,left_wrist,2.7708580493927,0,0,10104,93
10106,93,0.387263815410761,id3e3e50c7,left_hip,2.62665104866028,-2,-2,10104,93
10103,93,0.663828571300127,id3e3e50c7,left_ankle,2.65470886230469,1,1,10104,93
10101,95,0.759345445910982,id3e3e50c7,right_ankle,2.96678900718689,3,1,10104,93
1405,94,0.173484092813937,id3e3e50c7,left_wrist,2.7708580493927,1,2,1406,95
1407,94,0.406328557715319,id3e3e50c7,left_hip,2.62665104866028,-1,0,1406,95
1406,95,0.808740671018941,id3e3e50c7,left_ankle,2.65470886230469,0,0,1406,95
1404,93,0.758615718682081,id3e3e50c7,right_ankle,2.96678900718689,2,4,1406,95
649,95,0.202638808749479,id3e3e50c7,left_wrist,2.7708580493927,2,1,651,94
652,95,0.355010091977225,id3e3e50c7,left_hip,2.62665104866028,-1,-2,651,94
649,95,0.652119844844849,id3e3e50c7,left_ankle,2.65470886230469,2,1,651,94
647,96,0.736664610955125,id3e3e50c7,right_ankle,2.96678900718689,4,2,651,94
11196,89,0.230587673651707,id3e3e50c7,left_wrist,2.7708580493927,1,2,11197,90
11198,91,0.385752958953089,id3e3e50c7,left_hip,2.62665104866028,-1,-2,11197,90
11195,90,0.696979594740904,id3e3e50c7,left_ankle,2.65470886230469,2,2,11197,90
11194,92,0.806766045748191,id3e3e50c7,right_ankle,2.96678900718689,3,1,11197,90
16110,92,0.231834956249002,id3e3e50c7,left_wrist,2.7708580493927,1,0,16111,91
16113,91,0.418509204221353,id3e3e50c7,left_hip,2.62665104866028,-2,-2,16111,91
16109,91,0.72946802256837,id3e3e50c7,left_ankle,2.65470886230469,2,2,16111,91
16110,91,0.799350491120515,id3e3e50c7,right_ankle,2.96678900718689,1,1,16111,91
10471,91,0.220342016637147,id3e3e50c7,left_wrist,2.7708580493927,2,3,10473,92
10474,92,0.392020608669101,id3e3e50c7,left_hip,2.62665104866028,-1,-1,10473,92
10471,92,0.678334220131309,id3e3e50c7,left_ankle,2.65470886230469,2,2,10473,92
10469,95,0.794021216846411,id3e3e50c7,right_ankle,2.96678900718689,4,1,10473,92
9740,95,0.218296425765224,id3e3e50c7,left_wrist,2.7708580493927,2,-2,9742,91
9744,91,0.388826876890902,id3e3e50c7,left_hip,2.62665104866028,-2,-2,9742,91
9740,92,0.789025849473052,id3e3e50c7,left_ankle,2.65470886230469,2,1,9742,91
9738,92,0.777125634164228,id3e3e50c7,right_ankle,2.96678900718689,4,3,9742,91
9199,92,0.195040007387042,id3e3e50c7,left_wrist,2.7708580493927,1,1,9200,92
9203,91,0.401641624058689,id3e3e50c7,left_hip,2.62665104866028,-3,-2,9200,92
9197,93,0.757865268958755,id3e3e50c7,left_ankle,2.65470886230469,3,2,9200,92
9199,91,0.706634220463933,id3e3e50c7,right_ankle,2.96678900718689,1,2,9200,92
17112,92,0.180773366712723,id3e3e50c7,left_wrist,2.7708580493927,1,0,17113,91
17115,92,0.391437999456206,id3e3e50c7,left_hip,2.62665104866028,-2,-3,17113,91
17112,91,0.691957579176096,id3e3e50c7,left_ankle,2.65470886230469,1,1,17113,91
17112,91,0.760446174998431,id3e3e50c7,right_ankle,2.96678900718689,1,1,17113,91
8929,90,0.256468609776107,id3e3e50c7,left_wrist,2.7708580493927,0,2,8929,92
8931,91,0.387856033932962,id3e3e50c7,left_hip,2.62665104866028,-2,-1,8929,92
8926,92,0.734882348484231,id3e3e50c7,left_ankle,2.65470886230469,3,3,8929,92
8926,91,0.762366938411012,id3e3e50c7,right_ankle,2.96678900718689,3,4,8929,92
15082,97,0.171919449441249,idf1ce9a0f,left_wrist,4.65337610244751,-3,-5,15079,95
15076,98,0.255196323202677,idf1ce9a0f,left_hip,4.03278613090515,3,0,15079,95
15077,98,0.951559976928306,idf1ce9a0f,left_ankle,3.70895409584045,2,-1,15079,95
15079,97,0.761722460364759,idf1ce9a0f,right_ankle,3.83608889579773,0,-2,15079,95
13358,96,0.151776188138,idf1ce9a0f,left_wrist,4.65337610244751,-5,-3,13353,98
13352,96,0.256212289775611,idf1ce9a0f,left_hip,4.03278613090515,1,3,13353,98
13352,98,0.98759936033259,idf1ce9a0f,left_ankle,3.70895409584045,1,1,13353,98
13354,97,0.814157297507006,idf1ce9a0f,right_ankle,3.83608889579773,-1,0,13353,98
5316,97,0.0986208632874256,idf1ce9a0f,left_wrist,4.65337610244751,-5,-6,5311,96
5309,98,0.239416318283997,idf1ce9a0f,left_hip,4.03278613090515,2,0,5311,96
5309,98,0.893125089680967,idf1ce9a0f,left_ankle,3.70895409584045,2,0,5311,96
5311,98,0.723184610896633,idf1ce9a0f,right_ankle,3.83608889579773,0,-2,5311,96
5804,101,0.139985806123355,idf1ce9a0f,left_wrist,4.65337610244751,-6,-9,5798,98
5796,100,0.231863645714528,idf1ce9a0f,left_hip,4.03278613090515,2,0,5798,98
5796,100,0.965098680095394,idf1ce9a0f,left_ankle,3.70895409584045,2,0,5798,98
5799,100,0.676860446673729,idf1ce9a0f,right_ankle,3.83608889579773,-1,-3,5798,98
16134,95,0.257749951797399,idf1ce9a0f,left_wrist,4.65337610244751,-7,-6,16127,96
16126,96,0.299305694253215,idf1ce9a0f,left_hip,4.03278613090515,1,1,16127,96
16128,95,0.909232343413575,idf1ce9a0f,left_ankle,3.70895409584045,-1,0,16127,96
16128,96,0.791155292803606,idf1ce9a0f,right_ankle,3.83608889579773,-1,-1,16127,96
10084,96,0.255611361616645,idf1ce9a0f,left_wrist,4.65337610244751,2,3,10086,97
10085,96,0.257098319030684,idf1ce9a0f,left_hip,4.03278613090515,1,2,10086,97
10086,97,0.909646026077721,idf1ce9a0f,left_ankle,3.70895409584045,0,0,10086,97
10087,97,0.743804590487212,idf1ce9a0f,right_ankle,3.83608889579773,-1,-1,10086,97
3950,87,0.126700918379092,idf1ce9a0f,left_wrist,4.65337610244751,-9,2,3941,98
3941,98,0.257732396240709,idf1ce9a0f,left_hip,4.03278613090515,0,0,3941,98
3940,98,0.972979950405452,idf1ce9a0f,left_ankle,3.70895409584045,1,1,3941,98
3942,99,0.745788118353866,idf1ce9a0f,right_ankle,3.83608889579773,-1,-2,3941,98
16508,99,0.211671250102116,idf1ce9a0f,left_wrist,4.65337610244751,-6,-10,16502,95
16503,94,0.28916483717029,idf1ce9a0f,left_hip,4.03278613090515,-1,0,16502,95
16504,95,0.905255517513011,idf1ce9a0f,left_ankle,3.70895409584045,-2,-2,16502,95
16506,94,0.80664321154049,idf1ce9a0f,right_ankle,3.83608889579773,-4,-3,16502,95
2397,96,0.133267717055779,idf1ce9a0f,left_wrist,4.65337610244751,-6,-6,2391,96
2391,95,0.256812721750491,idf1ce9a0f,left_hip,4.03278613090515,0,1,2391,96
2391,96,1.01658360181648,idf1ce9a0f,left_ankle,3.70895409584045,0,0,2391,96
2391,98,0.799724205279147,idf1ce9a0f,right_ankle,3.83608889579773,0,-2,2391,96
19146,71,0.226176520915821,idf1ce9a0f,left_wrist,4.65337610244751,-24,-2,19122,93
19120,95,0.309095566201388,idf1ce9a0f,left_hip,4.03278613090515,2,0,19122,93
19123,95,0.940455202922512,idf1ce9a0f,left_ankle,3.70895409584045,-1,-3,19122,93
19123,95,0.799347551617163,idf1ce9a0f,right_ankle,3.83608889579773,-1,-3,19122,93
13647,96,0.19487573222256,idf1ce9a0f,left_wrist,4.65337610244751,-8,-5,13639,99
13641,96,0.265746861729732,idf1ce9a0f,left_hip,4.03278613090515,-2,1,13639,99
13641,97,0.865628936514519,idf1ce9a0f,left_ankle,3.70895409584045,-2,0,13639,99
13644,95,0.761178232667246,idf1ce9a0f,right_ankle,3.83608889579773,-5,-1,13639,99
12392,97,0.242713864214501,idf1ce9a0f,left_wrist,4.65337610244751,-6,-4,12386,99
12385,97,0.272900120555282,idf1ce9a0f,left_hip,4.03278613090515,1,3,12386,99
12386,97,0.93148756487841,idf1ce9a0f,left_ankle,3.70895409584045,0,2,12386,99
12387,97,0.717129329525777,idf1ce9a0f,right_ankle,3.83608889579773,-1,1,12386,99
7374,98,0.134636488046005,idf1ce9a0f,left_wrist,4.65337610244751,-6,-5,7368,99
7368,99,0.232291209159904,idf1ce9a0f,left_hip,4.03278613090515,0,0,7368,99
7369,98,0.947533525594965,idf1ce9a0f,left_ankle,3.70895409584045,-1,0,7368,99
7370,100,0.752338350416302,idf1ce9a0f,right_ankle,3.83608889579773,-2,-3,7368,99
10084,96,0.255611361616645,idf1ce9a0f,left_wrist,4.65337610244751,2,3,10086,97
10085,96,0.257098319030684,idf1ce9a0f,left_hip,4.03278613090515,1,2,10086,97
10086,97,0.909646026077721,idf1ce9a0f,left_ankle,3.70895409584045,0,0,10086,97
10087,97,0.743804590487212,idf1ce9a0f,right_ankle,3.83608889579773,-1,-1,10086,97
11207,86,0.311563341380254,idf1ce9a0f,left_wrist,4.65337610244751,-61,-49,11146,98
11143,98,0.238472666070437,idf1ce9a0f,left_hip,4.03278613090515,3,3,11146,98
11144,98,0.906781640151043,idf1ce9a0f,left_ankle,3.70895409584045,2,2,11146,98
11147,97,0.784415305172029,idf1ce9a0f,right_ankle,3.83608889579773,-1,0,11146,98
4047,99,0.153319918304737,idf1ce9a0f,left_wrist,4.65337610244751,-9,-8,4038,100
4038,100,0.24831927775056,idf1ce9a0f,left_hip,4.03278613090515,0,0,4038,100
4037,101,0.894223224924081,idf1ce9a0f,left_ankle,3.70895409584045,1,0,4038,100
4040,101,0.767935970567047,idf1ce9a0f,right_ankle,3.83608889579773,-2,-3,4038,100
11723,100,0.261554296251948,idf1ce9a0f,left_wrist,4.65337610244751,-4,-7,11719,97
11718,96,0.268317842218732,idf1ce9a0f,left_hip,4.03278613090515,1,2,11719,97
11719,96,0.919926629300851,idf1ce9a0f,left_ankle,3.70895409584045,0,1,11719,97
11721,97,0.746437771753415,idf1ce9a0f,right_ankle,3.83608889579773,-2,-2,11719,97
1717,100,0.152896988364927,idf1ce9a0f,left_wrist,4.65337610244751,-7,-10,1710,97
1708,99,0.224938859933552,idf1ce9a0f,left_hip,4.03278613090515,2,0,1710,97
1709,99,0.914361012949961,idf1ce9a0f,left_ankle,3.70895409584045,1,-1,1710,97
1711,98,0.751455021847915,idf1ce9a0f,right_ankle,3.83608889579773,-1,-2,1710,97
6193,100,0.147358626990614,idf1ce9a0f,left_wrist,4.65337610244751,-4,-6,6189,98
6187,99,0.234017494109216,idf1ce9a0f,left_hip,4.03278613090515,2,1,6189,98
6187,99,0.903820695747833,idf1ce9a0f,left_ankle,3.70895409584045,2,1,6189,98
6188,100,0.66603767205233,idf1ce9a0f,right_ankle,3.83608889579773,1,-1,6189,98
4734,95,0.118848580618878,idf1ce9a0f,left_wrist,4.65337610244751,-6,-2,4728,99
4727,97,0.280654309714846,idf1ce9a0f,left_hip,4.03278613090515,1,3,4728,99
4727,97,0.883139962375623,idf1ce9a0f,left_ankle,3.70895409584045,1,3,4728,99
4729,97,0.760711992688462,idf1ce9a0f,right_ankle,3.83608889579773,-1,1,4728,99
6145,117,0.150475079603695,idecc9265e,left_wrist,4.16588711738586,6,3,6151,114
6149,115,0.236917123866641,idecc9265e,left_hip,3.12049007415771,2,1,6151,114
6146,115,0.61795443044453,idecc9265e,left_ankle,3.11086416244507,5,4,6151,114
6145,115,0.670785261478298,idecc9265e,right_ankle,3.11068916320801,6,5,6151,114
18996,113,0.186188769102544,idecc9265e,left_wrist,4.16588711738586,-8,-9,18988,112
18995,112,0.261011402967074,idecc9265e,left_hip,3.12049007415771,-7,-7,18988,112
18992,112,0.626626895025136,idecc9265e,left_ankle,3.11086416244507,-4,-4,18988,112
18992,112,0.729565362774577,idecc9265e,right_ankle,3.11068916320801,-4,-4,18988,112
9602,58,0.138431235342649,idecc9265e,left_wrist,4.16588711738586,-14,49,9588,121
9593,123,0.190699174053672,idecc9265e,left_hip,3.12049007415771,-5,-7,9588,121
9594,118,0.596667512929379,idecc9265e,left_ankle,3.11086416244507,-6,-3,9588,121
9588,122,0.556739363050088,idecc9265e,right_ankle,3.11068916320801,0,-1,9588,121
16638,117,0.230237544911888,idecc9265e,left_wrist,4.16588711738586,-10,-14,16628,113
16635,113,0.233186628846798,idecc9265e,left_hip,3.12049007415771,-7,-7,16628,113
16631,119,0.633416070410138,idecc9265e,left_ankle,3.11086416244507,-3,-9,16628,113
16631,114,0.757180926680979,idecc9265e,right_ankle,3.11068916320801,-3,-4,16628,113
18886,111,0.232112688337617,idecc9265e,left_wrist,4.16588711738586,-9,-8,18877,112
18883,113,0.255397307041756,idecc9265e,left_hip,3.12049007415771,-6,-7,18877,112
18880,113,0.643528473821678,idecc9265e,left_ankle,3.11086416244507,-3,-4,18877,112
18880,113,0.647733145755255,idecc9265e,right_ankle,3.11068916320801,-3,-4,18877,112
8887,123,0.212970298364346,idecc9265e,left_wrist,4.16588711738586,-2,-8,8885,117
8889,118,0.228785308216423,idecc9265e,left_hip,3.12049007415771,-4,-5,8885,117
8889,117,0.659512589615256,idecc9265e,left_ankle,3.11086416244507,-4,-4,8885,117
8887,117,0.700540246249196,idecc9265e,right_ankle,3.11068916320801,-2,-2,8885,117
1374,112,0.176748556053066,idecc9265e,left_wrist,4.16588711738586,-13,-10,1361,115
1367,116,0.220978195670064,idecc9265e,left_hip,3.12049007415771,-6,-7,1361,115
1365,115,0.619535390278798,idecc9265e,left_ankle,3.11086416244507,-4,-4,1361,115
1366,114,0.699066105592254,idecc9265e,right_ankle,3.11068916320801,-5,-4,1361,115
7185,117,0.154070398074685,idecc9265e,left_wrist,4.16588711738586,-9,-11,7176,115
7183,114,0.237619004954622,idecc9265e,left_hip,3.12049007415771,-7,-6,7176,115
7179,116,0.639273489115766,idecc9265e,left_ankle,3.11086416244507,-3,-4,7176,115
7179,115,0.732631119518155,idecc9265e,right_ankle,3.11068916320801,-3,-3,7176,115
15502,115,0.206704937552178,idecc9265e,left_wrist,4.16588711738586,-9,-9,15493,115
15499,117,0.244890728009624,idecc9265e,left_hip,3.12049007415771,-6,-8,15493,115
15497,115,0.649589173900454,idecc9265e,left_ankle,3.11086416244507,-4,-4,15493,115
15496,116,0.732806108293748,idecc9265e,right_ankle,3.11068916320801,-3,-4,15493,115
7301,115,0.133280687058848,idecc9265e,left_wrist,4.16588711738586,-11,-11,7290,115
7296,116,0.20503975461616,idecc9265e,left_hip,3.12049007415771,-6,-7,7290,115
7294,116,0.624373872563286,idecc9265e,left_ankle,3.11086416244507,-4,-5,7290,115
7293,116,0.707384240643767,idecc9265e,right_ankle,3.11068916320801,-3,-4,7290,115
13593,111,0.192582449484874,idecc9265e,left_wrist,4.16588711738586,-11,-7,13582,115
13587,116,0.225029329084012,idecc9265e,left_hip,3.12049007415771,-5,-6,13582,115
13586,115,0.658699428849287,idecc9265e,left_ankle,3.11086416244507,-4,-4,13582,115
13584,115,0.64809315549444,idecc9265e,right_ankle,3.11068916320801,-2,-2,13582,115
17875,114,0.222156267963938,idecc9265e,left_wrist,4.16588711738586,-8,-9,17867,113
17874,113,0.262605300970701,idecc9265e,left_hip,3.12049007415771,-7,-7,17867,113
17870,113,0.661429733863582,idecc9265e,left_ankle,3.11086416244507,-3,-3,17867,113
17871,113,0.720207063857164,idecc9265e,right_ankle,3.11068916320801,-4,-4,17867,113
18209,116,0.171358269304856,idecc9265e,left_wrist,4.16588711738586,-7,-9,18202,114
18209,112,0.245516604391473,idecc9265e,left_hip,3.12049007415771,-7,-5,18202,114
18205,117,0.635766676901507,idecc9265e,left_ankle,3.11086416244507,-3,-6,18202,114
18206,113,0.722020461498981,idecc9265e,right_ankle,3.11068916320801,-4,-3,18202,114
8325,110,0.177616150559059,idecc9265e,left_wrist,4.16588711738586,-9,-5,8316,114
8321,116,0.24612504677082,idecc9265e,left_hip,3.12049007415771,-5,-7,8316,114
8319,114,0.595439355941365,idecc9265e,left_ankle,3.11086416244507,-3,-3,8316,114
8319,114,0.667200197992829,idecc9265e,right_ankle,3.11068916320801,-3,-3,8316,114
8208,118,0.142091207303705,idecc9265e,left_wrist,4.16588711738586,-7,-9,8201,116
8207,115,0.235540910579728,idecc9265e,left_hip,3.12049007415771,-6,-5,8201,116
8205,115,0.641091526929281,idecc9265e,left_ankle,3.11086416244507,-4,-3,8201,116
8203,117,0.724596883958256,idecc9265e,right_ankle,3.11068916320801,-2,-3,8201,116
19108,118,0.201696476563003,idecc9265e,left_wrist,4.16588711738586,-9,-11,19099,116
19106,115,0.233589053680465,idecc9265e,left_hip,3.12049007415771,-7,-6,19099,116
19103,116,0.607223278179078,idecc9265e,left_ankle,3.11086416244507,-4,-4,19099,116
19103,114,0.667815849921856,idecc9265e,right_ankle,3.11068916320801,-4,-2,19099,116
13703,109,0.146948396356535,idecc9265e,left_wrist,4.16588711738586,-7,-4,13696,112
13702,112,0.228974020961652,idecc9265e,left_hip,3.12049007415771,-6,-6,13696,112
13700,110,0.593725856428101,idecc9265e,left_ankle,3.11086416244507,-4,-2,13696,112
13698,114,0.704213817317601,idecc9265e,right_ankle,3.11068916320801,-2,-4,13696,112
15841,115,0.198696588578764,idecc9265e,left_wrist,4.16588711738586,-9,-10,15832,114
15840,114,0.239550752889384,idecc9265e,left_hip,3.12049007415771,-8,-8,15832,114
15836,114,0.575791963482347,idecc9265e,left_ankle,3.11086416244507,-4,-4,15832,114
15836,115,0.697000506454352,idecc9265e,right_ankle,3.11068916320801,-4,-5,15832,114
12910,116,0.162551930421316,idecc9265e,left_wrist,4.16588711738586,-11,-11,12899,116
12907,114,0.231568377456738,idecc9265e,left_hip,3.12049007415771,-8,-6,12899,116
12903,116,0.625195790024861,idecc9265e,left_ankle,3.11086416244507,-4,-4,12899,116
12903,116,0.67285835514457,idecc9265e,right_ankle,3.11068916320801,-4,-4,12899,116
19225,113,0.175243913958563,idecc9265e,left_wrist,4.16588711738586,-11,-10,19214,114
19220,114,0.246772966879345,idecc9265e,left_hip,3.12049007415771,-6,-6,19214,114
19218,113,0.640385353547306,idecc9265e,left_ankle,3.11086416244507,-4,-3,19214,114
19216,115,0.688940367013555,idecc9265e,right_ankle,3.11068916320801,-2,-3,19214,114
5804,102,0.129494269229894,id687ab496,left_wrist,3.60501980781555,-4,-4,5800,102
5791,109,0.279590949989038,id687ab496,left_hip,2.96911311149597,9,2,5800,102
5796,103,0.748284496030048,id687ab496,left_ankle,3.63504099845886,4,3,5800,102
5797,103,0.724977798355599,id687ab496,right_ankle,3.58052611351013,3,2,5800,102
3786,104,0.122762678718035,id687ab496,left_wrist,3.60501980781555,4,1,3790,101
3787,103,0.281171201859502,id687ab496,left_hip,2.96911311149597,3,1,3790,101
3784,103,0.757513016965945,id687ab496,left_ankle,3.63504099845886,6,4,3790,101
3787,100,0.676458899854693,id687ab496,right_ankle,3.58052611351013,3,4,3790,101
17425,106,0.310689540750534,id687ab496,left_wrist,3.60501980781555,45,40,17470,101
17469,102,0.277412774727351,id687ab496,left_hip,2.96911311149597,1,0,17470,101
17469,102,0.738164819620066,id687ab496,left_ankle,3.63504099845886,1,0,17470,101
17469,101,0.686272476790134,id687ab496,right_ankle,3.58052611351013,1,1,17470,101
9959,99,0.188027980346006,id687ab496,left_wrist,3.60501980781555,-3,-1,9956,101
9956,100,0.323004839368265,id687ab496,left_hip,2.96911311149597,0,1,9956,101
9952,104,0.723588895717444,id687ab496,left_ankle,3.63504099845886,4,1,9956,101
9954,99,0.657064053565425,id687ab496,right_ankle,3.58052611351013,2,4,9956,101
17276,56,0.161309299192092,id687ab496,left_wrist,3.60501980781555,-4,39,17272,99
17271,101,0.328884808046159,id687ab496,left_hip,2.96911311149597,1,-1,17272,99
17271,100,0.759011223827508,id687ab496,left_ankle,3.63504099845886,1,0,17272,99
17270,98,0.681971556978177,id687ab496,right_ankle,3.58052611351013,2,3,17272,99
3786,104,0.122762678718035,id687ab496,left_wrist,3.60501980781555,3,1,3789,102
3787,103,0.281171201859502,id687ab496,left_hip,2.96911311149597,2,1,3789,102
3784,103,0.757513016965945,id687ab496,left_ankle,3.63504099845886,5,4,3789,102
3787,100,0.676458899854693,id687ab496,right_ankle,3.58052611351013,2,4,3789,102
14916,99,0.247449633231356,id687ab496,left_wrist,3.60501980781555,44,45,14960,100
14961,99,0.30820051387488,id687ab496,left_hip,2.96911311149597,-1,0,14960,100
14959,101,0.704682374845343,id687ab496,left_ankle,3.63504099845886,1,0,14960,100
14957,100,0.701662746368906,id687ab496,right_ankle,3.58052611351013,3,3,14960,100
14264,56,0.118900821072164,id687ab496,left_wrist,3.60501980781555,2,45,14266,99
14265,100,0.290921797031492,id687ab496,left_hip,2.96911311149597,1,0,14266,99
14265,101,0.792680605061531,id687ab496,left_ankle,3.63504099845886,1,-1,14266,99
14262,99,0.672863983826782,id687ab496,right_ankle,3.58052611351013,4,4,14266,99
18524,100,0.239988403463462,id687ab496,left_wrist,3.60501980781555,45,46,18569,101
18569,101,0.331721587637723,id687ab496,left_hip,2.96911311149597,0,0,18569,101
18569,100,0.790834076418048,id687ab496,left_ankle,3.63504099845886,0,1,18569,101
18566,101,0.593458712385699,id687ab496,right_ankle,3.58052611351013,3,3,18569,101
10858,106,0.186774929192855,id687ab496,left_wrist,3.60501980781555,2,-2,10860,102
10858,102,0.258499793396827,id687ab496,left_hip,2.96911311149597,2,2,10860,102
10858,101,0.732652679089885,id687ab496,left_ankle,3.63504099845886,2,3,10860,102
10856,103,0.679781187904642,id687ab496,right_ankle,3.58052611351013,4,3,10860,102
14072,99,0.141130081953278,id687ab496,left_wrist,3.60501980781555,-3,-2,14069,100
14069,99,0.300692556825903,id687ab496,left_hip,2.96911311149597,0,1,14069,100
14069,99,0.775105318416625,id687ab496,left_ankle,3.63504099845886,0,1,14069,100
14065,99,0.673920774899401,id687ab496,right_ankle,3.58052611351013,4,5,14069,100
7710,77,0.17731749626118,id687ab496,left_wrist,3.60501980781555,15,40,7725,102
7725,102,0.302123077012143,id687ab496,left_hip,2.96911311149597,0,0,7725,102
7722,102,0.776484590979762,id687ab496,left_ankle,3.63504099845886,3,3,7725,102
7723,101,0.609024751333437,id687ab496,right_ankle,3.58052611351013,2,3,7725,102
2176,104,0.177079695516113,id687ab496,left_wrist,3.60501980781555,1,0,2177,103
2176,102,0.284510472750406,id687ab496,left_hip,2.96911311149597,1,2,2177,103
2173,102,0.714623632211196,id687ab496,left_ankle,3.63504099845886,4,5,2177,103
2174,101,0.648211038533616,id687ab496,right_ankle,3.58052611351013,3,5,2177,103
18277,99,0.227053132868987,id687ab496,left_wrist,3.60501980781555,-4,-4,18273,99
18272,101,0.306851031288999,id687ab496,left_hip,2.96911311149597,1,-1,18273,99
18271,101,0.754734595731125,id687ab496,left_ankle,3.63504099845886,2,0,18273,99
18268,102,0.699514932162909,id687ab496,right_ankle,3.58052611351013,5,2,18273,99
5652,109,0.137715541765032,id687ab496,left_wrist,3.60501980781555,45,40,5697,104
5688,104,0.251527060893395,id687ab496,left_hip,2.96911311149597,9,9,5697,104
5693,104,0.79787420120707,id687ab496,left_ankle,3.63504099845886,4,4,5697,104
5696,102,0.653876965456892,id687ab496,right_ankle,3.58052611351013,1,3,5697,104
11756,103,0.14525341412042,id687ab496,left_wrist,3.60501980781555,2,1,11758,102
11758,102,0.262129792586182,id687ab496,left_hip,2.96911311149597,0,0,11758,102
11758,101,0.769624889308849,id687ab496,left_ankle,3.63504099845886,0,1,11758,102
11756,102,0.58918023536658,id687ab496,right_ankle,3.58052611351013,2,2,11758,102
2176,104,0.177079695516113,id687ab496,left_wrist,3.60501980781555,-5,-7,2171,102
2176,102,0.284510472750406,id687ab496,left_hip,2.96911311149597,-5,-5,2171,102
2173,102,0.714623632211196,id687ab496,left_ankle,3.63504099845886,-2,-2,2171,102
2174,101,0.648211038533616,id687ab496,right_ankle,3.58052611351013,-3,-2,2171,102
16568,101,0.215324958427291,id687ab496,left_wrist,3.60501980781555,-5,-3,16563,103
16564,102,0.277215514600905,id687ab496,left_hip,2.96911311149597,-1,0,16563,103
16560,103,0.738501213516585,id687ab496,left_ankle,3.63504099845886,3,3,16563,103
16561,103,0.684882161225109,id687ab496,right_ankle,3.58052611351013,2,2,16563,103
6265,105,0.27310050209436,id687ab496,left_wrist,3.60501980781555,50,46,6315,101
6312,103,0.297136142455773,id687ab496,left_hip,2.96911311149597,3,1,6315,101
6313,99,0.748693397918152,id687ab496,left_ankle,3.63504099845886,2,4,6315,101
6311,101,0.655213650136588,id687ab496,right_ankle,3.58052611351013,4,4,6315,101
15457,105,0.18380173621529,id687ab496,left_wrist,3.60501980781555,1,1,15458,105
15458,104,0.265058586100494,id687ab496,left_hip,2.96911311149597,0,1,15458,105
15455,105,0.671976486752408,id687ab496,left_ankle,3.63504099845886,3,3,15458,105
15458,100,0.65413186253173,id687ab496,right_ankle,3.58052611351013,0,5,15458,105
6046,103,0.200193917950225,id1f372081,left_wrist,3.93741703033447,-1,3,6045,107
6044,107,0.269204372252811,id1f372081,left_hip,4.35353088378906,1,1,6045,107
6044,107,0.610212685058127,id1f372081,left_ankle,4.03008699417114,1,1,6045,107
6044,105,0.562986401078574,id1f372081,right_ankle,4.36854100227356,1,3,6045,107
4787,101,0.230815494244397,id1f372081,left_wrist,3.93741703033447,-2,5,4785,108
4785,107,0.27640888211839,id1f372081,left_hip,4.35353088378906,0,1,4785,108
4784,108,0.671794063689515,id1f372081,left_ankle,4.03008699417114,1,1,4785,108
4784,107,0.534943187107165,id1f372081,right_ankle,4.36854100227356,1,2,4785,108
11299,104,0.289544640728637,id1f372081,left_wrist,3.93741703033447,-12,-13,11287,103
11296,104,0.287332091503397,id1f372081,left_hip,4.35353088378906,-9,-10,11287,103
11294,103,0.545212971986297,id1f372081,left_ankle,4.03008699417114,-7,-7,11287,103
11291,106,0.498630427125471,id1f372081,right_ankle,4.36854100227356,-4,-7,11287,103
5940,107,0.201066820593042,id1f372081,left_wrist,3.93741703033447,-1,-1,5939,107
5937,108,0.259340101510986,id1f372081,left_hip,4.35353088378906,2,1,5939,107
5937,108,0.647552408243428,id1f372081,left_ankle,4.03008699417114,2,1,5939,107
5937,108,0.520900186007037,id1f372081,right_ankle,4.36854100227356,2,1,5939,107
4040,120,0.122996393971557,id1f372081,left_wrist,3.93741703033447,6,-6,4046,108
4045,107,0.278121771034422,id1f372081,left_hip,4.35353088378906,1,2,4046,108
4046,106,0.659239199924494,id1f372081,left_ankle,4.03008699417114,0,2,4046,108
4046,103,0.558832225503055,id1f372081,right_ankle,4.36854100227356,0,5,4046,108
11402,108,0.294352717308949,id1f372081,left_wrist,3.93741703033447,-13,-14,11389,107
11399,105,0.259404727841153,id1f372081,left_hip,4.35353088378906,-10,-8,11389,107
11396,106,0.586206226564774,id1f372081,left_ankle,4.03008699417114,-7,-6,11389,107
11396,104,0.503846104976058,id1f372081,right_ankle,4.36854100227356,-7,-4,11389,107
12335,106,0.160941470063535,id1f372081,left_wrist,3.93741703033447,-7,-9,12328,104
12333,105,0.242688981428842,id1f372081,left_hip,4.35353088378906,-5,-6,12328,104
12334,106,0.553449292210905,id1f372081,left_ankle,4.03008699417114,-6,-8,12328,104
12334,104,0.558259204228978,id1f372081,right_ankle,4.36854100227356,-6,-6,12328,104
2873,113,0.172323724815691,id1f372081,left_wrist,3.93741703033447,0,-6,2873,107
2871,106,0.269275760189627,id1f372081,left_hip,4.35353088378906,2,3,2873,107
2872,104,0.622121903493377,id1f372081,left_ankle,4.03008699417114,1,4,2873,107
2871,106,0.560794485782798,id1f372081,right_ankle,4.36854100227356,2,3,2873,107
5729,106,0.215932268297801,id1f372081,left_wrist,3.93741703033447,0,0,5729,106
5728,106,0.275774070549964,id1f372081,left_hip,4.35353088378906,1,1,5729,106
5728,105,0.712440197350269,id1f372081,left_ankle,4.03008699417114,1,2,5729,106
5727,105,0.609157817731472,id1f372081,right_ankle,4.36854100227356,2,3,5729,106
15687,104,0.295704128075435,id1f372081,left_wrist,3.93741703033447,-11,-13,15676,102
15684,106,0.255172039668004,id1f372081,left_hip,4.35353088378906,-8,-12,15676,102
15682,102,0.513929918171079,id1f372081,left_ankle,4.03008699417114,-6,-6,15676,102
15680,106,0.537108946486842,id1f372081,right_ankle,4.36854100227356,-4,-8,15676,102
20985,103,0.253837067407217,id1f372081,left_wrist,3.93741703033447,-10,-10,20975,103
20983,104,0.275997301265833,id1f372081,left_hip,4.35353088378906,-8,-9,20975,103
20982,102,0.606406269592843,id1f372081,left_ankle,4.03008699417114,-7,-6,20975,103
20980,105,0.550863279342304,id1f372081,right_ankle,4.36854100227356,-5,-7,20975,103
2230,113,0.23755148179579,id1f372081,left_wrist,3.93741703033447,-2,-7,2228,108
2232,109,0.270955684369513,id1f372081,left_hip,4.35353088378906,-4,-5,2228,108
2232,108,0.625268970337304,id1f372081,left_ankle,4.03008699417114,-4,-4,2228,108
2229,108,0.56067851231036,id1f372081,right_ankle,4.36854100227356,-1,-1,2228,108
16737,107,0.284709050889626,id1f372081,left_wrist,3.93741703033447,-14,-17,16723,104
16732,111,0.249507043662267,id1f372081,left_hip,4.35353088378906,-9,-16,16723,104
16729,106,0.577688908158771,id1f372081,left_ankle,4.03008699417114,-6,-8,16723,104
16731,105,0.550944797026044,id1f372081,right_ankle,4.36854100227356,-8,-9,16723,104
20783,97,0.291519321735379,id1f372081,left_wrist,3.93741703033447,-6,-1,20777,102
20781,100,0.308903143776046,id1f372081,left_hip,4.35353088378906,-4,-2,20777,102
20779,99,0.671295746303326,id1f372081,left_ankle,4.03008699417114,-2,1,20777,102
20775,105,0.5598440502583,id1f372081,right_ankle,4.36854100227356,2,-1,20777,102
17892,104,0.311996769625822,id1f372081,left_wrist,3.93741703033447,-14,-12,17878,106
17886,106,0.261040610423322,id1f372081,left_hip,4.35353088378906,-8,-8,17878,106
17885,104,0.644851985163615,id1f372081,left_ankle,4.03008699417114,-7,-5,17878,106
17886,106,0.513760682199884,id1f372081,right_ankle,4.36854100227356,-8,-8,17878,106
6790,105,0.22106334656408,id1f372081,left_wrist,3.93741703033447,-7,-6,6783,106
6788,106,0.282116095247103,id1f372081,left_hip,4.35353088378906,-5,-5,6783,106
6784,107,0.68911728247693,id1f372081,left_ankle,4.03008699417114,-1,-2,6783,106
6787,107,0.602205469453954,id1f372081,right_ankle,4.36854100227356,-4,-5,6783,106
14210,103,0.212620175305299,id1f372081,left_wrist,3.93741703033447,-11,-10,14199,104
14206,104,0.227729676240349,id1f372081,left_hip,4.35353088378906,-7,-7,14199,104
14204,104,0.639278402714018,id1f372081,left_ankle,4.03008699417114,-5,-5,14199,104
14202,103,0.568166092529303,id1f372081,right_ankle,4.36854100227356,-3,-2,14199,104
20783,97,0.291519321735379,id1f372081,left_wrist,3.93741703033447,-6,-1,20777,102
20781,100,0.308903143776046,id1f372081,left_hip,4.35353088378906,-4,-2,20777,102
20779,99,0.671295746303326,id1f372081,left_ankle,4.03008699417114,-2,1,20777,102
20775,105,0.5598440502583,id1f372081,right_ankle,4.36854100227356,2,-1,20777,102
20985,103,0.253837067407217,id1f372081,left_wrist,3.93741703033447,-3,-2,20982,104
20983,104,0.275997301265833,id1f372081,left_hip,4.35353088378906,-1,-1,20982,104
20982,102,0.606406269592843,id1f372081,left_ankle,4.03008699417114,0,2,20982,104
20980,105,0.550863279342304,id1f372081,right_ankle,4.36854100227356,2,1,20982,104
7527,104,0.227692525583598,id1f372081,left_wrist,3.93741703033447,-8,-8,7519,104
7525,104,0.271996401564429,id1f372081,left_hip,4.35353088378906,-6,-6,7519,104
7524,104,0.650841513680307,id1f372081,left_ankle,4.03008699417114,-5,-5,7519,104
7523,104,0.561630051716796,id1f372081,right_ankle,4.36854100227356,-4,-4,7519,104
5555,101,0.087579466858368,id079c763c,left_wrist,4.10278081893921,8,10,5563,103
5564,102,0.25991179894231,id079c763c,left_hip,3.94247794151306,-1,0,5563,103
5566,102,0.609091592201442,id079c763c,left_ankle,3.40837001800537,-3,-2,5563,103
5563,104,0.71295972245606,id079c763c,right_ankle,3.74637389183044,0,-1,5563,103
3590,109,0.0757746124333532,id079c763c,left_wrist,4.10278081893921,-31,-40,3559,100
3560,101,0.278590123290477,id079c763c,left_hip,3.94247794151306,-1,-2,3559,100
3562,100,0.725239869484204,id079c763c,left_ankle,3.40837001800537,-3,-3,3559,100
3562,99,0.783900822429558,id079c763c,right_ankle,3.74637389183044,-3,-2,3559,100
6778,106,0.163581353218285,id079c763c,left_wrist,4.10278081893921,9,7,6787,104
6789,104,0.238799021466834,id079c763c,left_hip,3.94247794151306,-2,-2,6787,104
6789,106,0.62924923166045,id079c763c,left_ankle,3.40837001800537,-2,-4,6787,104
6787,103,0.622669723237852,id079c763c,right_ankle,3.74637389183044,0,1,6787,104
10751,95,0.174626285896355,id079c763c,left_wrist,4.10278081893921,7,6,10758,94
10759,96,0.35201479457975,id079c763c,left_hip,3.94247794151306,-1,-3,10758,94
10760,97,0.749758641482975,id079c763c,left_ankle,3.40837001800537,-2,-5,10758,94
10761,96,0.666804870517424,id079c763c,right_ankle,3.74637389183044,-3,-5,10758,94
19308,95,0.177007699495355,id079c763c,left_wrist,4.10278081893921,-5,-5,19303,95
19309,93,0.382770341771344,id079c763c,left_hip,3.94247794151306,-6,-4,19303,95
19307,95,0.790352302528569,id079c763c,left_ankle,3.40837001800537,-4,-4,19303,95
19309,94,0.720623623212739,id079c763c,right_ankle,3.74637389183044,-6,-5,19303,95
10751,95,0.174626285896355,id079c763c,left_wrist,4.10278081893921,7,6,10758,94
10759,96,0.35201479457975,id079c763c,left_hip,3.94247794151306,-1,-3,10758,94
10760,97,0.749758641482975,id079c763c,left_ankle,3.40837001800537,-2,-5,10758,94
10761,96,0.666804870517424,id079c763c,right_ankle,3.74637389183044,-3,-5,10758,94
5454,102,0.134277887751076,id079c763c,left_wrist,4.10278081893921,8,8,5462,102
5464,101,0.283984975254341,id079c763c,left_hip,3.94247794151306,-2,-1,5462,102
5465,102,0.682831543134788,id079c763c,left_ankle,3.40837001800537,-3,-3,5462,102
5462,102,0.651526552416581,id079c763c,right_ankle,3.74637389183044,0,0,5462,102
1048,73,0.0994279182330686,id079c763c,left_wrist,4.10278081893921,9,30,1057,94
1058,94,0.320719695398513,id079c763c,left_hip,3.94247794151306,-1,-1,1057,94
1059,93,0.771479685506289,id079c763c,left_ankle,3.40837001800537,-2,-1,1057,94
1062,95,0.766864938581222,id079c763c,right_ankle,3.74637389183044,-5,-6,1057,94
8835,98,0.164488448645874,id079c763c,left_wrist,4.10278081893921,8,7,8843,97
8844,97,0.293555489143293,id079c763c,left_hip,3.94247794151306,-1,-1,8843,97
8846,96,0.733190780325762,id079c763c,left_ankle,3.40837001800537,-3,-2,8843,97
8848,94,0.673201316034478,id079c763c,right_ankle,3.74637389183044,-5,-2,8843,97
17924,88,0.170027258861152,id079c763c,left_wrist,4.10278081893921,-6,-3,17918,91
17924,91,0.396838048504684,id079c763c,left_hip,3.94247794151306,-6,-6,17918,91
17920,92,0.774650769431727,id079c763c,left_ankle,3.40837001800537,-2,-3,17918,91
17923,91,0.730435248940248,id079c763c,right_ankle,3.74637389183044,-5,-5,17918,91
7284,100,0.134087479396645,id079c763c,left_wrist,4.10278081893921,7,6,7291,99
7293,99,0.291193245903317,id079c763c,left_hip,3.94247794151306,-2,-2,7291,99
7295,99,0.711432267739714,id079c763c,left_ankle,3.40837001800537,-4,-4,7291,99
7294,99,0.636881546847525,id079c763c,right_ankle,3.74637389183044,-3,-3,7291,99
2763,102,0.174119738221611,id079c763c,left_wrist,4.10278081893921,8,6,2771,100
2771,101,0.330078649430073,id079c763c,left_hip,3.94247794151306,0,-1,2771,100
2772,101,0.744938038432285,id079c763c,left_ankle,3.40837001800537,-1,-2,2771,100
2771,100,0.691916715617813,id079c763c,right_ankle,3.74637389183044,0,0,2771,100
7866,100,0.0538468765382413,id079c763c,left_wrist,4.10278081893921,9,8,7875,99
7877,98,0.314756369559168,id079c763c,left_hip,3.94247794151306,-2,-1,7875,99
7879,98,0.741376749936478,id079c763c,left_ankle,3.40837001800537,-4,-3,7875,99
7880,97,0.740492770944857,id079c763c,right_ankle,3.74637389183044,-5,-3,7875,99
13417,97,0.0821680367143026,id079c763c,left_wrist,4.10278081893921,7,8,13424,98
13427,95,0.312557016888809,id079c763c,left_hip,3.94247794151306,-3,0,13424,98
13428,97,0.76739220370217,id079c763c,left_ankle,3.40837001800537,-4,-3,13424,98
13429,96,0.75228472112521,id079c763c,right_ankle,3.74637389183044,-5,-3,13424,98
8255,99,0.139681808037758,id079c763c,left_wrist,4.10278081893921,10,8,8265,97
8267,95,0.283043585863936,id079c763c,left_hip,3.94247794151306,-2,0,8265,97
8267,97,0.696908327844117,id079c763c,left_ankle,3.40837001800537,-2,-2,8265,97
8268,97,0.636516166426647,id079c763c,right_ankle,3.74637389183044,-3,-3,8265,97
14485,84,0.108948243060442,id079c763c,left_wrist,4.10278081893921,-6,8,14479,98
14478,100,0.262007907319337,id079c763c,left_hip,3.94247794151306,1,-1,14479,98
14481,100,0.757173585958017,id079c763c,left_ankle,3.40837001800537,-2,-4,14479,98
14482,96,0.708646938449011,id079c763c,right_ankle,3.74637389183044,-3,-1,14479,98
14665,110,0.141194315271353,id079c763c,left_wrist,4.10278081893921,8,-3,14673,99
14677,97,0.24370534920387,id079c763c,left_hip,3.94247794151306,-4,-2,14673,99
14675,100,0.755396834561632,id079c763c,left_ankle,3.40837001800537,-2,-3,14673,99
14676,98,0.72404113582139,id079c763c,right_ankle,3.74637389183044,-3,-2,14673,99
11630,91,0.223805931769032,id079c763c,left_wrist,4.10278081893921,-10,-4,11620,97
11622,99,0.355045075790997,id079c763c,left_hip,3.94247794151306,-2,-4,11620,97
11624,96,0.713712290509051,id079c763c,left_ankle,3.40837001800537,-4,-3,11620,97
11623,97,0.724241517797329,id079c763c,right_ankle,3.74637389183044,-3,-3,11620,97
9026,98,0.147159189824046,id079c763c,left_wrist,4.10278081893921,9,7,9035,96
9037,95,0.291718079843871,id079c763c,left_hip,3.94247794151306,-2,-1,9035,96
9037,97,0.74384491377137,id079c763c,left_ankle,3.40837001800537,-2,-3,9035,96
9038,97,0.734681101979729,id079c763c,right_ankle,3.74637389183044,-3,-4,9035,96
9605,93,0.0933658581215424,id079c763c,left_wrist,4.10278081893921,6,8,9611,95
9611,96,0.263410022674974,id079c763c,left_hip,3.94247794151306,0,-1,9611,95
9614,95,0.72335070130178,id079c763c,left_ankle,3.40837001800537,-3,-3,9611,95
9613,97,0.749420746667459,id079c763c,right_ankle,3.74637389183044,-2,-4,9611,95
5465,98,0.18888760332207,idbae5a811,left_wrist,3.07837104797363,-2,-6,5463,94
5459,97,0.252272979152135,idbae5a811,left_hip,3.08982992172241,4,1,5463,94
5462,99,0.64641560591363,idbae5a811,left_ankle,3.06130790710449,1,-4,5463,94
5460,99,0.595936911221973,idbae5a811,right_ankle,2.93668913841248,3,-2,5463,94
10342,90,0.1864847071803,idbae5a811,left_wrist,3.07837104797363,-4,-3,10338,91
10343,93,0.295822727448603,idbae5a811,left_hip,3.08982992172241,-5,-7,10338,91
10340,91,0.651875555000035,idbae5a811,left_ankle,3.06130790710449,-2,-2,10338,91
10340,92,0.668079691428367,idbae5a811,right_ankle,2.93668913841248,-2,-3,10338,91
16240,92,0.1595488948972,idbae5a811,left_wrist,3.07837104797363,-2,0,16238,94
16238,96,0.278698113265995,idbae5a811,left_hip,3.08982992172241,0,-2,16238,94
16237,93,0.639956286280095,idbae5a811,left_ankle,3.06130790710449,1,2,16238,94
16238,93,0.594771165428852,idbae5a811,right_ankle,2.93668913841248,0,1,16238,94
2597,91,0.190599937565958,idbae5a811,left_wrist,3.07837104797363,-3,2,2594,96
2598,91,0.309143736324095,idbae5a811,left_hip,3.08982992172241,-4,1,2594,96
2595,94,0.720844139494579,idbae5a811,left_ankle,3.06130790710449,-1,1,2594,96
2598,91,0.674948945572496,idbae5a811,right_ankle,2.93668913841248,-4,1,2594,96
7496,95,0.173445093738821,idbae5a811,left_wrist,3.07837104797363,-4,-5,7492,94
7498,92,0.270004026856016,idbae5a811,left_hip,3.08982992172241,-6,-4,7492,94
7496,94,0.637742590405738,idbae5a811,left_ankle,3.06130790710449,-4,-4,7492,94
7496,93,0.573937952843766,idbae5a811,right_ankle,2.93668913841248,-4,-3,7492,94
3771,91,0.239668593182156,idbae5a811,left_wrist,3.07837104797363,2,1,3773,90
3773,91,0.285135554145003,idbae5a811,left_hip,3.08982992172241,0,-1,3773,90
3771,91,0.733935481410819,idbae5a811,left_ankle,3.06130790710449,2,1,3773,90
3772,91,0.604486486666798,idbae5a811,right_ankle,2.93668913841248,1,0,3773,90
7685,90,0.165053425939943,idbae5a811,left_wrist,3.07837104797363,-5,-4,7680,91
7683,96,0.268170195681565,idbae5a811,left_hip,3.08982992172241,-3,-8,7680,91
7682,92,0.70680603779265,idbae5a811,left_ankle,3.06130790710449,-2,-3,7680,91
7683,93,0.646637117710224,idbae5a811,right_ankle,2.93668913841248,-3,-5,7680,91
2506,92,0.215180891161985,idbae5a811,left_wrist,3.07837104797363,-4,-3,2502,93
2505,94,0.282325835447144,idbae5a811,left_hip,3.08982992172241,-3,-4,2502,93
2506,90,0.727719665280292,idbae5a811,left_ankle,3.06130790710449,-4,-1,2502,93
2506,93,0.636574107906186,idbae5a811,right_ankle,2.93668913841248,-4,-4,2502,93
8237,97,0.14053633952763,idbae5a811,left_wrist,3.07837104797363,-4,-2,8233,99
8236,94,0.263226515363427,idbae5a811,left_hip,3.08982992172241,-3,2,8233,99
8235,95,0.625906347141682,idbae5a811,left_ankle,3.06130790710449,-2,2,8233,99
8234,95,0.60057508553077,idbae5a811,right_ankle,2.93668913841248,-1,3,8233,99
16835,90,0.11636234803542,idbae5a811,left_wrist,3.07837104797363,-49,-45,16786,94
16791,91,0.290516198693375,idbae5a811,left_hip,3.08982992172241,-5,-2,16786,94
16785,94,0.663726675500528,idbae5a811,left_ankle,3.06130790710449,1,1,16786,94
16787,92,0.573846853407976,idbae5a811,right_ankle,2.93668913841248,-1,1,16786,94
13599,92,0.149667064924718,idbae5a811,left_wrist,3.07837104797363,0,0,13599,92
13599,94,0.292169299480491,idbae5a811,left_hip,3.08982992172241,0,-2,13599,92
13597,92,0.687508407809301,idbae5a811,left_ankle,3.06130790710449,2,2,13599,92
13597,93,0.597927059511156,idbae5a811,right_ankle,2.93668913841248,2,1,13599,92
16560,101,0.161774044433966,idbae5a811,left_wrist,3.07837104797363,45,36,16605,92
16607,92,0.324708830974149,idbae5a811,left_hip,3.08982992172241,-2,-2,16605,92
16604,92,0.65577012276329,idbae5a811,left_ankle,3.06130790710449,1,1,16605,92
16605,92,0.595233996912301,idbae5a811,right_ankle,2.93668913841248,0,0,16605,92
8424,94,0.147064714229188,idbae5a811,left_wrist,3.07837104797363,1,1,8425,94
8424,94,0.277095141313284,idbae5a811,left_hip,3.08982992172241,1,1,8425,94
8424,93,0.678575846241473,idbae5a811,left_ankle,3.06130790710449,1,2,8425,94
8424,94,0.589852429630782,idbae5a811,right_ankle,2.93668913841248,1,1,8425,94
10787,91,0.197381064997007,idbae5a811,left_wrist,3.07837104797363,3,-3,10790,85
10791,92,0.252488690794672,idbae5a811,left_hip,3.08982992172241,-1,-8,10790,85
10789,89,0.719554609027192,idbae5a811,left_ankle,3.06130790710449,1,-3,10790,85
10790,89,0.59228621444513,idbae5a811,right_ankle,2.93668913841248,0,-4,10790,85
8702,91,0.18153683213242,idbae5a811,left_wrist,3.07837104797363,0,-5,8702,86
8702,93,0.28860728972146,idbae5a811,left_hip,3.08982992172241,0,-7,8702,86
8701,91,0.652303340920731,idbae5a811,left_ankle,3.06130790710449,1,-4,8702,86
8699,93,0.616525221273507,idbae5a811,right_ankle,2.93668913841248,3,-4,8702,86
1953,93,0.164622431761976,idbae5a811,left_wrist,3.07837104797363,0,-5,1953,88
1951,94,0.327061285011442,idbae5a811,left_hip,3.08982992172241,2,-4,1953,88
1951,94,0.719922358154588,idbae5a811,left_ankle,3.06130790710449,2,-4,1953,88
1951,94,0.682684477005461,idbae5a811,right_ankle,2.93668913841248,2,-4,1953,88
4412,97,0.192510510592563,idbae5a811,left_wrist,3.07837104797363,-1,-6,4411,92
4412,93,0.281551956612278,idbae5a811,left_hip,3.08982992172241,-1,-2,4411,92
4410,97,0.664225552069615,idbae5a811,left_ankle,3.06130790710449,1,-4,4411,92
4411,95,0.583137177918458,idbae5a811,right_ankle,2.93668913841248,0,-3,4411,92
8886,96,0.116542966227999,idbae5a811,left_wrist,3.07837104797363,-2,-1,8884,97
8884,94,0.272099614457415,idbae5a811,left_hip,3.08982992172241,0,3,8884,97
8883,97,0.689039250634863,idbae5a811,left_ankle,3.06130790710449,1,1,8884,97
8883,94,0.539158595362485,idbae5a811,right_ankle,2.93668913841248,1,4,8884,97
6679,95,0.182373990792511,idbae5a811,left_wrist,3.07837104797363,5,-1,6684,89
6682,92,0.242445661780057,idbae5a811,left_hip,3.08982992172241,2,-1,6684,89
6680,93,0.660435065095489,idbae5a811,left_ankle,3.06130790710449,4,0,6684,89
6679,91,0.533171070803522,idbae5a811,right_ankle,2.93668913841248,5,3,6684,89
16560,101,0.161774044433966,idbae5a811,left_wrist,3.07837104797363,45,36,16605,92
16607,92,0.324708830974149,idbae5a811,left_hip,3.08982992172241,-2,-2,16605,92
16604,92,0.65577012276329,idbae5a811,left_ankle,3.06130790710449,1,1,16605,92
16605,92,0.595233996912301,idbae5a811,right_ankle,2.93668913841248,0,0,16605,92
11757,119,0.231554857692834,id7c20ee7a,left_wrist,4.68353986740112,1,-15,11758,103
11752,110,0.169637863947954,id7c20ee7a,left_hip,4.60155296325684,6,-1,11758,103
11758,102,0.614394138880045,id7c20ee7a,left_ankle,4.15283918380737,0,1,11758,103
11760,101,0.656496249475427,id7c20ee7a,right_ankle,3.62808084487915,-2,0,11758,103
7325,109,0.171963308093709,id7c20ee7a,left_wrist,4.68353986740112,-50,-50,7275,109
7268,111,0.155951541727245,id7c20ee7a,left_hip,4.60155296325684,7,5,7275,109
7273,110,0.673353750441406,id7c20ee7a,left_ankle,4.15283918380737,2,1,7275,109
7272,110,0.606703156160746,id7c20ee7a,right_ankle,3.62808084487915,3,2,7275,109
6332,109,0.197192470235358,id7c20ee7a,left_wrist,4.68353986740112,-49,-50,6283,108
6277,110,0.176167853320132,id7c20ee7a,left_hip,4.60155296325684,6,4,6283,108
6280,110,0.613096311360327,id7c20ee7a,left_ankle,4.15283918380737,3,1,6283,108
6280,109,0.585132226943323,id7c20ee7a,right_ankle,3.62808084487915,3,2,6283,108
17722,106,0.102320663802002,id7c20ee7a,left_wrist,4.68353986740112,-1,0,17721,107
17719,106,0.193320744905172,id7c20ee7a,left_hip,4.60155296325684,2,3,17721,107
17722,105,0.61459632862196,id7c20ee7a,left_ankle,4.15283918380737,-1,1,17721,107
17719,108,0.551922338158941,id7c20ee7a,right_ankle,3.62808084487915,2,1,17721,107
15827,98,0.1092021694973,id7c20ee7a,left_wrist,4.68353986740112,-4,4,15823,106
15823,106,0.173690326198655,id7c20ee7a,left_hip,4.60155296325684,0,0,15823,106
15825,105,0.64264076243154,id7c20ee7a,left_ankle,4.15283918380737,-2,-1,15823,106
15823,106,0.672524180624799,id7c20ee7a,right_ankle,3.62808084487915,0,0,15823,106
3831,111,0.190236448177187,id7c20ee7a,left_wrist,4.68353986740112,-51,-51,3780,111
3775,112,0.176156542770306,id7c20ee7a,left_hip,4.60155296325684,5,4,3780,111
3778,110,0.548246087104353,id7c20ee7a,left_ankle,4.15283918380737,2,3,3780,111
3778,109,0.561827105221267,id7c20ee7a,right_ankle,3.62808084487915,2,4,3780,111
1634,107,0.153451388908968,id7c20ee7a,left_wrist,4.68353986740112,5,4,1639,106
1632,105,0.151794641528386,id7c20ee7a,left_hip,4.60155296325684,7,8,1639,106
1637,106,0.576361483905738,id7c20ee7a,left_ankle,4.15283918380737,2,2,1639,106
1637,106,0.537791926713409,id7c20ee7a,right_ankle,3.62808084487915,2,2,1639,106
17086,101,0.101874600729272,id7c20ee7a,left_wrist,4.68353986740112,-2,4,17084,107
17087,104,0.207370606449715,id7c20ee7a,left_hip,4.60155296325684,-3,0,17084,107
17085,105,0.664350185943423,id7c20ee7a,left_ankle,4.15283918380737,-1,1,17084,107
17084,106,0.613817898971536,id7c20ee7a,right_ankle,3.62808084487915,0,1,17084,107
13937,105,0.118730636748658,id7c20ee7a,left_wrist,4.68353986740112,4,5,13941,106
13937,105,0.145319335672476,id7c20ee7a,left_hip,4.60155296325684,4,5,13941,106
13940,105,0.593261331010387,id7c20ee7a,left_ankle,4.15283918380737,1,2,13941,106
13940,106,0.683392597152016,id7c20ee7a,right_ankle,3.62808084487915,1,1,13941,106
3941,111,0.156746431556724,id7c20ee7a,left_wrist,4.68353986740112,-51,-52,3890,110
3886,109,0.171695135923188,id7c20ee7a,left_hip,4.60155296325684,4,5,3890,110
3887,112,0.507989521554564,id7c20ee7a,left_ankle,4.15283918380737,3,1,3890,110
3886,112,0.533600939099724,id7c20ee7a,right_ankle,3.62808084487915,4,2,3890,110
1428,101,0.103843246671617,id7c20ee7a,left_wrist,4.68353986740112,4,0,1432,97
1426,103,0.126836373921885,id7c20ee7a,left_hip,4.60155296325684,6,0,1432,97
1430,103,0.675713374857339,id7c20ee7a,left_ankle,4.15283918380737,2,-4,1432,97
1432,102,0.57951031683945,id7c20ee7a,right_ankle,3.62808084487915,0,-5,1432,97
2529,109,0.196279516295885,id7c20ee7a,left_wrist,4.68353986740112,-45,-47,2484,107
2478,106,0.166381066673369,id7c20ee7a,left_hip,4.60155296325684,6,7,2484,107
2482,106,0.62536423180984,id7c20ee7a,left_ankle,4.15283918380737,2,3,2484,107
2482,107,0.58141745174556,id7c20ee7a,right_ankle,3.62808084487915,2,2,2484,107
8722,118,0.134429526629309,id7c20ee7a,left_wrist,4.68353986740112,-49,-58,8673,109
8667,108,0.149609565271102,id7c20ee7a,left_hip,4.60155296325684,6,7,8673,109
8671,109,0.665864121109295,id7c20ee7a,left_ankle,4.15283918380737,2,2,8673,109
8670,109,0.63215219138574,id7c20ee7a,right_ankle,3.62808084487915,3,3,8673,109
3941,111,0.156746431556724,id7c20ee7a,left_wrist,4.68353986740112,-51,-52,3890,110
3886,109,0.171695135923188,id7c20ee7a,left_hip,4.60155296325684,4,5,3890,110
3887,112,0.507989521554564,id7c20ee7a,left_ankle,4.15283918380737,3,1,3890,110
3886,112,0.533600939099724,id7c20ee7a,right_ankle,3.62808084487915,4,2,3890,110
6881,113,0.189203179601708,id7c20ee7a,left_wrist,4.68353986740112,-52,-52,6829,113
6823,110,0.132787305224878,id7c20ee7a,left_hip,4.60155296325684,6,9,6829,113
6827,112,0.558802432748096,id7c20ee7a,left_ankle,4.15283918380737,2,3,6829,113
6826,111,0.558150648833428,id7c20ee7a,right_ankle,3.62808084487915,3,5,6829,113
4491,112,0.181091858186333,id7c20ee7a,left_wrist,4.68353986740112,-51,-52,4440,111
4435,112,0.169502295519888,id7c20ee7a,left_hip,4.60155296325684,5,4,4440,111
4437,112,0.526699083699309,id7c20ee7a,left_ankle,4.15283918380737,3,2,4440,111
4437,111,0.588056965335356,id7c20ee7a,right_ankle,3.62808084487915,3,3,4440,111
5901,107,0.222580935343357,id7c20ee7a,left_wrist,4.68353986740112,-50,-49,5851,108
5842,110,0.189391575732612,id7c20ee7a,left_hip,4.60155296325684,9,7,5851,108
5848,109,0.572029885867524,id7c20ee7a,left_ankle,4.15283918380737,3,2,5851,108
5848,111,0.545905745458093,id7c20ee7a,right_ankle,3.62808084487915,3,0,5851,108
4272,110,0.200638660361679,id7c20ee7a,left_wrist,4.68353986740112,-50,-50,4222,110
4218,108,0.167256675064979,id7c20ee7a,left_hip,4.60155296325684,4,6,4222,110
4219,111,0.567871694726476,id7c20ee7a,left_ankle,4.15283918380737,3,2,4222,110
4219,110,0.498998762698154,id7c20ee7a,right_ankle,3.62808084487915,3,3,4222,110
10810,104,0.174619671856149,id7c20ee7a,left_wrist,4.68353986740112,-1,3,10809,108
10804,107,0.134824155600739,id7c20ee7a,left_hip,4.60155296325684,5,6,10809,108
10807,108,0.562290137408379,id7c20ee7a,left_ankle,4.15283918380737,2,2,10809,108
10806,109,0.633081921025878,id7c20ee7a,right_ankle,3.62808084487915,3,2,10809,108
17408,98,0.143283704682369,id7c20ee7a,left_wrist,4.68353986740112,-6,3,17402,107
17396,113,0.180488756005,id7c20ee7a,left_hip,4.60155296325684,6,0,17402,107
17403,107,0.640010143538874,id7c20ee7a,left_ankle,4.15283918380737,-1,-1,17402,107
17400,106,0.568896614923143,id7c20ee7a,right_ankle,3.62808084487915,2,3,17402,107
665,101,0.17531727702983,id00b70b13,left_wrist,3.5145480632782,28,25,693,98
696,98,0.274969898743386,id00b70b13,left_hip,3.38146901130676,-3,-3,693,98
696,98,0.662867914394574,id00b70b13,left_ankle,3.5276038646698,-3,-3,693,98
694,99,0.621560315693383,id00b70b13,right_ankle,3.32667207717896,-1,-2,693,98
10243,101,0.202960688563098,id00b70b13,left_wrist,3.5145480632782,7,7,10250,101
10252,102,0.322046556554005,id00b70b13,left_hip,3.38146901130676,-2,-3,10250,101
10252,101,0.679681129794907,id00b70b13,left_ankle,3.5276038646698,-2,-2,10250,101
10253,100,0.68023659247508,id00b70b13,right_ankle,3.32667207717896,-3,-2,10250,101
17100,116,0.204787537590435,id00b70b13,left_wrist,3.5145480632782,8,-7,17108,101
17111,101,0.308634701695725,id00b70b13,left_hip,3.38146901130676,-3,-3,17108,101
17110,102,0.686901261171378,id00b70b13,left_ankle,3.5276038646698,-2,-3,17108,101
17111,101,0.653866306755401,id00b70b13,right_ankle,3.32667207717896,-3,-3,17108,101
7295,99,0.177073278257685,id00b70b13,left_wrist,3.5145480632782,41,40,7336,98
7337,101,0.316851082048922,id00b70b13,left_hip,3.38146901130676,-1,-4,7336,98
7338,99,0.657833140766843,id00b70b13,left_ankle,3.5276038646698,-2,-3,7336,98
7336,102,0.682078551551472,id00b70b13,right_ankle,3.32667207717896,0,-4,7336,98
1054,82,0.102915477028882,id00b70b13,left_wrist,3.5145480632782,29,45,1083,98
1085,99,0.289383863614961,id00b70b13,left_hip,3.38146901130676,-2,-3,1083,98
1086,98,0.65177696376502,id00b70b13,left_ankle,3.5276038646698,-3,-3,1083,98
1083,98,0.665544027539682,id00b70b13,right_ankle,3.32667207717896,0,0,1083,98
2760,135,0.130331678288174,id00b70b13,left_wrist,3.5145480632782,27,-4,2787,104
2789,103,0.304904885349258,id00b70b13,left_hip,3.38146901130676,-2,-1,2787,104
2788,104,0.697001724101197,id00b70b13,left_ankle,3.5276038646698,-1,-1,2787,104
2790,103,0.680710350172276,id00b70b13,right_ankle,3.32667207717896,-3,-2,2787,104
6335,169,0.132111374532764,id00b70b13,left_wrist,3.5145480632782,93,26,6428,102
6521,170,0.179173477009976,id00b70b13,left_wrist,3.5145480632782,-93,-161,6428,102
6431,103,0.296869765229401,id00b70b13,left_hip,3.38146901130676,-3,-4,6428,102
6433,100,0.743664702453871,id00b70b13,left_ankle,3.5276038646698,-5,-3,6428,102
6431,103,0.671513468619584,id00b70b13,right_ankle,3.32667207717896,-3,-4,6428,102
3064,102,0.125685214795788,id00b70b13,left_wrist,3.5145480632782,29,28,3093,101
3094,101,0.278744868794926,id00b70b13,left_hip,3.38146901130676,-1,-1,3093,101
3095,101,0.767826458333368,id00b70b13,left_ankle,3.5276038646698,-2,-2,3093,101
3094,100,0.578151264085861,id00b70b13,right_ankle,3.32667207717896,-1,0,3093,101
2654,107,0.270137412087044,id00b70b13,left_wrist,3.5145480632782,29,28,2683,106
2685,105,0.271638557005627,id00b70b13,left_hip,3.38146901130676,-2,-1,2683,106
2685,104,0.602994364420372,id00b70b13,left_ankle,3.5276038646698,-2,0,2683,106
2687,104,0.635483958694703,id00b70b13,right_ankle,3.32667207717896,-4,-2,2683,106
4406,62,0.0866517103585893,id00b70b13,left_wrist,3.5145480632782,-11,29,4395,102
4398,102,0.254215023156347,id00b70b13,left_hip,3.38146901130676,-3,-3,4395,102
4398,101,0.702573911252655,id00b70b13,left_ankle,3.5276038646698,-3,-2,4395,102
4398,101,0.72333722558425,id00b70b13,right_ankle,3.32667207717896,-3,-2,4395,102
4600,63,0.167873481725788,id00b70b13,left_wrist,3.5145480632782,-5,36,4595,104
4598,102,0.265448694853905,id00b70b13,left_hip,3.38146901130676,-3,-1,4595,104
4597,103,0.712068565705847,id00b70b13,left_ankle,3.5276038646698,-2,-1,4595,104
4598,103,0.628218592157421,id00b70b13,right_ankle,3.32667207717896,-3,-2,4595,104
2654,107,0.270137412087044,id00b70b13,left_wrist,3.5145480632782,29,27,2683,105
2685,105,0.271638557005627,id00b70b13,left_hip,3.38146901130676,-2,-2,2683,105
2685,104,0.602994364420372,id00b70b13,left_ankle,3.5276038646698,-2,-1,2683,105
2687,104,0.635483958694703,id00b70b13,right_ankle,3.32667207717896,-4,-3,2683,105
19097,99,0.180212344881379,id00b70b13,left_wrist,3.5145480632782,-5,-5,19092,99
19096,99,0.28126976582134,id00b70b13,left_hip,3.38146901130676,-4,-4,19092,99
19096,98,0.753095881042107,id00b70b13,left_ankle,3.5276038646698,-4,-3,19092,99
19094,100,0.709077971081697,id00b70b13,right_ankle,3.32667207717896,-2,-3,19092,99
6521,170,0.179173477009976,id00b70b13,left_wrist,3.5145480632782,8,-61,6529,101
6533,101,0.280318203984093,id00b70b13,left_hip,3.38146901130676,-4,-4,6529,101
6532,102,0.690855397267589,id00b70b13,left_ankle,3.5276038646698,-3,-4,6529,101
6533,101,0.67334270387499,id00b70b13,right_ankle,3.32667207717896,-4,-4,6529,101
9920,84,0.181391225073039,id00b70b13,left_wrist,3.5145480632782,25,44,9945,103
9948,103,0.313316983793568,id00b70b13,left_hip,3.38146901130676,-3,-3,9945,103
9948,103,0.776474794578126,id00b70b13,left_ankle,3.5276038646698,-3,-3,9945,103
9949,102,0.692724348994874,id00b70b13,right_ankle,3.32667207717896,-4,-3,9945,103
13206,114,0.250564172113742,id00b70b13,left_wrist,3.5145480632782,7,-8,13213,99
13217,100,0.307462915241058,id00b70b13,left_hip,3.38146901130676,-4,-5,13213,99
13216,100,0.761236403600306,id00b70b13,left_ankle,3.5276038646698,-3,-4,13213,99
13215,99,0.644421517516929,id00b70b13,right_ankle,3.32667207717896,-2,-2,13213,99
1952,92,0.13520023935298,id00b70b13,left_wrist,3.5145480632782,28,36,1980,100
1980,101,0.291124328883436,id00b70b13,left_hip,3.38146901130676,0,-1,1980,100
1981,101,0.718106077924287,id00b70b13,left_ankle,3.5276038646698,-1,-2,1980,100
1978,104,0.685738106327411,id00b70b13,right_ankle,3.32667207717896,2,-2,1980,100
2552,103,0.201746696133175,id00b70b13,left_wrist,3.5145480632782,31,29,2583,101
2585,101,0.286788306382261,id00b70b13,left_hip,3.38146901130676,-2,-2,2583,101
2584,102,0.652392301479503,id00b70b13,left_ankle,3.5276038646698,-1,-2,2583,101
2585,103,0.690633155230731,id00b70b13,right_ankle,3.32667207717896,-2,-4,2583,101
1054,82,0.102915477028882,id00b70b13,left_wrist,3.5145480632782,29,45,1083,98
1085,99,0.289383863614961,id00b70b13,left_hip,3.38146901130676,-2,-3,1083,98
1086,98,0.65177696376502,id00b70b13,left_ankle,3.5276038646698,-3,-3,1083,98
1083,98,0.665544027539682,id00b70b13,right_ankle,3.32667207717896,0,0,1083,98
18061,100,0.339250145980511,id00b70b13,left_wrist,3.5145480632782,-54,-55,18007,99
18012,98,0.282895318281528,id00b70b13,left_hip,3.38146901130676,-5,-4,18007,99
18010,100,0.775397607428631,id00b70b13,left_ankle,3.5276038646698,-3,-4,18007,99
18009,101,0.696151772144364,id00b70b13,right_ankle,3.32667207717896,-2,-4,18007,99
14657,105,0.12704267042523,id1165e00c,left_wrist,3.57215189933777,-2,-3,14655,104
14655,104,0.269248628892356,id1165e00c,left_hip,3.62602305412292,0,0,14655,104
14654,106,0.694714828294189,id1165e00c,left_ankle,4.06086397171021,1,-1,14655,104
14653,106,0.793656435238812,id1165e00c,right_ankle,3.98530697822571,2,0,14655,104
2133,112,0.201082177646588,id1165e00c,left_wrist,3.57215189933777,1,-2,2134,109
2131,109,0.280418139471587,id1165e00c,left_hip,3.62602305412292,3,3,2134,109
2132,109,0.648777637013478,id1165e00c,left_ankle,4.06086397171021,2,2,2134,109
2132,109,0.630026999093218,id1165e00c,right_ankle,3.98530697822571,2,2,2134,109
10818,98,0.0692215120655923,id1165e00c,left_wrist,3.57215189933777,-8,2,10810,108
10808,110,0.226329111389234,id1165e00c,left_hip,3.62602305412292,2,0,10810,108
10810,109,0.632826119245642,id1165e00c,left_ankle,4.06086397171021,0,-1,10810,108
10809,111,0.715082254187525,id1165e00c,right_ankle,3.98530697822571,1,-2,10810,108
10075,99,0.100649987543809,id1165e00c,left_wrist,3.57215189933777,-8,-1,10067,106
10062,110,0.223008808353421,id1165e00c,left_hip,3.62602305412292,5,1,10067,106
10064,109,0.585981724808201,id1165e00c,left_ankle,4.06086397171021,3,0,10067,106
10064,107,0.694147144657289,id1165e00c,right_ankle,3.98530697822571,3,2,10067,106
8254,105,0.0893616116394233,id1165e00c,left_wrist,3.57215189933777,0,3,8254,108
8253,108,0.226695024042595,id1165e00c,left_hip,3.62602305412292,1,1,8254,108
8255,107,0.647489305749946,id1165e00c,left_ankle,4.06086397171021,-1,0,8254,108
8253,107,0.74228025375634,id1165e00c,right_ankle,3.98530697822571,1,2,8254,108
21528,105,0.105627429520697,id1165e00c,left_wrist,3.57215189933777,0,2,21528,107
21526,108,0.251909697427213,id1165e00c,left_hip,3.62602305412292,2,1,21528,107
21528,108,0.678037158599873,id1165e00c,left_ankle,4.06086397171021,0,-1,21528,107
21527,108,0.763172283178626,id1165e00c,right_ankle,3.98530697822571,1,0,21528,107
3990,110,0.136954857153962,id1165e00c,left_wrist,3.57215189933777,-2,-2,3988,110
3985,114,0.240840600528251,id1165e00c,left_hip,3.62602305412292,3,-1,3988,110
3985,112,0.540672554691436,id1165e00c,left_ankle,4.06086397171021,3,1,3988,110
3985,112,0.634072010584048,id1165e00c,right_ankle,3.98530697822571,3,1,3988,110
17685,107,0.154240123430373,id1165e00c,left_wrist,3.57215189933777,-3,-4,17682,106
17683,104,0.235209358402362,id1165e00c,left_hip,3.62602305412292,-1,1,17682,106
17682,106,0.595103971863162,id1165e00c,left_ankle,4.06086397171021,0,0,17682,106
17680,106,0.696832183011659,id1165e00c,right_ankle,3.98530697822571,2,2,17682,106
1543,107,0.155812341070374,id1165e00c,left_wrist,3.57215189933777,51,52,1594,108
1592,108,0.251043862123699,id1165e00c,left_hip,3.62602305412292,2,2,1594,108
1593,108,0.63403767568124,id1165e00c,left_ankle,4.06086397171021,1,1,1594,108
1592,108,0.697382419705587,id1165e00c,right_ankle,3.98530697822571,2,2,1594,108
8783,95,0.0996833208050395,id1165e00c,left_wrist,3.57215189933777,-5,6,8778,106
8779,104,0.240467556433283,id1165e00c,left_hip,3.62602305412292,-1,1,8778,106
8779,104,0.612311868707414,id1165e00c,left_ankle,4.06086397171021,-1,1,8778,106
8776,105,0.786778993812427,id1165e00c,right_ankle,3.98530697822571,2,3,8778,106
3116,107,0.156183505387795,id1165e00c,left_wrist,3.57215189933777,1,1,3117,107
3116,107,0.243143446182525,id1165e00c,left_hip,3.62602305412292,1,1,3117,107
3114,108,0.592966837664846,id1165e00c,left_ankle,4.06086397171021,3,2,3117,107
3114,108,0.637006197380548,id1165e00c,right_ankle,3.98530697822571,3,2,3117,107
4441,108,0.116866658249905,id1165e00c,left_wrist,3.57215189933777,-10,-3,4431,115
4432,114,0.226635469109039,id1165e00c,left_hip,3.62602305412292,-1,0,4431,115
4429,112,0.55374642658332,id1165e00c,left_ankle,4.06086397171021,2,5,4431,115
4433,112,0.59495073743167,id1165e00c,right_ankle,3.98530697822571,-2,1,4431,115
18318,101,0.193962336995742,id1165e00c,left_wrist,3.57215189933777,-11,-4,18307,108
18310,105,0.237363898972382,id1165e00c,left_hip,3.62602305412292,-3,0,18307,108
18308,108,0.633596691156792,id1165e00c,left_ankle,4.06086397171021,-1,-1,18307,108
18307,107,0.721943434675767,id1165e00c,right_ankle,3.98530697822571,0,1,18307,108
15713,107,0.148201620434625,id1165e00c,left_wrist,3.57215189933777,-10,-8,15703,109
15705,108,0.263379652411769,id1165e00c,left_hip,3.62602305412292,-2,-1,15703,109
15705,106,0.615362832390042,id1165e00c,left_ankle,4.06086397171021,-2,1,15703,109
15704,106,0.714743421452279,id1165e00c,right_ankle,3.98530697822571,-1,2,15703,109
5867,112,0.102681016151015,id1165e00c,left_wrist,3.57215189933777,0,-3,5867,109
5866,108,0.239860338780902,id1165e00c,left_hip,3.62602305412292,1,2,5867,109
5864,111,0.571375350312056,id1165e00c,left_ankle,4.06086397171021,3,1,5867,109
5864,110,0.633273514444992,id1165e00c,right_ankle,3.98530697822571,3,2,5867,109
10818,98,0.0692215120655923,id1165e00c,left_wrist,3.57215189933777,-8,2,10810,108
10808,110,0.226329111389234,id1165e00c,left_hip,3.62602305412292,2,0,10810,108
10810,109,0.632826119245642,id1165e00c,left_ankle,4.06086397171021,0,-1,10810,108
10809,111,0.715082254187525,id1165e00c,right_ankle,3.98530697822571,1,-2,10810,108
1917,112,0.205536294569872,id1165e00c,left_wrist,3.57215189933777,1,-2,1918,109
1917,106,0.264707091609261,id1165e00c,left_hip,3.62602305412292,1,4,1918,109
1915,110,0.61592127480332,id1165e00c,left_ankle,4.06086397171021,3,2,1918,109
1918,109,0.726690650801563,id1165e00c,right_ankle,3.98530697822571,0,0,1918,109
7728,103,0.115022549601981,id1165e00c,left_wrist,3.57215189933777,-6,-1,7722,108
7721,110,0.242327922091022,id1165e00c,left_hip,3.62602305412292,1,-1,7722,108
7722,108,0.647373740328794,id1165e00c,left_ankle,4.06086397171021,0,0,7722,108
7721,110,0.693952307321567,id1165e00c,right_ankle,3.98530697822571,1,-1,7722,108
21113,104,0.124270617646219,id1165e00c,left_wrist,3.57215189933777,-6,-4,21107,106
21109,104,0.25892245354607,id1165e00c,left_hip,3.62602305412292,-2,0,21107,106
21109,105,0.726479314937855,id1165e00c,left_ankle,4.06086397171021,-2,-1,21107,106
21106,106,0.793958566095961,id1165e00c,right_ankle,3.98530697822571,1,1,21107,106
13615,97,0.111215431828122,id1165e00c,left_wrist,3.57215189933777,-4,2,13611,103
13610,106,0.272800624423718,id1165e00c,left_hip,3.62602305412292,1,-2,13611,103
13611,105,0.688859834720674,id1165e00c,left_ankle,4.06086397171021,0,-2,13611,103
13609,105,0.77396385194933,id1165e00c,right_ankle,3.98530697822571,2,0,13611,103
14015,103,0.232547097261482,id5308a7d6,left_wrist,3.25032091140747,-2,-4,14013,101
14012,103,0.29345459865225,id5308a7d6,left_hip,3.55774402618408,1,-1,14013,101
14011,103,0.715899042310729,id5308a7d6,left_ankle,3.64328217506409,2,0,14013,101
14012,101,0.758220379627547,id5308a7d6,right_ankle,3.4536349773407,1,1,14013,101
6642,108,0.174113274651999,id5308a7d6,left_wrist,3.25032091140747,-4,-4,6638,108
6638,107,0.231546333441422,id5308a7d6,left_hip,3.55774402618408,0,1,6638,108
6637,108,0.663777829175277,id5308a7d6,left_ankle,3.64328217506409,1,1,6638,108
6636,105,0.671891084027528,id5308a7d6,right_ankle,3.4536349773407,2,5,6638,108
8568,100,0.254753611850768,id5308a7d6,left_wrist,3.25032091140747,-2,-2,8566,100
8565,100,0.308692393271017,id5308a7d6,left_hip,3.55774402618408,1,1,8566,100
8564,101,0.713777656406922,id5308a7d6,left_ankle,3.64328217506409,2,1,8566,100
8564,100,0.66535024999968,id5308a7d6,right_ankle,3.4536349773407,2,2,8566,100
20869,103,0.169881243053581,id5308a7d6,left_wrist,3.25032091140747,-4,-4,20865,103
20866,101,0.264062832889767,id5308a7d6,left_hip,3.55774402618408,-1,1,20865,103
20864,102,0.788061437671348,id5308a7d6,left_ankle,3.64328217506409,1,2,20865,103
20864,102,0.697378966374296,id5308a7d6,right_ankle,3.4536349773407,1,2,20865,103
17981,101,0.266317429253688,id5308a7d6,left_wrist,3.25032091140747,-4,-4,17977,101
17977,102,0.308403456248087,id5308a7d6,left_hip,3.55774402618408,0,-1,17977,101
17976,101,0.749582830274043,id5308a7d6,left_ankle,3.64328217506409,1,1,17977,101
17977,100,0.771584856449058,id5308a7d6,right_ankle,3.4536349773407,0,1,17977,101
20076,99,0.209140232199059,id5308a7d6,left_wrist,3.25032091140747,-4,-4,20072,99
20072,100,0.30708412716197,id5308a7d6,left_hip,3.55774402618408,0,-1,20072,99
20071,98,0.799833954588504,id5308a7d6,left_ankle,3.64328217506409,1,2,20072,99
20070,102,0.720760431272965,id5308a7d6,right_ankle,3.4536349773407,2,-1,20072,99
17073,102,0.248656653327653,id5308a7d6,left_wrist,3.25032091140747,-3,-2,17070,103
17070,103,0.291885018454524,id5308a7d6,left_hip,3.55774402618408,0,0,17070,103
17069,102,0.711278057736785,id5308a7d6,left_ankle,3.64328217506409,1,2,17070,103
17067,104,0.692788032262326,id5308a7d6,right_ankle,3.4536349773407,3,2,17070,103
16553,105,0.238752416890058,id5308a7d6,left_wrist,3.25032091140747,-6,-5,16547,106
16549,105,0.240767210469062,id5308a7d6,left_hip,3.55774402618408,-2,-1,16547,106
16548,105,0.768726967423362,id5308a7d6,left_ankle,3.64328217506409,-1,0,16547,106
16545,106,0.78931011995129,id5308a7d6,right_ankle,3.4536349773407,2,2,16547,106
5721,103,0.228292889322209,id5308a7d6,left_wrist,3.25032091140747,-1,-1,5720,103
5718,103,0.281784607423387,id5308a7d6,left_hip,3.55774402618408,2,2,5720,103
5717,103,0.743959877427643,id5308a7d6,left_ankle,3.64328217506409,3,3,5720,103
5718,100,0.605431623009281,id5308a7d6,right_ankle,3.4536349773407,2,5,5720,103
16046,103,0.247489638146357,id5308a7d6,left_wrist,3.25032091140747,-5,-4,16041,104
16041,104,0.267034473272121,id5308a7d6,left_hip,3.55774402618408,0,0,16041,104
16040,104,0.776258330739775,id5308a7d6,left_ankle,3.64328217506409,1,1,16041,104
16039,104,0.709554100171193,id5308a7d6,right_ankle,3.4536349773407,2,2,16041,104
20670,100,0.210690767357629,id5308a7d6,left_wrist,3.25032091140747,-5,-3,20665,102
20666,101,0.314839043339234,id5308a7d6,left_hip,3.55774402618408,-1,0,20665,102
20665,101,0.808899855334126,id5308a7d6,left_ankle,3.64328217506409,0,1,20665,102
20665,101,0.784747844775402,id5308a7d6,right_ankle,3.4536349773407,0,1,20665,102
6232,102,0.253438096093224,id5308a7d6,left_wrist,3.25032091140747,-3,-1,6229,104
6229,102,0.288262656060336,id5308a7d6,left_hip,3.55774402618408,0,2,6229,104
6227,102,0.637955856025038,id5308a7d6,left_ankle,3.64328217506409,2,4,6229,104
6225,105,0.639587630437911,id5308a7d6,right_ankle,3.4536349773407,4,3,6229,104
8469,100,0.249759192129048,id5308a7d6,left_wrist,3.25032091140747,-1,-2,8468,99
8466,100,0.298483761381114,id5308a7d6,left_hip,3.55774402618408,2,1,8468,99
8465,100,0.828756220858295,id5308a7d6,left_ankle,3.64328217506409,3,2,8468,99
8466,99,0.745107012825169,id5308a7d6,right_ankle,3.4536349773407,2,2,8468,99
17073,102,0.248656653327653,id5308a7d6,left_wrist,3.25032091140747,-3,-2,17070,103
17070,103,0.291885018454524,id5308a7d6,left_hip,3.55774402618408,0,0,17070,103
17069,102,0.711278057736785,id5308a7d6,left_ankle,3.64328217506409,1,2,17070,103
17067,104,0.692788032262326,id5308a7d6,right_ankle,3.4536349773407,3,2,17070,103
1696,104,0.242204022614137,id5308a7d6,left_wrist,3.25032091140747,0,-3,1696,101
1694,102,0.285867501824152,id5308a7d6,left_hip,3.55774402618408,2,1,1696,101
1693,103,0.697422557846442,id5308a7d6,left_ankle,3.64328217506409,3,1,1696,101
1693,102,0.749841017562071,id5308a7d6,right_ankle,3.4536349773407,3,2,1696,101
7669,101,0.234508294592089,id5308a7d6,left_wrist,3.25032091140747,-4,-2,7665,103
7666,101,0.284373289794174,id5308a7d6,left_hip,3.55774402618408,-1,1,7665,103
7664,102,0.768928574795315,id5308a7d6,left_ankle,3.64328217506409,1,2,7665,103
7664,102,0.696281494765357,id5308a7d6,right_ankle,3.4536349773407,1,2,7665,103
9382,105,0.212080868657631,id5308a7d6,left_wrist,3.25032091140747,-2,-3,9380,104
9380,103,0.281854021079418,id5308a7d6,left_hip,3.55774402618408,0,1,9380,104
9379,102,0.725739304981249,id5308a7d6,left_ankle,3.64328217506409,1,3,9380,104
9375,106,0.573122800911914,id5308a7d6,right_ankle,3.4536349773407,5,3,9380,104
3398,101,0.243744553075846,id5308a7d6,left_wrist,3.25032091140747,-1,-2,3397,100
3395,100,0.29079746551818,id5308a7d6,left_hip,3.55774402618408,2,2,3397,100
3394,100,0.734343403547356,id5308a7d6,left_ankle,3.64328217506409,3,3,3397,100
3394,102,0.75070476428195,id5308a7d6,right_ankle,3.4536349773407,3,1,3397,100
12270,104,0.180971632351037,id5308a7d6,left_wrist,3.25032091140747,-3,-5,12267,102
12267,103,0.25362339358505,id5308a7d6,left_hip,3.55774402618408,0,-1,12267,102
12266,103,0.785558673948552,id5308a7d6,left_ankle,3.64328217506409,1,0,12267,102
12265,102,0.746121307357732,id5308a7d6,right_ankle,3.4536349773407,2,2,12267,102
20468,101,0.220995293160624,id5308a7d6,left_wrist,3.25032091140747,-3,-2,20465,102
20465,102,0.276352407809958,id5308a7d6,left_hip,3.55774402618408,0,0,20465,102
20463,102,0.78099815214094,id5308a7d6,left_ankle,3.64328217506409,2,2,20465,102
20465,100,0.672419266518496,id5308a7d6,right_ankle,3.4536349773407,0,2,20465,102
17624,110,0.303388633179158,ida61e8ddf,left_wrist,2.75470900535583,-1,-3,17623,108
17622,109,0.345788459300449,ida61e8ddf,left_hip,2.99848294258118,1,0,17623,108
17622,108,0.871781734714325,ida61e8ddf,left_ankle,2.55913305282593,1,1,17623,108
17622,110,0.852223107166528,ida61e8ddf,right_ankle,2.53433895111084,1,-1,17623,108
3207,113,0.294186330116799,ida61e8ddf,left_wrist,2.75470900535583,0,1,3207,114
3205,114,0.311691001278768,ida61e8ddf,left_hip,2.99848294258118,2,2,3207,114
3205,114,0.921655921441197,ida61e8ddf,left_ankle,2.55913305282593,2,2,3207,114
3208,110,0.711469672774411,ida61e8ddf,right_ankle,2.53433895111084,-1,3,3207,114
9745,104,0.372228066693858,ida61e8ddf,left_wrist,2.75470900535583,-1,0,9744,105
9742,105,0.405469325307254,ida61e8ddf,left_hip,2.99848294258118,2,2,9744,105
9741,106,0.893628807665964,ida61e8ddf,left_ankle,2.55913305282593,3,2,9744,105
9740,106,0.943238607946319,ida61e8ddf,right_ankle,2.53433895111084,4,3,9744,105
6841,109,0.290739469989384,ida61e8ddf,left_wrist,2.75470900535583,-2,-2,6839,109
6840,108,0.319793143583547,ida61e8ddf,left_hip,2.99848294258118,-1,0,6839,109
6842,109,0.993759901442151,ida61e8ddf,left_ankle,2.55913305282593,-3,-3,6839,109
6839,109,0.846821265356289,ida61e8ddf,right_ankle,2.53433895111084,0,0,6839,109
12098,110,0.317570413038673,ida61e8ddf,left_wrist,2.75470900535583,0,-1,12098,109
12096,111,0.35231479053733,ida61e8ddf,left_hip,2.99848294258118,2,0,12098,109
12095,111,0.996514551686036,ida61e8ddf,left_ankle,2.55913305282593,3,1,12098,109
12096,111,0.793492697126752,ida61e8ddf,right_ankle,2.53433895111084,2,0,12098,109
4877,107,0.290214604855573,ida61e8ddf,left_wrist,2.75470900535583,1,4,4878,110
4875,111,0.331657788051098,ida61e8ddf,left_hip,2.99848294258118,3,2,4878,110
4877,109,0.947403067039113,ida61e8ddf,left_ankle,2.55913305282593,1,2,4878,110
4875,111,0.857903409340238,ida61e8ddf,right_ankle,2.53433895111084,3,2,4878,110
8469,101,0.152403886755878,ida61e8ddf,left_wrist,2.75470900535583,-6,0,8463,107
8464,103,0.317192796343763,ida61e8ddf,left_hip,2.99848294258118,-1,3,8463,107
8462,106,0.698077169591163,ida61e8ddf,left_ankle,2.55913305282593,1,2,8463,107
8464,103,0.777957564341384,ida61e8ddf,right_ankle,2.53433895111084,-1,3,8463,107
3207,113,0.294186330116799,ida61e8ddf,left_wrist,2.75470900535583,0,1,3207,114
3205,114,0.311691001278768,ida61e8ddf,left_hip,2.99848294258118,2,2,3207,114
3205,114,0.921655921441197,ida61e8ddf,left_ankle,2.55913305282593,2,2,3207,114
3208,110,0.711469672774411,ida61e8ddf,right_ankle,2.53433895111084,-1,3,3207,114
6625,110,0.300308356741662,ida61e8ddf,left_wrist,2.75470900535583,-2,-1,6623,111
6622,110,0.343816065079057,ida61e8ddf,left_hip,2.99848294258118,1,2,6623,111
6622,110,0.984709162518029,ida61e8ddf,left_ankle,2.55913305282593,1,2,6623,111
6622,109,0.888832294423905,ida61e8ddf,right_ankle,2.53433895111084,1,3,6623,111
12975,109,0.260830588614709,ida61e8ddf,left_wrist,2.75470900535583,-2,-1,12973,110
12971,110,0.33517073513869,ida61e8ddf,left_hip,2.99848294258118,2,2,12973,110
12972,108,0.847659148016476,ida61e8ddf,left_ankle,2.55913305282593,1,3,12973,110
12971,109,0.896468899092462,ida61e8ddf,right_ankle,2.53433895111084,2,3,12973,110
8676,107,0.310491189079617,ida61e8ddf,left_wrist,2.75470900535583,0,-1,8676,106
8673,108,0.345465114199018,ida61e8ddf,left_hip,2.99848294258118,3,1,8676,106
8673,108,0.922978512957674,ida61e8ddf,left_ankle,2.55913305282593,3,1,8676,106
8672,108,0.894195304056127,ida61e8ddf,right_ankle,2.53433895111084,4,2,8676,106
1204,109,0.307507924554623,ida61e8ddf,left_wrist,2.75470900535583,1,1,1205,109
1203,109,0.294455446172305,ida61e8ddf,left_hip,2.99848294258118,2,2,1205,109
1203,109,0.985349530719606,ida61e8ddf,left_ankle,2.55913305282593,2,2,1205,109
1203,108,0.849027923839126,ida61e8ddf,right_ankle,2.53433895111084,2,3,1205,109
14042,110,0.314540189958029,ida61e8ddf,left_wrist,2.75470900535583,0,-3,14042,107
14040,107,0.401335075003903,ida61e8ddf,left_hip,2.99848294258118,2,2,14042,107
14043,104,0.855592744850336,ida61e8ddf,left_ankle,2.55913305282593,-1,2,14042,107
14038,111,0.826538727464481,ida61e8ddf,right_ankle,2.53433895111084,4,0,14042,107
7587,107,0.330989284788896,ida61e8ddf,left_wrist,2.75470900535583,1,2,7588,108
7587,106,0.368772990091975,ida61e8ddf,left_hip,2.99848294258118,1,3,7588,108
7586,106,0.88665382520413,ida61e8ddf,left_ankle,2.55913305282593,2,4,7588,108
7585,108,0.874670518166096,ida61e8ddf,right_ankle,2.53433895111084,3,3,7588,108
17517,108,0.337802671226906,ida61e8ddf,left_wrist,2.75470900535583,-1,-1,17516,108
17515,108,0.3889273969563,ida61e8ddf,left_hip,2.99848294258118,1,1,17516,108
17515,108,0.95355345515255,ida61e8ddf,left_ankle,2.55913305282593,1,1,17516,108
17515,108,0.883880051510759,ida61e8ddf,right_ankle,2.53433895111084,1,1,17516,108
5202,110,0.268200493745389,ida61e8ddf,left_wrist,2.75470900535583,0,0,5202,110
5201,110,0.295180368545717,ida61e8ddf,left_hip,2.99848294258118,1,1,5202,110
5201,109,0.906739317459305,ida61e8ddf,left_ankle,2.55913305282593,1,2,5202,110
5201,110,0.861730862847173,ida61e8ddf,right_ankle,2.53433895111084,1,1,5202,110
15225,108,0.360036745413489,ida61e8ddf,left_wrist,2.75470900535583,-3,-3,15222,108
15220,110,0.363249776215374,ida61e8ddf,left_hip,2.99848294258118,2,0,15222,108
15220,109,0.932200613500588,ida61e8ddf,left_ankle,2.55913305282593,2,1,15222,108
15219,111,0.875888311643098,ida61e8ddf,right_ankle,2.53433895111084,3,0,15222,108
1637,111,0.284595331194011,ida61e8ddf,left_wrist,2.75470900535583,1,1,1638,111
1637,111,0.300414763009441,ida61e8ddf,left_hip,2.99848294258118,1,1,1638,111
1637,110,0.916091706677917,ida61e8ddf,left_ankle,2.55913305282593,1,2,1638,111
1637,111,0.793931044566734,ida61e8ddf,right_ankle,2.53433895111084,1,1,1638,111
15770,108,0.341652259246115,ida61e8ddf,left_wrist,2.75470900535583,-3,-3,15767,108
15765,109,0.397748905943309,ida61e8ddf,left_hip,2.99848294258118,2,1,15767,108
15766,108,0.899563058783631,ida61e8ddf,left_ankle,2.55913305282593,1,1,15767,108
15764,110,0.8909869045316,ida61e8ddf,right_ankle,2.53433895111084,3,1,15767,108
8569,108,0.266098266034812,ida61e8ddf,left_wrist,2.75470900535583,0,0,8569,108
8566,108,0.364630410278631,ida61e8ddf,left_hip,2.99848294258118,3,3,8569,108
8567,107,0.943759881681573,ida61e8ddf,left_ankle,2.55913305282593,2,3,8569,108
8566,107,0.861803719337064,ida61e8ddf,right_ankle,2.53433895111084,3,4,8569,108
1983,102,0.234267086860182,id9603e9c3,left_wrist,3.1929018497467,-2,-3,1981,101
1983,101,0.34160789812062,id9603e9c3,left_hip,3.29805111885071,-2,-2,1981,101
1981,102,0.836302034867793,id9603e9c3,left_ankle,3.14351296424866,0,-1,1981,101
1981,101,0.744940923726046,id9603e9c3,right_ankle,3.2443311214447,0,0,1981,101
5942,102,0.314301066899404,id9603e9c3,left_wrist,3.1929018497467,-1,-2,5941,101
5943,100,0.386119847244613,id9603e9c3,left_hip,3.29805111885071,-2,-1,5941,101
5942,100,0.800531864900873,id9603e9c3,left_ankle,3.14351296424866,-1,0,5941,101
5940,102,0.809934269847569,id9603e9c3,right_ankle,3.2443311214447,1,0,5941,101
14785,97,0.3828383657077,id9603e9c3,left_wrist,3.1929018497467,-4,-3,14781,98
14784,97,0.460791598604393,id9603e9c3,left_hip,3.29805111885071,-3,-2,14781,98
14783,97,0.887628173481876,id9603e9c3,left_ankle,3.14351296424866,-2,-1,14781,98
14780,98,0.854917001685235,id9603e9c3,right_ankle,3.2443311214447,1,1,14781,98
4942,102,0.251687745139027,id9603e9c3,left_wrist,3.1929018497467,-1,-1,4941,102
4942,101,0.33612402972137,id9603e9c3,left_hip,3.29805111885071,-1,0,4941,102
4940,102,0.838235761201296,id9603e9c3,left_ankle,3.14351296424866,1,1,4941,102
4940,99,0.66222575642274,id9603e9c3,right_ankle,3.2443311214447,1,4,4941,102
10349,100,0.315319244092731,id9603e9c3,left_wrist,3.1929018497467,-2,-1,10347,101
10349,100,0.38393941232801,id9603e9c3,left_hip,3.29805111885071,-2,-1,10347,101
10348,100,0.793746925483556,id9603e9c3,left_ankle,3.14351296424866,-1,0,10347,101
10346,102,0.783087325677214,id9603e9c3,right_ankle,3.2443311214447,1,0,10347,101
14785,97,0.3828383657077,id9603e9c3,left_wrist,3.1929018497467,-4,-3,14781,98
14784,97,0.460791598604393,id9603e9c3,left_hip,3.29805111885071,-3,-2,14781,98
14783,97,0.887628173481876,id9603e9c3,left_ankle,3.14351296424866,-2,-1,14781,98
14780,98,0.854917001685235,id9603e9c3,right_ankle,3.2443311214447,1,1,14781,98
1299,98,0.258817860588779,id9603e9c3,left_wrist,3.1929018497467,-3,-1,1296,100
1296,101,0.350233877337623,id9603e9c3,left_hip,3.29805111885071,0,-1,1296,100
1296,99,0.764560907367225,id9603e9c3,left_ankle,3.14351296424866,0,1,1296,100
1295,97,0.721341788123729,id9603e9c3,right_ankle,3.2443311214447,1,4,1296,100
12443,102,0.291608609661711,id9603e9c3,left_wrist,3.1929018497467,-2,-4,12441,100
12443,101,0.423765412534061,id9603e9c3,left_hip,3.29805111885071,-2,-3,12441,100
12442,100,0.85562804040389,id9603e9c3,left_ankle,3.14351296424866,-1,-1,12441,100
12441,101,0.813067897437786,id9603e9c3,right_ankle,3.2443311214447,0,-1,12441,100
12343,101,0.346017778535396,id9603e9c3,left_wrist,3.1929018497467,-1,-2,12342,100
12344,100,0.437645514212339,id9603e9c3,left_hip,3.29805111885071,-2,-2,12342,100
12342,101,0.819102375226308,id9603e9c3,left_ankle,3.14351296424866,0,-1,12342,100
12341,101,0.783024343547803,id9603e9c3,right_ankle,3.2443311214447,1,0,12342,100
8149,101,0.291406538023867,id9603e9c3,left_wrist,3.1929018497467,-2,-1,8147,102
8148,102,0.353403843850719,id9603e9c3,left_hip,3.29805111885071,-1,-1,8147,102
8147,102,0.782863892774254,id9603e9c3,left_ankle,3.14351296424866,0,0,8147,102
8148,101,0.752316859236582,id9603e9c3,right_ankle,3.2443311214447,-1,0,8147,102
7740,103,0.27180078730103,id9603e9c3,left_wrist,3.1929018497467,-2,-2,7738,103
7740,103,0.329576184511747,id9603e9c3,left_hip,3.29805111885071,-2,-2,7738,103
7738,103,0.708761308949719,id9603e9c3,left_ankle,3.14351296424866,0,0,7738,103
7738,102,0.668638481326455,id9603e9c3,right_ankle,3.2443311214447,0,1,7738,103
9952,99,0.365197724405735,id9603e9c3,left_wrist,3.1929018497467,-4,-3,9948,100
9952,98,0.390345437583202,id9603e9c3,left_hip,3.29805111885071,-4,-2,9948,100
9949,101,0.78159997710957,id9603e9c3,left_ankle,3.14351296424866,-1,-2,9948,100
9949,99,0.739896316829004,id9603e9c3,right_ankle,3.2443311214447,-1,0,9948,100
16415,99,0.362846508712085,id9603e9c3,left_wrist,3.1929018497467,-3,-4,16412,98
16414,98,0.441611177763657,id9603e9c3,left_hip,3.29805111885071,-2,-2,16412,98
16414,97,0.852249244092295,id9603e9c3,left_ankle,3.14351296424866,-2,-1,16412,98
16411,97,0.845107469282181,id9603e9c3,right_ankle,3.2443311214447,1,2,16412,98
4155,100,0.261162234532251,id9603e9c3,left_wrist,3.1929018497467,-3,-1,4152,102
4154,100,0.375746411882393,id9603e9c3,left_hip,3.29805111885071,-2,0,4152,102
4153,101,0.781666841896961,id9603e9c3,left_ankle,3.14351296424866,-1,0,4152,102
4153,99,0.764544794462183,id9603e9c3,right_ankle,3.2443311214447,-1,2,4152,102
3956,102,0.2897706830606,id9603e9c3,left_wrist,3.1929018497467,-1,-2,3955,101
3955,102,0.344314369980246,id9603e9c3,left_hip,3.29805111885071,0,-1,3955,101
3954,101,0.831469240152596,id9603e9c3,left_ankle,3.14351296424866,1,1,3955,101
3954,100,0.775478566566583,id9603e9c3,right_ankle,3.2443311214447,1,2,3955,101
7541,99,0.279891658886002,id9603e9c3,left_wrist,3.1929018497467,-2,-2,7539,99
7541,97,0.363449195536534,id9603e9c3,left_hip,3.29805111885071,-2,0,7539,99
7539,100,0.808554711828651,id9603e9c3,left_ankle,3.14351296424866,0,-1,7539,99
7538,99,0.769212693821049,id9603e9c3,right_ankle,3.2443311214447,1,1,7539,99
5942,102,0.314301066899404,id9603e9c3,left_wrist,3.1929018497467,-1,-2,5941,101
5943,100,0.386119847244613,id9603e9c3,left_hip,3.29805111885071,-2,-1,5941,101
5942,100,0.800531864900873,id9603e9c3,left_ankle,3.14351296424866,-1,0,5941,101
5940,102,0.809934269847569,id9603e9c3,right_ankle,3.2443311214447,1,0,5941,101
15264,98,0.380092801795893,id9603e9c3,left_wrist,3.1929018497467,-3,-4,15261,97
15262,98,0.447299457591169,id9603e9c3,left_hip,3.29805111885071,-1,-2,15261,97
15261,97,0.875211789484481,id9603e9c3,left_ankle,3.14351296424866,0,0,15261,97
15259,97,0.835692936469091,id9603e9c3,right_ankle,3.2443311214447,2,2,15261,97
3165,100,0.275266024892832,id9603e9c3,left_wrist,3.1929018497467,-2,-1,3163,101
3164,101,0.338164936282123,id9603e9c3,left_hip,3.29805111885071,-1,-1,3163,101
3163,100,0.769759648065828,id9603e9c3,left_ankle,3.14351296424866,0,1,3163,101
3163,100,0.75117713260624,id9603e9c3,right_ankle,3.2443311214447,0,1,3163,101
8762,100,0.30689905092285,id9603e9c3,left_wrist,3.1929018497467,-5,-2,8757,103
8761,102,0.390653857862874,id9603e9c3,left_hip,3.29805111885071,-4,-3,8757,103
8759,101,0.795378738660829,id9603e9c3,left_ankle,3.14351296424866,-2,0,8757,103
8758,102,0.753264257924059,id9603e9c3,right_ankle,3.2443311214447,-1,0,8757,103
6698,86,0.197878262789792,idfc5f05e4,left_wrist,2.77163219451904,2,1,6700,85
6699,85,0.284207037060446,idfc5f05e4,left_hip,2.89211988449097,1,1,6700,85
6695,87,0.925054746225163,idfc5f05e4,left_ankle,2.49707794189453,5,3,6700,85
6697,84,0.8164240720757,idfc5f05e4,right_ankle,2.71216797828674,3,4,6700,85
8870,85,0.220238116109101,idfc5f05e4,left_wrist,2.77163219451904,0,0,8870,85
8870,86,0.316029916083326,idfc5f05e4,left_hip,2.89211988449097,0,-1,8870,85
8871,84,0.935298367713485,idfc5f05e4,left_ankle,2.49707794189453,-1,0,8870,85
8869,83,0.932210687565052,idfc5f05e4,right_ankle,2.71216797828674,1,3,8870,85
10210,84,0.181572532838958,idfc5f05e4,left_wrist,2.77163219451904,1,1,10211,84
10212,84,0.292952200860216,idfc5f05e4,left_hip,2.89211988449097,-1,-1,10211,84
10208,87,0.973492634893138,idfc5f05e4,left_ankle,2.49707794189453,3,0,10211,84
10209,80,0.826966332788632,idfc5f05e4,right_ankle,2.71216797828674,2,6,10211,84
15296,85,0.25977044238761,idfc5f05e4,left_wrist,2.77163219451904,42,41,15338,84
15338,84,0.31653004894436,idfc5f05e4,left_hip,2.89211988449097,0,0,15338,84
15337,84,0.957626085966643,idfc5f05e4,left_ankle,2.49707794189453,1,1,15338,84
15334,87,0.947347609038687,idfc5f05e4,right_ankle,2.71216797828674,4,1,15338,84
3641,89,0.177972387668015,idfc5f05e4,left_wrist,2.77163219451904,2,0,3643,87
3642,87,0.279113256874788,idfc5f05e4,left_hip,2.89211988449097,1,1,3643,87
3640,89,0.966939467157244,idfc5f05e4,left_ankle,2.49707794189453,3,1,3643,87
3642,87,0.902932759069334,idfc5f05e4,right_ankle,2.71216797828674,1,1,3643,87
3815,88,0.176457483211244,idfc5f05e4,left_wrist,2.77163219451904,1,0,3816,87
3814,88,0.260780869038178,idfc5f05e4,left_hip,2.89211988449097,2,1,3816,87
3813,88,0.927175655369494,idfc5f05e4,left_ankle,2.49707794189453,3,2,3816,87
3814,89,0.828907631840647,idfc5f05e4,right_ankle,2.71216797828674,2,0,3816,87
12450,83,0.195096951663055,idfc5f05e4,left_wrist,2.77163219451904,0,1,12450,84
12452,83,0.317951703494675,idfc5f05e4,left_hip,2.89211988449097,-2,-1,12450,84
12449,84,0.96332839076615,idfc5f05e4,left_ankle,2.49707794189453,1,1,12450,84
12448,83,0.874505181586405,idfc5f05e4,right_ankle,2.71216797828674,2,3,12450,84
12950,84,0.216908601956935,idfc5f05e4,left_wrist,2.77163219451904,0,-1,12950,83
12952,83,0.353212991044426,idfc5f05e4,left_hip,2.89211988449097,-2,-2,12950,83
12950,83,1.00434745303379,idfc5f05e4,left_ankle,2.49707794189453,0,0,12950,83
12949,80,0.838542970642759,idfc5f05e4,right_ankle,2.71216797828674,1,4,12950,83
1923,89,0.223832498854489,idfc5f05e4,left_wrist,2.77163219451904,3,2,1926,88
1923,88,0.301610185313527,idfc5f05e4,left_hip,2.89211988449097,3,3,1926,88
1921,89,0.852296026921086,idfc5f05e4,left_ankle,2.49707794189453,5,4,1926,88
1924,87,0.907673202213762,idfc5f05e4,right_ankle,2.71216797828674,2,3,1926,88
15006,84,0.183259514261482,idfc5f05e4,left_wrist,2.77163219451904,1,0,15007,83
15008,83,0.346430645166394,idfc5f05e4,left_hip,2.89211988449097,-1,-1,15007,83
15007,79,0.86652636583277,idfc5f05e4,left_ankle,2.49707794189453,0,4,15007,83
15005,85,0.964376658064343,idfc5f05e4,right_ankle,2.71216797828674,2,0,15007,83
2436,86,0.249221669915251,idfc5f05e4,left_wrist,2.77163219451904,4,2,2440,84
2438,85,0.31998031666475,idfc5f05e4,left_hip,2.89211988449097,2,1,2440,84
2434,90,0.949367758672186,idfc5f05e4,left_ankle,2.49707794189453,6,0,2440,84
2436,86,0.930089645247805,idfc5f05e4,right_ankle,2.71216797828674,4,2,2440,84
2350,87,0.191662351182219,idfc5f05e4,left_wrist,2.77163219451904,4,4,2354,87
2353,86,0.305183282876198,idfc5f05e4,left_hip,2.89211988449097,1,2,2354,87
2352,83,0.853990148539697,idfc5f05e4,left_ankle,2.49707794189453,2,6,2354,87
2352,85,0.845654656922538,idfc5f05e4,right_ankle,2.71216797828674,2,4,2354,87
14432,83,0.196403099453761,idfc5f05e4,left_wrist,2.77163219451904,0,1,14432,84
14434,84,0.377325344036865,idfc5f05e4,left_hip,2.89211988449097,-2,-2,14432,84
14431,84,0.976475891547701,idfc5f05e4,left_ankle,2.49707794189453,1,1,14432,84
14430,84,0.96492262846044,idfc5f05e4,right_ankle,2.71216797828674,2,2,14432,84
8047,82,0.146873631953835,idfc5f05e4,left_wrist,2.77163219451904,-1,1,8046,84
8048,84,0.323488931437708,idfc5f05e4,left_hip,2.89211988449097,-2,-2,8046,84
8046,80,0.852721574881341,idfc5f05e4,left_ankle,2.49707794189453,0,4,8046,84
8043,83,0.965259172830584,idfc5f05e4,right_ankle,2.71216797828674,3,4,8046,84
2436,86,0.249221669915251,idfc5f05e4,left_wrist,2.77163219451904,4,2,2440,84
2438,85,0.31998031666475,idfc5f05e4,left_hip,2.89211988449097,2,1,2440,84
2434,90,0.949367758672186,idfc5f05e4,left_ankle,2.49707794189453,6,0,2440,84
2436,86,0.930089645247805,idfc5f05e4,right_ankle,2.71216797828674,4,2,2440,84
5447,85,0.16634194181131,idfc5f05e4,left_wrist,2.77163219451904,-1,0,5446,86
5447,85,0.268192312045665,idfc5f05e4,left_hip,2.89211988449097,-1,0,5446,86
5444,85,0.927828421965693,idfc5f05e4,left_ankle,2.49707794189453,2,3,5446,86
5445,85,0.908966375246625,idfc5f05e4,right_ankle,2.71216797828674,1,2,5446,86
10293,82,0.201368634379891,idfc5f05e4,left_wrist,2.77163219451904,1,2,10294,83
10295,82,0.319837008320205,idfc5f05e4,left_hip,2.89211988449097,-1,0,10294,83
10294,82,0.910666316851899,idfc5f05e4,left_ankle,2.49707794189453,0,1,10294,83
10288,83,0.939431356193816,idfc5f05e4,right_ankle,2.71216797828674,6,6,10294,83
4931,87,0.207402179639342,idfc5f05e4,left_wrist,2.77163219451904,1,1,4932,87
4930,86,0.283873514861784,idfc5f05e4,left_hip,2.89211988449097,2,3,4932,87
4929,87,0.839008858572946,idfc5f05e4,left_ankle,2.49707794189453,3,3,4932,87
4928,88,0.875978821818677,idfc5f05e4,right_ankle,2.71216797828674,4,3,4932,87
5531,85,0.199556778351514,idfc5f05e4,left_wrist,2.77163219451904,0,0,5531,85
5531,87,0.287079913163883,idfc5f05e4,left_hip,2.89211988449097,0,-2,5531,85
5528,85,0.858214993236476,idfc5f05e4,left_ankle,2.49707794189453,3,3,5531,85
5529,86,0.851995489844771,idfc5f05e4,right_ankle,2.71216797828674,2,1,5531,85
2350,87,0.191662351182219,idfc5f05e4,left_wrist,2.77163219451904,4,4,2354,87
2353,86,0.305183282876198,idfc5f05e4,left_hip,2.89211988449097,1,2,2354,87
2352,83,0.853990148539697,idfc5f05e4,left_ankle,2.49707794189453,2,6,2354,87
2352,85,0.845654656922538,idfc5f05e4,right_ankle,2.71216797828674,2,4,2354,87
15149,100,0.304377129157626,idf540d82b,left_wrist,4.05174493789673,12,10,15161,98
15155,98,0.273071579275322,idf540d82b,left_hip,4.05051612854004,6,6,15161,98
15150,99,0.537011278307505,idf540d82b,left_ankle,4.79123306274414,11,10,15161,98
15150,101,0.472665480869543,idf540d82b,right_ankle,4.84579110145569,11,8,15161,98
4326,99,0.318265164829644,idf540d82b,left_wrist,4.05174493789673,10,12,4336,101
4334,96,0.275183128246702,idf540d82b,left_hip,4.05051612854004,2,7,4336,101
4326,101,0.54874490283034,idf540d82b,left_ankle,4.79123306274414,10,10,4336,101
4326,101,0.487337988111809,idf540d82b,right_ankle,4.84579110145569,10,10,4336,101
21901,97,0.343276926783098,idf540d82b,left_wrist,4.05174493789673,4,6,21905,99
21906,96,0.34408566891047,idf540d82b,left_hip,4.05051612854004,-1,2,21905,99
21899,98,0.662754713409746,idf540d82b,left_ankle,4.79123306274414,6,7,21905,99
21898,97,0.616013846325251,idf540d82b,right_ankle,4.84579110145569,7,9,21905,99
20554,100,0.328052781346011,idf540d82b,left_wrist,4.05174493789673,11,4,20565,93
20561,100,0.369876743218954,idf540d82b,left_hip,4.05051612854004,4,-3,20565,93
20555,97,0.648279097718631,idf540d82b,left_ankle,4.79123306274414,10,6,20565,93
20553,99,0.481994623355517,idf540d82b,right_ankle,4.84579110145569,12,6,20565,93
21664,98,0.343440154467934,idf540d82b,left_wrist,4.05174493789673,49,47,21713,96
21716,95,0.371132937896195,idf540d82b,left_hip,4.05051612854004,-3,-2,21713,96
21706,97,0.600052007142834,idf540d82b,left_ankle,4.79123306274414,7,6,21713,96
21706,97,0.5858324696159,idf540d82b,right_ankle,4.84579110145569,7,6,21713,96
16609,96,0.329263536440821,idf540d82b,left_wrist,4.05174493789673,3,5,16612,98
16614,96,0.344265153056282,idf540d82b,left_hip,4.05051612854004,-2,0,16612,98
16605,98,0.650744231464218,idf540d82b,left_ankle,4.79123306274414,7,7,16612,98
16605,98,0.550725266204182,idf540d82b,right_ankle,4.84579110145569,7,7,16612,98
8574,99,0.240456823570185,idf540d82b,left_wrist,4.05174493789673,11,11,8585,99
8581,96,0.263610581141362,idf540d82b,left_hip,4.05051612854004,4,7,8585,99
8574,100,0.467883952785224,idf540d82b,left_ankle,4.79123306274414,11,10,8585,99
8575,98,0.518301503778748,idf540d82b,right_ankle,4.84579110145569,10,11,8585,99
17949,50,0.106695765344634,idf540d82b,left_wrist,4.05174493789673,4,50,17953,96
17955,94,0.390388049669965,idf540d82b,left_hip,4.05051612854004,-2,0,17953,96
17947,96,0.604946084936505,idf540d82b,left_ankle,4.79123306274414,6,6,17953,96
17947,94,0.644509205831617,idf540d82b,right_ankle,4.84579110145569,6,8,17953,96
372,95,0.246055772974423,idf540d82b,left_wrist,4.05174493789673,-46,-41,326,100
322,98,0.306005667013027,idf540d82b,left_hip,4.05051612854004,4,6,326,100
316,98,0.624441366242172,idf540d82b,left_ankle,4.79123306274414,10,12,326,100
317,98,0.532204760676185,idf540d82b,right_ankle,4.84579110145569,9,11,326,100
21664,98,0.343440154467934,idf540d82b,left_wrist,4.05174493789673,49,51,21713,100
21716,95,0.371132937896195,idf540d82b,left_hip,4.05051612854004,-3,2,21713,100
21706,97,0.600052007142834,idf540d82b,left_ankle,4.79123306274414,7,10,21713,100
21706,97,0.5858324696159,idf540d82b,right_ankle,4.84579110145569,7,10,21713,100
22759,100,0.312715893734782,idf540d82b,left_wrist,4.05174493789673,12,9,22771,97
22768,97,0.298042643902793,idf540d82b,left_hip,4.05051612854004,3,3,22771,97
22761,98,0.589320430357749,idf540d82b,left_ankle,4.79123306274414,10,9,22771,97
22760,99,0.553662635228399,idf540d82b,right_ankle,4.84579110145569,11,9,22771,97
8280,99,0.260174449189966,idf540d82b,left_wrist,4.05174493789673,9,6,8289,96
8286,100,0.282574928105579,idf540d82b,left_hip,4.05051612854004,3,-1,8289,96
8281,97,0.599841330687998,idf540d82b,left_ankle,4.79123306274414,8,7,8289,96
8280,98,0.526280920866753,idf540d82b,right_ankle,4.84579110145569,9,7,8289,96
17185,97,0.338869043876961,idf540d82b,left_wrist,4.05174493789673,4,7,17189,100
17190,98,0.351468772203365,idf540d82b,left_hip,4.05051612854004,-1,1,17189,100
17183,96,0.582765552953366,idf540d82b,left_ankle,4.79123306274414,6,10,17189,100
17182,101,0.666956386182247,idf540d82b,right_ankle,4.84579110145569,7,6,17189,100
18233,96,0.321150737404701,idf540d82b,left_wrist,4.05174493789673,2,3,18235,97
18237,98,0.358153897514428,idf540d82b,left_hip,4.05051612854004,-2,-3,18235,97
18229,97,0.675117981350861,idf540d82b,left_ankle,4.79123306274414,6,6,18235,97
18232,95,0.618661774001663,idf540d82b,right_ankle,4.84579110145569,3,5,18235,97
16216,97,0.239486310022925,idf540d82b,left_wrist,4.05174493789673,8,10,16224,99
16222,97,0.321318973239544,idf540d82b,left_hip,4.05051612854004,2,4,16224,99
16213,99,0.535437579111646,idf540d82b,left_ankle,4.79123306274414,11,11,16224,99
16211,101,0.598140334449738,idf540d82b,right_ankle,4.84579110145569,13,11,16224,99
11098,95,0.32223262420731,idf540d82b,left_wrist,4.05174493789673,5,7,11103,97
11102,95,0.321477165453699,idf540d82b,left_hip,4.05051612854004,1,3,11103,97
11093,97,0.534857973602065,idf540d82b,left_ankle,4.79123306274414,10,10,11103,97
11095,95,0.602499730922404,idf540d82b,right_ankle,4.84579110145569,8,10,11103,97
11382,101,0.292785060319941,idf540d82b,left_wrist,4.05174493789673,7,3,11389,97
11388,99,0.332909833247217,idf540d82b,left_hip,4.05051612854004,1,-1,11389,97
11382,94,0.630469264657423,idf540d82b,left_ankle,4.79123306274414,7,10,11389,97
11382,94,0.555024299108891,idf540d82b,right_ankle,4.84579110145569,7,10,11389,97
7091,101,0.26499190432432,idf540d82b,left_wrist,4.05174493789673,16,15,7107,100
7099,102,0.259486001939916,idf540d82b,left_hip,4.05051612854004,8,6,7107,100
7096,100,0.524023853660879,idf540d82b,left_ankle,4.79123306274414,11,11,7107,100
7094,102,0.47489979546842,idf540d82b,right_ankle,4.84579110145569,13,11,7107,100
15922,98,0.284149809033804,idf540d82b,left_wrist,4.05174493789673,10,8,15932,96
15927,99,0.273025639919296,idf540d82b,left_hip,4.05051612854004,5,2,15932,96
15921,97,0.549743055541926,idf540d82b,left_ankle,4.79123306274414,11,10,15932,96
15922,97,0.534786668876093,idf540d82b,right_ankle,4.84579110145569,10,9,15932,96
18909,95,0.403394575528454,idf540d82b,left_wrist,4.05174493789673,4,7,18913,98
18913,95,0.362901014719772,idf540d82b,left_hip,4.05051612854004,0,3,18913,98
18902,98,0.595458852887819,idf540d82b,left_ankle,4.79123306274414,11,11,18913,98
18906,94,0.547799824986998,idf540d82b,right_ankle,4.84579110145569,7,11,18913,98
7970,93,0.196938302981518,idb221f542,left_wrist,3.16808485984802,-2,-2,7968,93
7977,95,0.251454128471629,idb221f542,left_hip,2.99407196044922,-9,-11,7968,93
7967,93,0.763633501413425,idb221f542,left_ankle,3.27086520195007,1,1,7968,93
7971,94,0.793225359345483,idb221f542,right_ankle,3.22318005561829,-3,-4,7968,93
9417,97,0.284204344297896,idb221f542,left_wrist,3.16808485984802,-3,-3,9414,97
9422,97,0.323913569931504,idb221f542,left_hip,2.99407196044922,-8,-8,9414,97
9413,100,0.873194310366504,idb221f542,left_ankle,3.27086520195007,1,-2,9414,97
9416,98,0.798685534292404,idb221f542,right_ankle,3.22318005561829,-2,-3,9414,97
12125,99,0.235371967595181,idb221f542,left_wrist,3.16808485984802,-1,-2,12124,98
12131,98,0.289732717597053,idb221f542,left_hip,2.99407196044922,-7,-7,12124,98
12122,99,0.766513851435263,idb221f542,left_ankle,3.27086520195007,2,1,12124,98
12126,99,0.838162526066608,idb221f542,right_ankle,3.22318005561829,-2,-3,12124,98
2710,100,0.228321285902784,idb221f542,left_wrist,3.16808485984802,-4,-3,2706,101
2706,100,0.287816130212636,idb221f542,left_hip,2.99407196044922,0,1,2706,101
2706,100,0.791955880782864,idb221f542,left_ankle,3.27086520195007,0,1,2706,101
2704,99,0.827189486945872,idb221f542,right_ankle,3.22318005561829,2,4,2706,101
6321,99,0.257897880716536,idb221f542,left_wrist,3.16808485984802,-2,-2,6319,99
6326,98,0.3117573975344,idb221f542,left_hip,2.99407196044922,-7,-6,6319,99
6319,98,0.792773520057327,idb221f542,left_ankle,3.27086520195007,0,1,6319,99
6321,98,0.815940545717326,idb221f542,right_ankle,3.22318005561829,-2,-1,6319,99
7488,98,0.291597127727947,idb221f542,left_wrist,3.16808485984802,-1,-1,7487,98
7488,98,0.306703647408021,idb221f542,left_hip,2.99407196044922,-1,-1,7487,98
7486,97,0.800067361000325,idb221f542,left_ankle,3.27086520195007,1,2,7487,98
7486,97,0.843410115040639,idb221f542,right_ankle,3.22318005561829,1,2,7487,98
1628,100,0.19006203561686,idb221f542,left_wrist,3.16808485984802,-2,-3,1626,99
1625,100,0.275682359415732,idb221f542,left_hip,2.99407196044922,1,0,1626,99
1624,99,0.756800684161738,idb221f542,left_ankle,3.27086520195007,2,2,1626,99
1624,99,0.810491830797621,idb221f542,right_ankle,3.22318005561829,2,2,1626,99
17010,100,0.303234405711108,idb221f542,left_wrist,3.16808485984802,-3,-3,17007,100
17013,100,0.340848556424704,idb221f542,left_hip,2.99407196044922,-6,-6,17007,100
17008,101,0.838258917141719,idb221f542,left_ankle,3.27086520195007,-1,-2,17007,100
17009,99,0.801664490507661,idb221f542,right_ankle,3.22318005561829,-2,-1,17007,100
15347,99,0.313594964447582,idb221f542,left_wrist,3.16808485984802,-3,-3,15344,99
15352,97,0.322370017174726,idb221f542,left_hip,2.99407196044922,-8,-6,15344,99
15346,100,0.807531175698229,idb221f542,left_ankle,3.27086520195007,-2,-3,15344,99
15346,100,0.835328442807339,idb221f542,right_ankle,3.22318005561829,-2,-3,15344,99
16029,100,0.29328463335151,idb221f542,left_wrist,3.16808485984802,-2,-3,16027,99
16033,99,0.3317357601532,idb221f542,left_hip,2.99407196044922,-6,-6,16027,99
16028,100,0.764736686206978,idb221f542,left_ankle,3.27086520195007,-1,-2,16027,99
16029,99,0.776187814241948,idb221f542,right_ankle,3.22318005561829,-2,-2,16027,99
17109,98,0.304006350501662,idb221f542,left_wrist,3.16808485984802,-3,-2,17106,99
17112,99,0.340997599758452,idb221f542,left_hip,2.99407196044922,-6,-6,17106,99
17108,98,0.769261013288373,idb221f542,left_ankle,3.27086520195007,-2,-1,17106,99
17107,100,0.809510128880681,idb221f542,right_ankle,3.22318005561829,-1,-2,17106,99
1431,99,0.185517517071626,idb221f542,left_wrist,3.16808485984802,-3,-3,1428,99
1429,97,0.283876812374239,idb221f542,left_hip,2.99407196044922,-1,1,1428,99
1427,99,0.761924508536028,idb221f542,left_ankle,3.27086520195007,1,1,1428,99
1426,102,0.853312462109836,idb221f542,right_ankle,3.22318005561829,2,-1,1428,99
7005,96,0.259607771284979,idb221f542,left_wrist,3.16808485984802,-2,-1,7003,97
7009,98,0.301941265790606,idb221f542,left_hip,2.99407196044922,-6,-7,7003,97
7002,98,0.805591633144608,idb221f542,left_ankle,3.27086520195007,1,0,7003,97
7004,99,0.837719243756816,idb221f542,right_ankle,3.22318005561829,-1,-3,7003,97
9899,99,0.296569202050406,idb221f542,left_wrist,3.16808485984802,-2,-2,9897,99
9905,97,0.301321322752557,idb221f542,left_hip,2.99407196044922,-8,-6,9897,99
9897,98,0.830120083643769,idb221f542,left_ankle,3.27086520195007,0,1,9897,99
9899,99,0.85221840553449,idb221f542,right_ankle,3.22318005561829,-2,-2,9897,99
2021,100,0.175867781774659,idb221f542,left_wrist,3.16808485984802,-3,-3,2018,100
2018,99,0.296705843210817,idb221f542,left_hip,2.99407196044922,0,1,2018,100
2016,101,0.754225990897717,idb221f542,left_ankle,3.27086520195007,2,1,2018,100
2016,100,0.806645412145759,idb221f542,right_ankle,3.22318005561829,2,2,2018,100
14664,99,0.326449203059938,idb221f542,left_wrist,3.16808485984802,-2,-2,14662,99
14667,100,0.321012330646769,idb221f542,left_hip,2.99407196044922,-5,-6,14662,99
14661,102,0.779198852871039,idb221f542,left_ankle,3.27086520195007,1,-2,14662,99
14664,99,0.752916447154452,idb221f542,right_ankle,3.22318005561829,-2,-2,14662,99
13488,99,0.246866531951919,idb221f542,left_wrist,3.16808485984802,-4,-4,13484,99
13490,99,0.311118649558263,idb221f542,left_hip,2.99407196044922,-6,-6,13484,99
13486,99,0.754504184367027,idb221f542,left_ankle,3.27086520195007,-2,-2,13484,99
13487,99,0.792814801733528,idb221f542,right_ankle,3.22318005561829,-3,-3,13484,99
1141,98,0.1891550654848,idb221f542,left_wrist,3.16808485984802,-4,-3,1137,99
1139,96,0.273774462423823,idb221f542,left_hip,2.99407196044922,-2,1,1137,99
1136,98,0.810852811182827,idb221f542,left_ankle,3.27086520195007,1,2,1137,99
1136,98,0.840639717031522,idb221f542,right_ankle,3.22318005561829,1,2,1137,99
8836,99,0.299199017834613,idb221f542,left_wrist,3.16808485984802,-1,-2,8835,98
8844,95,0.288413121865557,idb221f542,left_hip,2.99407196044922,-9,-6,8835,98
8835,97,0.824870666362889,idb221f542,left_ankle,3.27086520195007,0,1,8835,98
8838,98,0.815885592877822,idb221f542,right_ankle,3.22318005561829,-3,-3,8835,98
16814,98,0.311812405594388,idb221f542,left_wrist,3.16808485984802,-4,-2,16810,100
16817,99,0.341269095319867,idb221f542,left_hip,2.99407196044922,-7,-6,16810,100
16812,99,0.797788677584648,idb221f542,left_ankle,3.27086520195007,-2,-1,16810,100
16811,100,0.76265628370212,idb221f542,right_ankle,3.22318005561829,-1,-1,16810,100
