tau_i,T_i,sim_i,subj_id,loc_id,exec_t,SS_start_diff,SS_end_diff,manSS_tau_i,manSS_T_i
5058,114,0.335553124593897,idabd0c53c,left_wrist,3.1791660785675,54,53,5112,113
5111,114,0.381697258591824,idabd0c53c,left_hip,3.29924297332764,1,0,5112,113
5111,114,0.671502030131731,idabd0c53c,left_ankle,3.01360607147217,1,0,5112,113
5113,116,0.602116451241124,idabd0c53c,right_ankle,2.9379711151123,-1,-4,5112,113
7101,112,0.34705355618779,idabd0c53c,left_wrist,3.1791660785675,50,49,7151,111
7152,113,0.335604347862092,idabd0c53c,left_hip,3.29924297332764,-1,-3,7151,111
7152,110,0.641704900819237,idabd0c53c,left_ankle,3.01360607147217,-1,0,7151,111
7154,109,0.637770025583545,idabd0c53c,right_ankle,2.9379711151123,-3,-1,7151,111
10929,109,0.39583442874618,idabd0c53c,left_wrist,3.1791660785675,-3,-3,10926,109
10926,109,0.41491599268532,idabd0c53c,left_hip,3.29924297332764,0,0,10926,109
10925,109,0.750756036586605,idabd0c53c,left_ankle,3.01360607147217,1,1,10926,109
10925,109,0.654507057650387,idabd0c53c,right_ankle,2.9379711151123,1,1,10926,109
17244,108,0.449990556550842,idabd0c53c,left_wrist,3.1791660785675,-3,-3,17241,108
17244,105,0.426020694909081,idabd0c53c,left_hip,3.29924297332764,-3,0,17241,108
17241,107,0.673916572537917,idabd0c53c,left_ankle,3.01360607147217,0,1,17241,108
17241,108,0.694325878198138,idabd0c53c,right_ankle,2.9379711151123,0,0,17241,108
3798,115,0.402126103318451,idabd0c53c,left_wrist,3.1791660785675,54,54,3852,115
3851,117,0.372433186003562,idabd0c53c,left_hip,3.29924297332764,1,-1,3852,115
3850,117,0.650829437158568,idabd0c53c,left_ankle,3.01360607147217,2,0,3852,115
3856,113,0.633129798936989,idabd0c53c,right_ankle,2.9379711151123,-4,-2,3852,115
17033,107,0.440117454669387,idabd0c53c,left_wrist,3.1791660785675,-4,-4,17029,107
17030,106,0.467767308531594,idabd0c53c,left_hip,3.29924297332764,-1,0,17029,107
17030,106,0.768255583478989,idabd0c53c,left_ankle,3.01360607147217,-1,0,17029,107
17029,105,0.691730436879384,idabd0c53c,right_ankle,2.9379711151123,0,2,17029,107
17881,106,0.461905310537443,idabd0c53c,left_wrist,3.1791660785675,-3,-3,17878,106
17879,105,0.469699322135905,idabd0c53c,left_hip,3.29924297332764,-1,0,17878,106
17878,106,0.660325715563753,idabd0c53c,left_ankle,3.01360607147217,0,0,17878,106
17878,108,0.672153236665634,idabd0c53c,right_ankle,2.9379711151123,0,-2,17878,106
12567,110,0.380622503121284,idabd0c53c,left_wrist,3.1791660785675,-4,-4,12563,110
12564,112,0.372451880787934,idabd0c53c,left_hip,3.29924297332764,-1,-3,12563,110
12562,111,0.66513397469648,idabd0c53c,left_ankle,3.01360607147217,1,0,12563,110
12564,109,0.661971203656915,idabd0c53c,right_ankle,2.9379711151123,-1,0,12563,110
12017,57,0.249956978969942,idabd0c53c,left_wrist,3.1791660785675,-3,51,12014,111
12015,111,0.421108952253833,idabd0c53c,left_hip,3.29924297332764,-1,-1,12014,111
12013,111,0.685682025281544,idabd0c53c,left_ankle,3.01360607147217,1,1,12014,111
12014,112,0.594425545229783,idabd0c53c,right_ankle,2.9379711151123,0,-1,12014,111
1227,108,0.386366478191323,idabd0c53c,left_wrist,3.1791660785675,50,50,1277,108
1277,107,0.370378529336758,idabd0c53c,left_hip,3.29924297332764,0,1,1277,108
1277,106,0.751765931077574,idabd0c53c,left_ankle,3.01360607147217,0,2,1277,108
1275,110,0.689696575841677,idabd0c53c,right_ankle,2.9379711151123,2,0,1277,108
3912,114,0.381593123260599,idabd0c53c,left_wrist,3.1791660785675,54,53,3966,113
3967,113,0.364487009526767,idabd0c53c,left_hip,3.29924297332764,-1,-1,3966,113
3966,113,0.730456590734617,idabd0c53c,left_ankle,3.01360607147217,0,0,3966,113
3968,115,0.5811296462709,idabd0c53c,right_ankle,2.9379711151123,-2,-4,3966,113
3346,112,0.400102784183328,idabd0c53c,left_wrist,3.1791660785675,51,52,3397,113
3397,113,0.380401818947288,idabd0c53c,left_hip,3.29924297332764,0,0,3397,113
3397,112,0.688637835969396,idabd0c53c,left_ankle,3.01360607147217,0,1,3397,113
3399,115,0.63058154959142,idabd0c53c,right_ankle,2.9379711151123,-2,-4,3397,113
13060,110,0.392697022083153,idabd0c53c,left_wrist,3.1791660785675,51,52,13111,111
13111,114,0.432530755129865,idabd0c53c,left_hip,3.29924297332764,0,-3,13111,111
13110,112,0.67972392994714,idabd0c53c,left_ankle,3.01360607147217,1,0,13111,111
13111,110,0.661324713535568,idabd0c53c,right_ankle,2.9379711151123,0,1,13111,111
7321,115,0.328926026648168,idabd0c53c,left_wrist,3.1791660785675,51,51,7372,115
7372,117,0.343964094267637,idabd0c53c,left_hip,3.29924297332764,0,-2,7372,115
7371,116,0.712274102055166,idabd0c53c,left_ankle,3.01360607147217,1,0,7372,115
7375,115,0.562589950879049,idabd0c53c,right_ankle,2.9379711151123,-3,-3,7372,115
14714,107,0.418715165342717,idabd0c53c,left_wrist,3.1791660785675,-4,-2,14710,109
14711,113,0.398229771791801,idabd0c53c,left_hip,3.29924297332764,-1,-5,14710,109
14710,107,0.640453768830134,idabd0c53c,left_ankle,3.01360607147217,0,2,14710,109
14711,105,0.666148426224694,idabd0c53c,right_ankle,2.9379711151123,-1,3,14710,109
9526,58,0.230249974511896,idabd0c53c,left_wrist,3.1791660785675,-3,51,9523,112
9524,110,0.383941876365843,idabd0c53c,left_hip,3.29924297332764,-1,1,9523,112
9524,110,0.732592759809268,idabd0c53c,left_ankle,3.01360607147217,-1,1,9523,112
9525,112,0.665657717366705,idabd0c53c,right_ankle,2.9379711151123,-2,-2,9523,112
13607,108,0.4090061356322,idabd0c53c,left_wrist,3.1791660785675,50,47,13657,105
13659,104,0.494541091649144,idabd0c53c,left_hip,3.29924297332764,-2,-1,13657,105
13657,104,0.709062511173569,idabd0c53c,left_ankle,3.01360607147217,0,1,13657,105
13656,104,0.707427418475076,idabd0c53c,right_ankle,2.9379711151123,1,2,13657,105
18838,108,0.41061465343884,idabd0c53c,left_wrist,3.1791660785675,-2,-2,18836,108
18835,108,0.411765375715407,idabd0c53c,left_hip,3.29924297332764,1,1,18836,108
18835,108,0.713039068692738,idabd0c53c,left_ankle,3.01360607147217,1,1,18836,108
18835,108,0.716457977183718,idabd0c53c,right_ankle,2.9379711151123,1,1,18836,108
7212,110,0.388560804433054,idabd0c53c,left_wrist,3.1791660785675,49,51,7261,112
7264,109,0.389140099306709,idabd0c53c,left_hip,3.29924297332764,-3,0,7261,112
7261,111,0.672986368039839,idabd0c53c,left_ankle,3.01360607147217,0,1,7261,112
7262,114,0.600647388967209,idabd0c53c,right_ankle,2.9379711151123,-1,-3,7261,112
14714,107,0.418715165342717,idabd0c53c,left_wrist,3.1791660785675,-4,-2,14710,109
14711,113,0.398229771791801,idabd0c53c,left_hip,3.29924297332764,-1,-5,14710,109
14710,107,0.640453768830134,idabd0c53c,left_ankle,3.01360607147217,0,2,14710,109
14711,105,0.666148426224694,idabd0c53c,right_ankle,2.9379711151123,-1,3,14710,109
18058,95,0.296203823824957,id5993bf4a,left_wrist,3.46885299682617,-3,-7,18055,91
18061,94,0.503169842309992,id5993bf4a,left_hip,3.39592814445496,-6,-9,18055,91
18053,94,0.850517934501361,id5993bf4a,left_ankle,3.52782106399536,2,-1,18055,91
18053,92,0.734983913512199,id5993bf4a,right_ankle,3.39012908935547,2,1,18055,91
4112,98,0.233936325403172,id5993bf4a,left_wrist,3.46885299682617,0,-1,4112,97
4111,98,0.366434887721438,id5993bf4a,left_hip,3.39592814445496,1,0,4112,97
4108,98,0.870954192673403,id5993bf4a,left_ankle,3.52782106399536,4,3,4112,97
4108,99,0.683358240266834,id5993bf4a,right_ankle,3.39012908935547,4,2,4112,97
12551,98,0.222888510529393,id5993bf4a,left_wrist,3.46885299682617,0,-2,12551,96
12552,100,0.482363726203605,id5993bf4a,left_hip,3.39592814445496,-1,-5,12551,96
12549,97,0.76480323635247,id5993bf4a,left_ankle,3.52782106399536,2,1,12551,96
12550,96,0.748459401743107,id5993bf4a,right_ankle,3.39012908935547,1,1,12551,96
2485,123,0.225490928291463,id5993bf4a,left_wrist,3.46885299682617,2,-27,2487,94
2486,96,0.34972526530247,id5993bf4a,left_hip,3.39592814445496,1,-1,2487,94
2484,96,0.914388315848766,id5993bf4a,left_ankle,3.52782106399536,3,1,2487,94
2483,97,0.731159058056803,id5993bf4a,right_ankle,3.39012908935547,4,1,2487,94
5172,97,0.20295490610203,id5993bf4a,left_wrist,3.46885299682617,-1,-3,5171,95
5172,97,0.336186693372353,id5993bf4a,left_hip,3.39592814445496,-1,-3,5171,95
5168,95,0.87377212037602,id5993bf4a,left_ankle,3.52782106399536,3,3,5171,95
5169,95,0.690086971702975,id5993bf4a,right_ankle,3.39012908935547,2,2,5171,95
7464,98,0.22819411240019,id5993bf4a,left_wrist,3.46885299682617,-2,-2,7462,98
7463,98,0.385660565841964,id5993bf4a,left_hip,3.39592814445496,-1,-1,7462,98
7460,99,0.899588879115323,id5993bf4a,left_ankle,3.52782106399536,2,1,7462,98
7460,98,0.773574948983584,id5993bf4a,right_ankle,3.39012908935547,2,2,7462,98
392,95,0.236733599296216,id5993bf4a,left_wrist,3.46885299682617,-5,-4,387,96
392,95,0.443302429066983,id5993bf4a,left_hip,3.39592814445496,-5,-4,387,96
385,96,0.772714048892755,id5993bf4a,left_ankle,3.52782106399536,2,2,387,96
387,95,0.736419117223659,id5993bf4a,right_ankle,3.39012908935547,0,1,387,96
7367,98,0.207849992196582,id5993bf4a,left_wrist,3.46885299682617,-1,-2,7366,97
7368,96,0.371414439829444,id5993bf4a,left_hip,3.39592814445496,-2,-1,7366,97
7363,98,0.784360611744941,id5993bf4a,left_ankle,3.52782106399536,3,2,7366,97
7364,97,0.711385630302263,id5993bf4a,right_ankle,3.39012908935547,2,2,7366,97
16740,95,0.251859717718601,id5993bf4a,left_wrist,3.46885299682617,-3,-2,16737,96
16742,96,0.507975440281577,id5993bf4a,left_hip,3.39592814445496,-5,-5,16737,96
16735,96,0.837296019520228,id5993bf4a,left_ankle,3.52782106399536,2,2,16737,96
16735,95,0.790853620433158,id5993bf4a,right_ankle,3.39012908935547,2,3,16737,96
6606,97,0.274942477449352,id5993bf4a,left_wrist,3.46885299682617,-3,-2,6603,98
6606,96,0.42031734952698,id5993bf4a,left_hip,3.39592814445496,-3,-1,6603,98
6601,98,0.904742300908629,id5993bf4a,left_ankle,3.52782106399536,2,2,6603,98
6602,98,0.756928165359782,id5993bf4a,right_ankle,3.39012908935547,1,1,6603,98
9302,95,0.256573706146857,id5993bf4a,left_wrist,3.46885299682617,-5,-11,9297,89
9303,95,0.553524276323705,id5993bf4a,left_hip,3.39592814445496,-6,-12,9297,89
9296,88,0.887945035451985,id5993bf4a,left_ankle,3.52782106399536,1,2,9297,89
9298,90,0.794924132969533,id5993bf4a,right_ankle,3.39012908935547,-1,-2,9297,89
11584,98,0.245677198084183,id5993bf4a,left_wrist,3.46885299682617,-1,3,11583,102
11588,95,0.401654718222269,id5993bf4a,left_hip,3.39592814445496,-5,2,11583,102
11581,103,0.788135427413899,id5993bf4a,left_ankle,3.52782106399536,2,1,11583,102
11580,98,0.696757607356538,id5993bf4a,right_ankle,3.39012908935547,3,7,11583,102
9483,96,0.234169468828132,id5993bf4a,left_wrist,3.46885299682617,-5,-5,9478,96
9485,94,0.498195559229771,id5993bf4a,left_hip,3.39592814445496,-7,-5,9478,96
9477,100,0.864591732842062,id5993bf4a,left_ankle,3.52782106399536,1,-3,9478,96
9478,96,0.805774854630865,id5993bf4a,right_ankle,3.39012908935547,0,0,9478,96
3626,94,0.205174426251769,id5993bf4a,left_wrist,3.46885299682617,1,4,3627,97
3632,94,0.413356174249377,id5993bf4a,left_hip,3.39592814445496,-5,-2,3627,97
3626,96,0.748091840771828,id5993bf4a,left_ankle,3.52782106399536,1,2,3627,97
3626,96,0.731780637030996,id5993bf4a,right_ankle,3.39012908935547,1,2,3627,97
15881,98,0.312587029606832,id5993bf4a,left_wrist,3.46885299682617,-2,-1,15879,99
15884,96,0.495645678463682,id5993bf4a,left_hip,3.39592814445496,-5,-2,15879,99
15878,97,0.867036113224805,id5993bf4a,left_ankle,3.52782106399536,1,3,15879,99
15878,97,0.700920443398748,id5993bf4a,right_ankle,3.39012908935547,1,3,15879,99
12935,102,0.346818073172353,id5993bf4a,left_wrist,3.46885299682617,1,-4,12936,97
12939,98,0.501135827136275,id5993bf4a,left_hip,3.39592814445496,-3,-4,12936,97
12935,97,0.844041494988709,id5993bf4a,left_ankle,3.52782106399536,1,1,12936,97
12935,97,0.804508200257714,id5993bf4a,right_ankle,3.39012908935547,1,1,12936,97
15311,97,0.263797263627025,id5993bf4a,left_wrist,3.46885299682617,-1,-1,15310,97
15313,96,0.519276656258631,id5993bf4a,left_hip,3.39592814445496,-3,-2,15310,97
15306,98,0.862641660079738,id5993bf4a,left_ankle,3.52782106399536,4,3,15310,97
15306,97,0.774412652200816,id5993bf4a,right_ankle,3.39012908935547,4,4,15310,97
2191,103,0.221415102589532,id5993bf4a,left_wrist,3.46885299682617,5,-1,2196,97
2196,99,0.373710215207347,id5993bf4a,left_hip,3.39592814445496,0,-2,2196,97
2194,98,0.898934203166833,id5993bf4a,left_ankle,3.52782106399536,2,1,2196,97
2194,98,0.771175080704692,id5993bf4a,right_ankle,3.39012908935547,2,1,2196,97
13903,97,0.240889018377335,id5993bf4a,left_wrist,3.46885299682617,-4,-3,13899,98
13904,96,0.427214732318373,id5993bf4a,left_hip,3.39592814445496,-5,-3,13899,98
13898,97,0.769722574695962,id5993bf4a,left_ankle,3.52782106399536,1,2,13899,98
13899,97,0.734158575316147,id5993bf4a,right_ankle,3.39012908935547,0,1,13899,98
8032,124,0.217366365660273,id5993bf4a,left_wrist,3.46885299682617,-4,-28,8028,100
8029,98,0.306048101390311,id5993bf4a,left_hip,3.39592814445496,-1,1,8028,100
8026,100,0.796632352210556,id5993bf4a,left_ankle,3.52782106399536,2,2,8028,100
8025,100,0.736959069451773,id5993bf4a,right_ankle,3.39012908935547,3,3,8028,100
13845,53,0.190132596622803,idd80ac2b4,left_wrist,2.97348690032959,-2,46,13843,101
13841,100,0.35163655766566,idd80ac2b4,left_hip,2.6537880897522,2,3,13843,101
13841,101,0.800016193047667,idd80ac2b4,left_ankle,2.67027711868286,2,2,13843,101
13841,100,0.706645681687352,idd80ac2b4,right_ankle,2.68798494338989,2,3,13843,101
10917,96,0.184040144314899,idd80ac2b4,left_wrist,2.97348690032959,0,3,10917,99
10913,98,0.324863483743246,idd80ac2b4,left_hip,2.6537880897522,4,5,10917,99
10915,97,0.787220883578692,idd80ac2b4,left_ankle,2.67027711868286,2,4,10917,99
10915,97,0.765060730241521,idd80ac2b4,right_ankle,2.68798494338989,2,4,10917,99
13154,101,0.20448320349175,idd80ac2b4,left_wrist,2.97348690032959,0,-1,13154,100
13149,101,0.346783210878163,idd80ac2b4,left_hip,2.6537880897522,5,4,13154,100
13152,100,0.80458088669029,idd80ac2b4,left_ankle,2.67027711868286,2,2,13154,100
13151,99,0.711827853308951,idd80ac2b4,right_ankle,2.68798494338989,3,4,13154,100
9355,103,0.173665719242458,idd80ac2b4,left_wrist,2.97348690032959,6,2,9361,99
9356,99,0.263588116046675,idd80ac2b4,left_hip,2.6537880897522,5,5,9361,99
9358,99,0.820621824284169,idd80ac2b4,left_ankle,2.67027711868286,3,3,9361,99
9358,100,0.758894845984435,idd80ac2b4,right_ankle,2.68798494338989,3,2,9361,99
8865,95,0.141598087110911,idd80ac2b4,left_wrist,2.97348690032959,3,7,8868,99
8862,101,0.320444729593305,idd80ac2b4,left_hip,2.6537880897522,6,4,8868,99
8866,100,0.73909478372843,idd80ac2b4,left_ankle,2.67027711868286,2,1,8868,99
8864,99,0.769904444188917,idd80ac2b4,right_ankle,2.68798494338989,4,4,8868,99
13254,54,0.165276191089894,idd80ac2b4,left_wrist,2.97348690032959,-1,43,13253,98
13249,97,0.333844169678856,idd80ac2b4,left_hip,2.6537880897522,4,5,13253,98
13251,98,0.773083870033337,idd80ac2b4,left_ankle,2.67027711868286,2,2,13253,98
13249,99,0.816616015267234,idd80ac2b4,right_ankle,2.68798494338989,4,3,13253,98
563,100,0.172205655833387,idd80ac2b4,left_wrist,2.97348690032959,6,4,569,98
562,98,0.311139676059797,idd80ac2b4,left_hip,2.6537880897522,7,7,569,98
565,98,0.699443495265213,idd80ac2b4,left_ankle,2.67027711868286,4,4,569,98
565,99,0.705771518360901,idd80ac2b4,right_ankle,2.68798494338989,4,3,569,98
8077,96,0.178354243360138,idd80ac2b4,left_wrist,2.97348690032959,4,7,8081,99
8075,98,0.232062991371678,idd80ac2b4,left_hip,2.6537880897522,6,7,8081,99
8078,98,0.797724654114442,idd80ac2b4,left_ankle,2.67027711868286,3,4,8081,99
8078,98,0.755486302180674,idd80ac2b4,right_ankle,2.68798494338989,3,4,8081,99
12375,96,0.19685452201271,idd80ac2b4,left_wrist,2.97348690032959,-2,-1,12373,97
12369,97,0.347822164596097,idd80ac2b4,left_hip,2.6537880897522,4,4,12373,97
12370,98,0.837936557043943,idd80ac2b4,left_ankle,2.67027711868286,3,2,12373,97
12371,97,0.832961926352911,idd80ac2b4,right_ankle,2.68798494338989,2,2,12373,97
11691,103,0.214074839152223,idd80ac2b4,left_wrist,2.97348690032959,4,0,11695,99
11690,98,0.290833955299145,idd80ac2b4,left_hip,2.6537880897522,5,6,11695,99
11693,97,0.726270341501178,idd80ac2b4,left_ankle,2.67027711868286,2,4,11695,99
11693,101,0.726907717188681,idd80ac2b4,right_ankle,2.68798494338989,2,0,11695,99
8077,96,0.178354243360138,idd80ac2b4,left_wrist,2.97348690032959,4,7,8081,99
8075,98,0.232062991371678,idd80ac2b4,left_hip,2.6537880897522,6,7,8081,99
8078,98,0.797724654114442,idd80ac2b4,left_ankle,2.67027711868286,3,4,8081,99
8078,98,0.755486302180674,idd80ac2b4,right_ankle,2.68798494338989,3,4,8081,99
14443,98,0.223678877749408,idd80ac2b4,left_wrist,2.97348690032959,-3,-1,14440,100
14437,100,0.328560171807836,idd80ac2b4,left_hip,2.6537880897522,3,3,14440,100
14438,99,0.700672115363497,idd80ac2b4,left_ankle,2.67027711868286,2,3,14440,100
14437,100,0.743532435039373,idd80ac2b4,right_ankle,2.68798494338989,3,3,14440,100
7503,87,0.130803877899427,idd80ac2b4,left_wrist,2.97348690032959,-7,6,7496,100
7489,99,0.219933431155518,idd80ac2b4,left_hip,2.6537880897522,7,8,7496,100
7492,100,0.690852040416793,idd80ac2b4,left_ankle,2.67027711868286,4,4,7496,100
7492,100,0.670992838339853,idd80ac2b4,right_ankle,2.68798494338989,4,4,7496,100
4182,92,0.187680872393317,idd80ac2b4,left_wrist,2.97348690032959,1,9,4183,100
4177,100,0.273875323226745,idd80ac2b4,left_hip,2.6537880897522,6,6,4183,100
4179,101,0.713128651926682,idd80ac2b4,left_ankle,2.67027711868286,4,3,4183,100
4178,101,0.670746674095467,idd80ac2b4,right_ankle,2.68798494338989,5,4,4183,100
1246,103,0.175041856956062,idd80ac2b4,left_wrist,2.97348690032959,9,4,1255,98
1247,100,0.302294705908194,idd80ac2b4,left_hip,2.6537880897522,8,6,1255,98
1251,99,0.725629156372576,idd80ac2b4,left_ankle,2.67027711868286,4,3,1255,98
1250,101,0.697175476747348,idd80ac2b4,right_ankle,2.68798494338989,5,2,1255,98
1739,99,0.173490870002316,idd80ac2b4,left_wrist,2.97348690032959,5,5,1744,99
1738,99,0.272290323353108,idd80ac2b4,left_hip,2.6537880897522,6,6,1744,99
1740,99,0.718340833013052,idd80ac2b4,left_ankle,2.67027711868286,4,4,1744,99
1741,99,0.699099683332687,idd80ac2b4,right_ankle,2.68798494338989,3,3,1744,99
5561,92,0.171294614209077,idd80ac2b4,left_wrist,2.97348690032959,-2,4,5559,98
5554,98,0.296842219555918,idd80ac2b4,left_hip,2.6537880897522,5,5,5559,98
5556,97,0.739234998519657,idd80ac2b4,left_ankle,2.67027711868286,3,4,5559,98
5557,97,0.753460208444379,idd80ac2b4,right_ankle,2.68798494338989,2,3,5559,98
8673,95,0.136439551052733,idd80ac2b4,left_wrist,2.97348690032959,-4,3,8669,102
8666,100,0.32818573294153,idd80ac2b4,left_hip,2.6537880897522,3,5,8669,102
8668,100,0.790086536163967,idd80ac2b4,left_ankle,2.67027711868286,1,3,8669,102
8667,100,0.711641849425043,idd80ac2b4,right_ankle,2.68798494338989,2,4,8669,102
11107,101,0.218934482642503,idd80ac2b4,left_wrist,2.97348690032959,6,3,11113,98
11108,98,0.294260727451223,idd80ac2b4,left_hip,2.6537880897522,5,5,11113,98
11110,98,0.733467061088957,idd80ac2b4,left_ankle,2.67027711868286,3,3,11113,98
11110,98,0.739459591223903,idd80ac2b4,right_ankle,2.68798494338989,3,3,11113,98
6811,98,0.206885152797264,idd80ac2b4,left_wrist,2.97348690032959,6,6,6817,98
6811,98,0.294285843876838,idd80ac2b4,left_hip,2.6537880897522,6,6,6817,98
6813,98,0.807057455760958,idd80ac2b4,left_ankle,2.67027711868286,4,4,6817,98
6813,98,0.743051981586975,idd80ac2b4,right_ankle,2.68798494338989,4,4,6817,98
16136,102,0.348052956212101,id82b9735c,left_wrist,2.74998998641968,1,2,16137,103
16138,102,0.480398407333211,id82b9735c,left_hip,3.48938179016113,-1,0,16137,103
16137,102,0.853469610537477,id82b9735c,left_ankle,2.92749691009521,0,1,16137,103
16135,102,0.847956607589778,id82b9735c,right_ankle,2.91821908950806,2,3,16137,103
5150,111,0.305297839815588,id82b9735c,left_wrist,2.74998998641968,4,1,5154,108
5152,109,0.361861818973761,id82b9735c,left_hip,3.48938179016113,2,1,5154,108
5150,108,0.729512699766871,id82b9735c,left_ankle,2.92749691009521,4,4,5154,108
5152,108,0.758576674521517,id82b9735c,right_ankle,2.91821908950806,2,2,5154,108
8042,105,0.312724960793985,id82b9735c,left_wrist,2.74998998641968,0,1,8042,106
8040,106,0.384638572233983,id82b9735c,left_hip,3.48938179016113,2,2,8042,106
8041,104,0.720135846914094,id82b9735c,left_ankle,2.92749691009521,1,3,8042,106
8038,107,0.801504750681983,id82b9735c,right_ankle,2.91821908950806,4,3,8042,106
5831,106,0.275641335052227,id82b9735c,left_wrist,2.74998998641968,0,2,5831,108
5830,108,0.372590024384335,id82b9735c,left_hip,3.48938179016113,1,1,5831,108
5831,108,0.77316925526877,id82b9735c,left_ankle,2.92749691009521,0,0,5831,108
5829,108,0.808323374064491,id82b9735c,right_ankle,2.91821908950806,2,2,5831,108
11481,105,0.289910083940434,id82b9735c,left_wrist,2.74998998641968,1,2,11482,106
11480,106,0.401472028339286,id82b9735c,left_hip,3.48938179016113,2,2,11482,106
11481,106,0.747472456146898,id82b9735c,left_ankle,2.92749691009521,1,1,11482,106
11479,104,0.713756789150939,id82b9735c,right_ankle,2.91821908950806,3,5,11482,106
4622,109,0.286708115503725,id82b9735c,left_wrist,2.74998998641968,4,4,4626,109
4624,108,0.367141465241206,id82b9735c,left_hip,3.48938179016113,2,3,4626,109
4625,108,0.740496251483696,id82b9735c,left_ankle,2.92749691009521,1,2,4626,109
4624,107,0.796267608779143,id82b9735c,right_ankle,2.91821908950806,2,4,4626,109
8471,98,0.229212005903039,id82b9735c,left_wrist,2.74998998641968,-2,7,8469,107
8469,106,0.406167359097978,id82b9735c,left_hip,3.48938179016113,0,1,8469,107
8468,108,0.838615285068582,id82b9735c,left_ankle,2.92749691009521,1,0,8469,107
8468,103,0.815601283286679,id82b9735c,right_ankle,2.91821908950806,1,5,8469,107
13429,102,0.315175253981605,id82b9735c,left_wrist,2.74998998641968,1,-2,13430,99
13429,102,0.472784459336686,id82b9735c,left_hip,3.48938179016113,1,-2,13430,99
13429,101,0.795531624882444,id82b9735c,left_ankle,2.92749691009521,1,-1,13430,99
13426,102,0.828602854508938,id82b9735c,right_ankle,2.91821908950806,4,1,13430,99
1521,111,0.355839546241293,id82b9735c,left_wrist,2.74998998641968,2,-2,1523,107
1520,108,0.401587034785346,id82b9735c,left_hip,3.48938179016113,3,2,1523,107
1522,104,0.748748800153841,id82b9735c,left_ankle,2.92749691009521,1,4,1523,107
1519,109,0.721244365029404,id82b9735c,right_ankle,2.91821908950806,4,2,1523,107
15330,101,0.443673090730911,id82b9735c,left_wrist,2.74998998641968,2,1,15332,100
15331,100,0.476755987709661,id82b9735c,left_hip,3.48938179016113,1,1,15332,100
15331,100,0.869365887756667,id82b9735c,left_ankle,2.92749691009521,1,1,15332,100
15328,102,0.828103509343149,id82b9735c,right_ankle,2.91821908950806,4,2,15332,100
5936,105,0.293190640625881,id82b9735c,left_wrist,2.74998998641968,2,4,5938,107
5937,107,0.378971862303738,id82b9735c,left_hip,3.48938179016113,1,1,5938,107
5938,107,0.799860238855661,id82b9735c,left_ankle,2.92749691009521,0,0,5938,107
5936,107,0.759485834701856,id82b9735c,right_ankle,2.91821908950806,2,2,5938,107
14727,103,0.40252929746933,id82b9735c,left_wrist,2.74998998641968,2,0,14729,101
14729,100,0.472065747129548,id82b9735c,left_hip,3.48938179016113,0,1,14729,101
14728,103,0.83213348255663,id82b9735c,left_ankle,2.92749691009521,1,-1,14729,101
14726,103,0.826540614891334,id82b9735c,right_ankle,2.91821908950806,3,1,14729,101
6147,108,0.278975330413824,id82b9735c,left_wrist,2.74998998641968,2,1,6149,107
6148,106,0.383995587501878,id82b9735c,left_hip,3.48938179016113,1,2,6149,107
6149,107,0.761434426246061,id82b9735c,left_ankle,2.92749691009521,0,0,6149,107
6147,106,0.822112558445504,id82b9735c,right_ankle,2.91821908950806,2,3,6149,107
5936,105,0.293190640625881,id82b9735c,left_wrist,2.74998998641968,2,4,5938,107
5937,107,0.378971862303738,id82b9735c,left_hip,3.48938179016113,1,1,5938,107
5938,107,0.799860238855661,id82b9735c,left_ankle,2.92749691009521,0,0,5938,107
5936,107,0.759485834701856,id82b9735c,right_ankle,2.91821908950806,2,2,5938,107
8361,111,0.332869484718898,id82b9735c,left_wrist,2.74998998641968,2,-1,8363,108
8361,109,0.388763988603017,id82b9735c,left_hip,3.48938179016113,2,1,8363,108
8362,107,0.690991323464384,id82b9735c,left_ankle,2.92749691009521,1,2,8363,108
8360,109,0.71239114251717,id82b9735c,right_ankle,2.91821908950806,3,2,8363,108
15733,103,0.400835601428492,id82b9735c,left_wrist,2.74998998641968,0,-1,15733,102
15734,101,0.471791761892886,id82b9735c,left_hip,3.48938179016113,-1,0,15733,102
15733,102,0.776482129264225,id82b9735c,left_ankle,2.92749691009521,0,0,15733,102
15728,106,0.773485922007378,id82b9735c,right_ankle,2.91821908950806,5,1,15733,102
15131,102,0.33684563435846,id82b9735c,left_wrist,2.74998998641968,0,0,15131,102
15132,101,0.494153639527091,id82b9735c,left_hip,3.48938179016113,-1,0,15131,102
15131,101,0.812428221722922,id82b9735c,left_ankle,2.92749691009521,0,1,15131,102
15129,98,0.833159239289403,id82b9735c,right_ankle,2.91821908950806,2,6,15131,102
6875,103,0.35679098039108,id82b9735c,left_wrist,2.74998998641968,2,5,6877,106
6875,106,0.367542159748101,id82b9735c,left_hip,3.48938179016113,2,2,6877,106
6877,106,0.816614018337823,id82b9735c,left_ankle,2.92749691009521,0,0,6877,106
6873,107,0.702815452079334,id82b9735c,right_ankle,2.91821908950806,4,3,6877,106
13731,101,0.292842919660228,id82b9735c,left_wrist,2.74998998641968,-1,-1,13730,101
13732,99,0.474790471486262,id82b9735c,left_hip,3.48938179016113,-2,0,13730,101
13729,102,0.813480892415954,id82b9735c,left_ankle,2.92749691009521,1,0,13730,101
13728,97,0.855166188945567,id82b9735c,right_ankle,2.91821908950806,2,6,13730,101
16836,103,0.365751844747013,id82b9735c,left_wrist,2.74998998641968,2,1,16838,102
16837,103,0.445015823073124,id82b9735c,left_hip,3.48938179016113,1,0,16838,102
16838,103,0.847311325903967,id82b9735c,left_ankle,2.92749691009521,0,-1,16838,102
16833,108,0.835534592581131,id82b9735c,right_ankle,2.91821908950806,5,-1,16838,102
8903,109,0.154633066409257,id8af5374b,left_wrist,3.27087497711182,-3,-4,8900,108
8894,105,0.188946821219393,id8af5374b,left_hip,3.50520586967468,6,9,8900,108
8899,106,0.678050132362631,id8af5374b,left_ankle,3.49136805534363,1,3,8900,108
8898,112,0.757741389519982,id8af5374b,right_ankle,3.36464500427246,2,-2,8900,108
14485,112,0.208204022082312,id8af5374b,left_wrist,3.27087497711182,-2,-5,14483,109
14475,111,0.248846091641534,id8af5374b,left_hip,3.50520586967468,8,6,14483,109
14481,110,0.69477809470675,id8af5374b,left_ankle,3.49136805534363,2,1,14483,109
14483,109,0.683708313388051,id8af5374b,right_ankle,3.36464500427246,0,0,14483,109
8127,113,0.160041633717842,id8af5374b,left_wrist,3.27087497711182,-3,-4,8124,112
8117,111,0.201485927358339,id8af5374b,left_hip,3.50520586967468,7,8,8124,112
8122,113,0.717071576033676,id8af5374b,left_ankle,3.49136805534363,2,1,8124,112
8123,112,0.788963882397428,id8af5374b,right_ankle,3.36464500427246,1,1,8124,112
6688,114,0.170256595435241,id8af5374b,left_wrist,3.27087497711182,-2,-4,6686,112
6677,114,0.272581268939121,id8af5374b,left_hip,3.50520586967468,9,7,6686,112
6684,113,0.720099201612207,id8af5374b,left_ankle,3.49136805534363,2,1,6686,112
6682,115,0.729042283105388,id8af5374b,right_ankle,3.36464500427246,4,1,6686,112
15372,111,0.227096987764706,id8af5374b,left_wrist,3.27087497711182,-5,-4,15367,112
15360,112,0.273799870030822,id8af5374b,left_hip,3.50520586967468,7,7,15367,112
15366,112,0.687828169098445,id8af5374b,left_ankle,3.49136805534363,1,1,15367,112
15365,113,0.699815838542955,id8af5374b,right_ankle,3.36464500427246,2,1,15367,112
4171,106,0.193117492268016,id8af5374b,left_wrist,3.27087497711182,-2,2,4169,110
4161,111,0.261222856371365,id8af5374b,left_hip,3.50520586967468,8,7,4169,110
4167,109,0.646962438357887,id8af5374b,left_ankle,3.49136805534363,2,3,4169,110
4168,109,0.742209228094877,id8af5374b,right_ankle,3.36464500427246,1,2,4169,110
14485,112,0.208204022082312,id8af5374b,left_wrist,3.27087497711182,-2,-5,14483,109
14475,111,0.248846091641534,id8af5374b,left_hip,3.50520586967468,8,6,14483,109
14481,110,0.69477809470675,id8af5374b,left_ankle,3.49136805534363,2,1,14483,109
14483,109,0.683708313388051,id8af5374b,right_ankle,3.36464500427246,0,0,14483,109
2525,112,0.178025834698454,id8af5374b,left_wrist,3.27087497711182,-3,-3,2522,112
2516,112,0.258073209269374,id8af5374b,left_hip,3.50520586967468,6,6,2522,112
2521,112,0.756075947201163,id8af5374b,left_ankle,3.49136805534363,1,1,2522,112
2522,109,0.768373010168868,id8af5374b,right_ankle,3.36464500427246,0,3,2522,112
5041,109,0.137967186655015,id8af5374b,left_wrist,3.27087497711182,0,-1,5041,108
5033,109,0.25068590461941,id8af5374b,left_hip,3.50520586967468,8,7,5041,108
5038,107,0.664985629035439,id8af5374b,left_ankle,3.49136805534363,3,4,5041,108
5039,110,0.767317217734579,id8af5374b,right_ankle,3.36464500427246,2,0,5041,108
2954,125,0.147538117502979,id8af5374b,left_wrist,3.27087497711182,10,-4,2964,111
2956,113,0.253403604529347,id8af5374b,left_hip,3.50520586967468,8,6,2964,111
2962,113,0.724642300428301,id8af5374b,left_ankle,3.49136805534363,2,0,2964,111
2963,111,0.805670196336694,id8af5374b,right_ankle,3.36464500427246,1,1,2964,111
4936,106,0.189672926284854,id8af5374b,left_wrist,3.27087497711182,-3,1,4933,110
4926,108,0.239573672658985,id8af5374b,left_hip,3.50520586967468,7,9,4933,110
4932,107,0.760483667660874,id8af5374b,left_ankle,3.49136805534363,1,4,4933,110
4931,109,0.789243725460814,id8af5374b,right_ankle,3.36464500427246,2,3,4933,110
1330,109,0.172496528438158,id8af5374b,left_wrist,3.27087497711182,-3,-3,1327,109
1320,109,0.25172115936382,id8af5374b,left_hip,3.50520586967468,7,7,1327,109
1325,109,0.694251726842005,id8af5374b,left_ankle,3.49136805534363,2,2,1327,109
1326,110,0.717980218212337,id8af5374b,right_ankle,3.36464500427246,1,0,1327,109
13037,114,0.199860159912743,id8af5374b,left_wrist,3.27087497711182,-6,-6,13031,114
13025,115,0.265560508974566,id8af5374b,left_hip,3.50520586967468,6,5,13031,114
13032,114,0.702667701808681,id8af5374b,left_ankle,3.49136805534363,-1,-1,13031,114
13031,114,0.786503144914653,id8af5374b,right_ankle,3.36464500427246,0,0,13031,114
17879,110,0.201191246149182,id8af5374b,left_wrist,3.27087497711182,-4,-3,17875,111
17868,111,0.280416081308344,id8af5374b,left_hip,3.50520586967468,7,7,17875,111
17874,111,0.677684593147042,id8af5374b,left_ankle,3.49136805534363,1,1,17875,111
17875,110,0.719869775727378,id8af5374b,right_ankle,3.36464500427246,0,1,17875,111
15809,110,0.222089443186592,id8af5374b,left_wrist,3.27087497711182,-4,-3,15805,111
15797,110,0.302340334629785,id8af5374b,left_hip,3.50520586967468,8,9,15805,111
15804,109,0.750589919641034,id8af5374b,left_ankle,3.49136805534363,1,3,15805,111
15804,111,0.732551519851353,id8af5374b,right_ankle,3.36464500427246,1,1,15805,111
16137,112,0.24673449553404,id8af5374b,left_wrist,3.27087497711182,-2,-5,16135,109
16127,110,0.294471476647258,id8af5374b,left_hip,3.50520586967468,8,7,16135,109
16133,110,0.685370557202206,id8af5374b,left_ankle,3.49136805534363,2,1,16135,109
16134,110,0.705548730795861,id8af5374b,right_ankle,3.36464500427246,1,0,16135,109
9233,118,0.166817794624144,id8af5374b,left_wrist,3.27087497711182,-2,-5,9231,115
9225,115,0.217277188790344,id8af5374b,left_hip,3.50520586967468,6,6,9231,115
9230,115,0.729949567048028,id8af5374b,left_ankle,3.49136805534363,1,1,9231,115
9226,118,0.78476615509844,id8af5374b,right_ankle,3.36464500427246,5,2,9231,115
8350,109,0.141264630783273,id8af5374b,left_wrist,3.27087497711182,-5,-3,8345,111
8338,111,0.21457422212158,id8af5374b,left_hip,3.50520586967468,7,7,8345,111
8344,110,0.637655610225687,id8af5374b,left_ankle,3.49136805534363,1,2,8345,111
8344,110,0.738772809285485,id8af5374b,right_ankle,3.36464500427246,1,2,8345,111
16466,111,0.267797532954161,id8af5374b,left_wrist,3.27087497711182,-3,-4,16463,110
16455,110,0.222679503160875,id8af5374b,left_hip,3.50520586967468,8,8,16463,110
16461,111,0.686401350821537,id8af5374b,left_ankle,3.49136805534363,2,1,16463,110
16462,111,0.706632869276499,id8af5374b,right_ankle,3.36464500427246,1,0,16463,110
12258,111,0.178601569267793,id8af5374b,left_wrist,3.27087497711182,-5,-6,12253,110
12246,111,0.237701168227497,id8af5374b,left_hip,3.50520586967468,7,6,12253,110
12252,111,0.764095468934976,id8af5374b,left_ankle,3.49136805534363,1,0,12253,110
12252,111,0.782624132664889,id8af5374b,right_ankle,3.36464500427246,1,0,12253,110
14704,109,0.252020953501388,id650857ca,left_wrist,4.184730052948,-51,-52,14653,108
14653,107,0.24466224654783,id650857ca,left_hip,4.1405930519104,0,1,14653,108
14652,108,0.602202291196896,id650857ca,left_ankle,3.85806608200073,1,1,14653,108
14653,110,0.61208114882041,id650857ca,right_ankle,4.08373808860779,0,-2,14653,108
7856,111,0.201537379342694,id650857ca,left_wrist,4.184730052948,54,53,7910,110
7913,107,0.261229646216582,id650857ca,left_hip,4.1405930519104,-3,0,7910,110
7910,109,0.574976860737361,id650857ca,left_ankle,3.85806608200073,0,1,7910,110
7913,107,0.583328290552764,id650857ca,right_ankle,4.08373808860779,-3,0,7910,110
6140,109,0.156664134858349,id650857ca,left_wrist,4.184730052948,-2,-2,6138,109
6139,108,0.21588353497204,id650857ca,left_hip,4.1405930519104,-1,0,6138,109
6137,108,0.531824305485239,id650857ca,left_ankle,3.85806608200073,1,2,6138,109
6139,108,0.507216463490455,id650857ca,right_ankle,4.08373808860779,-1,0,6138,109
22100,110,0.223753541243759,id650857ca,left_wrist,4.184730052948,49,53,22149,114
22156,109,0.197432441728579,id650857ca,left_hip,4.1405930519104,-7,-2,22149,114
22154,115,0.490681493541011,id650857ca,left_ankle,3.85806608200073,-5,-6,22149,114
22157,115,0.440210234216443,id650857ca,right_ankle,4.08373808860779,-8,-9,22149,114
14077,100,0.279407037640053,id650857ca,left_wrist,4.184730052948,47,56,14124,109
14125,107,0.243422540462085,id650857ca,left_hip,4.1405930519104,-1,1,14124,109
14124,109,0.551486816741991,id650857ca,left_ankle,3.85806608200073,0,0,14124,109
14125,108,0.560072175989835,id650857ca,right_ankle,4.08373808860779,-1,0,14124,109
4820,113,0.14764026763528,id650857ca,left_wrist,4.184730052948,-2,-4,4818,111
4817,113,0.210039741843979,id650857ca,left_hip,4.1405930519104,1,-1,4818,111
4815,113,0.5351099797775,id650857ca,left_ankle,3.85806608200073,3,1,4818,111
4820,110,0.507508332831594,id650857ca,right_ankle,4.08373808860779,-2,-1,4818,111
2985,110,0.189806282801942,id650857ca,left_wrist,4.184730052948,-6,-4,2979,112
2976,114,0.254429880246714,id650857ca,left_hip,4.1405930519104,3,1,2979,112
2980,108,0.536146882572004,id650857ca,left_ankle,3.85806608200073,-1,3,2979,112
2981,108,0.598822089455855,id650857ca,right_ankle,4.08373808860779,-2,2,2979,112
10671,116,0.264591421080423,id650857ca,left_wrist,4.184730052948,2,-6,10673,108
10672,111,0.266892597792699,id650857ca,left_hip,4.1405930519104,1,-2,10673,108
10672,110,0.590653116262882,id650857ca,left_ankle,3.85806608200073,1,-1,10673,108
10674,111,0.609222785911984,id650857ca,right_ankle,4.08373808860779,-1,-4,10673,108
20609,103,0.330923036908595,id650857ca,left_wrist,4.184730052948,48,51,20657,106
20660,109,0.264999003402637,id650857ca,left_hip,4.1405930519104,-3,-6,20657,106
20656,107,0.590279834443093,id650857ca,left_ankle,3.85806608200073,1,0,20657,106
20654,109,0.547792885483776,id650857ca,right_ankle,4.08373808860779,3,0,20657,106
13396,99,0.405825493817973,id650857ca,left_wrist,4.184730052948,-8,2,13388,109
13390,107,0.255221082434042,id650857ca,left_hip,4.1405930519104,-2,0,13388,109
13387,108,0.490230978218976,id650857ca,left_ankle,3.85806608200073,1,2,13388,109
13389,107,0.576138153074339,id650857ca,right_ankle,4.08373808860779,-1,1,13388,109
21777,108,0.253015961431651,id650857ca,left_wrist,4.184730052948,52,51,21829,107
21830,108,0.244761963866201,id650857ca,left_hip,4.1405930519104,-1,-2,21829,107
21828,108,0.547971817368418,id650857ca,left_ankle,3.85806608200073,1,0,21829,107
21828,111,0.562325485930917,id650857ca,right_ankle,4.08373808860779,1,-3,21829,107
16333,109,0.165472341758199,id650857ca,left_wrist,4.184730052948,49,48,16382,108
16384,109,0.237010176754929,id650857ca,left_hip,4.1405930519104,-2,-3,16382,108
16382,108,0.534549175498391,id650857ca,left_ankle,3.85806608200073,0,0,16382,108
16383,107,0.545590004380998,id650857ca,right_ankle,4.08373808860779,-1,0,16382,108
7966,107,0.303112320803785,id650857ca,left_wrist,4.184730052948,53,51,8019,105
8072,103,0.299195613811057,id650857ca,left_wrist,4.184730052948,-53,-51,8019,105
8019,105,0.292890514670372,id650857ca,left_hip,4.1405930519104,0,0,8019,105
8018,105,0.622881402786202,id650857ca,left_ankle,3.85806608200073,1,1,8019,105
8019,102,0.652645272784344,id650857ca,right_ankle,4.08373808860779,0,3,8019,105
9723,124,0.229881972481112,id650857ca,left_wrist,4.184730052948,-52,-65,9671,111
9671,108,0.209215564732224,id650857ca,left_hip,4.1405930519104,0,3,9671,111
9671,108,0.509752396599937,id650857ca,left_ankle,3.85806608200073,0,3,9671,111
9671,117,0.489809092928131,id650857ca,right_ankle,4.08373808860779,0,-6,9671,111
3526,112,0.211639888939915,id650857ca,left_wrist,4.184730052948,-6,-7,3520,111
3519,109,0.220318438103236,id650857ca,left_hip,4.1405930519104,1,3,3520,111
3519,112,0.492922106350007,id650857ca,left_ankle,3.85806608200073,1,0,3520,111
3522,111,0.529494236274256,id650857ca,right_ankle,4.08373808860779,-2,-2,3520,111
259,104,0.285251647335512,id650857ca,left_wrist,4.184730052948,47,47,306,104
307,101,0.29551103611588,id650857ca,left_hip,4.1405930519104,-1,2,306,104
306,102,0.63549129781372,id650857ca,left_ankle,3.85806608200073,0,2,306,104
302,105,0.606225651727159,id650857ca,right_ankle,4.08373808860779,4,3,306,104
15918,103,0.215901933033602,id650857ca,left_wrist,4.184730052948,48,49,15966,104
15968,103,0.281651346584698,id650857ca,left_hip,4.1405930519104,-2,-1,15966,104
15965,104,0.609498051599547,id650857ca,left_ankle,3.85806608200073,1,1,15966,104
15963,103,0.563802179636791,id650857ca,right_ankle,4.08373808860779,3,4,15966,104
2341,107,0.226299481459503,id650857ca,left_wrist,4.184730052948,-6,-5,2335,108
2336,107,0.241622980752158,id650857ca,left_hip,4.1405930519104,-1,0,2335,108
2335,105,0.507697002561078,id650857ca,left_ankle,3.85806608200073,0,3,2335,108
2335,107,0.586729728159933,id650857ca,right_ankle,4.08373808860779,0,1,2335,108
10016,54,0.138916326774427,id650857ca,left_wrist,4.184730052948,1,57,10017,110
10017,111,0.273235693536047,id650857ca,left_hip,4.1405930519104,0,-1,10017,110
10017,110,0.571444918773059,id650857ca,left_ankle,3.85806608200073,0,0,10017,110
10018,111,0.597246398091234,id650857ca,right_ankle,4.08373808860779,-1,-2,10017,110
14345,106,0.29403873105961,id650857ca,left_wrist,4.184730052948,-6,-6,14339,106
14339,107,0.282489634895049,id650857ca,left_hip,4.1405930519104,0,-1,14339,106
14339,106,0.625422549543393,id650857ca,left_ankle,3.85806608200073,0,0,14339,106
14338,104,0.646410563584042,id650857ca,right_ankle,4.08373808860779,1,3,14339,106
20217,93,0.246931766449211,idff99de96,left_wrist,3.73769688606262,4,11,20221,100
20221,100,0.345139724863415,idff99de96,left_hip,3.48931097984314,0,0,20221,100
20218,99,0.697130211033817,idff99de96,left_ankle,3.66665506362915,3,4,20221,100
20218,102,0.801879835967076,idff99de96,right_ankle,3.76388502120972,3,1,20221,100
10143,137,0.389715426789755,idff99de96,left_wrist,3.73769688606262,-8,-46,10135,99
10142,93,0.388319095256601,idff99de96,left_hip,3.48931097984314,-7,-1,10135,99
10132,99,0.800469870519128,idff99de96,left_ankle,3.66665506362915,3,3,10135,99
10130,100,0.865711528677411,idff99de96,right_ankle,3.76388502120972,5,4,10135,99
9942,100,0.392856333853509,idff99de96,left_wrist,3.73769688606262,-12,-8,9930,104
9927,104,0.283605501362169,idff99de96,left_hip,3.48931097984314,3,3,9930,104
9927,103,0.72415305221884,idff99de96,left_ankle,3.66665506362915,3,4,9930,104
9928,103,0.78442916086585,idff99de96,right_ankle,3.76388502120972,2,3,9930,104
3586,109,0.291688636301627,idff99de96,left_wrist,3.73769688606262,6,7,3592,110
3592,113,0.40369712953317,idff99de96,left_hip,3.48931097984314,0,-3,3592,110
3591,109,0.633522839407932,idff99de96,left_ankle,3.66665506362915,1,2,3592,110
3593,109,0.781878025291873,idff99de96,right_ankle,3.76388502120972,-1,0,3592,110
15480,105,0.243444461248805,idff99de96,left_wrist,3.73769688606262,-50,-53,15430,102
15430,103,0.278489356831381,idff99de96,left_hip,3.48931097984314,0,-1,15430,102
15428,104,0.61013318591607,idff99de96,left_ankle,3.66665506362915,2,0,15430,102
15428,102,0.693301084311837,idff99de96,right_ankle,3.76388502120972,2,2,15430,102
9308,99,0.195072258828009,idff99de96,left_wrist,3.73769688606262,5,4,9313,98
9307,102,0.32160821727662,idff99de96,left_hip,3.48931097984314,6,2,9313,98
9309,101,0.733944874293109,idff99de96,left_ankle,3.66665506362915,4,1,9313,98
9308,104,0.741220793991113,idff99de96,right_ankle,3.76388502120972,5,-1,9313,98
10448,99,0.309510398583145,idff99de96,left_wrist,3.73769688606262,-15,-10,10433,104
10432,106,0.350575716261129,idff99de96,left_hip,3.48931097984314,1,-1,10433,104
10432,102,0.732798392855232,idff99de96,left_ankle,3.66665506362915,1,3,10433,104
10433,103,0.859550813061706,idff99de96,right_ankle,3.76388502120972,0,1,10433,104
4371,118,0.429793168684558,idff99de96,left_wrist,3.73769688606262,-47,-60,4324,105
4322,110,0.35882142650878,idff99de96,left_hip,3.48931097984314,2,-3,4324,105
4322,104,0.778393553720811,idff99de96,left_ankle,3.66665506362915,2,3,4324,105
4324,101,0.795738621289555,idff99de96,right_ankle,3.76388502120972,0,4,4324,105
4735,54,0.0796273883217671,idff99de96,left_wrist,3.73769688606262,1,46,4736,99
4734,101,0.369388891442081,idff99de96,left_hip,3.48931097984314,2,0,4736,99
4733,101,0.693227113930134,idff99de96,left_ankle,3.66665506362915,3,1,4736,99
4732,102,0.893255600559146,idff99de96,right_ankle,3.76388502120972,4,1,4736,99
12157,100,0.283120318936247,idff99de96,left_wrist,3.73769688606262,-10,-8,12147,102
12145,103,0.351969411265144,idff99de96,left_hip,3.48931097984314,2,1,12147,102
12145,101,0.792366344540863,idff99de96,left_ankle,3.66665506362915,2,3,12147,102
12144,103,0.866688618592815,idff99de96,right_ankle,3.76388502120972,3,2,12147,102
11756,103,0.358219620625557,idff99de96,left_wrist,3.73769688606262,-13,-14,11743,102
11743,102,0.334941470866286,idff99de96,left_hip,3.48931097984314,0,0,11743,102
11742,102,0.62742989869209,idff99de96,left_ankle,3.66665506362915,1,1,11743,102
11743,100,0.883898440603727,idff99de96,right_ankle,3.76388502120972,0,2,11743,102
1743,101,0.215531788071654,idff99de96,left_wrist,3.73769688606262,-40,-41,1703,100
1700,102,0.377312436611007,idff99de96,left_hip,3.48931097984314,3,1,1703,100
1698,101,0.742304669526262,idff99de96,left_ankle,3.66665506362915,5,4,1703,100
1698,101,0.799603557903191,idff99de96,right_ankle,3.76388502120972,5,4,1703,100
874,108,0.270683367373266,idff99de96,left_wrist,3.73769688606262,2,6,876,112
875,113,0.316730562799997,idff99de96,left_hip,3.48931097984314,1,0,876,112
870,116,0.708091018152739,idff99de96,left_ankle,3.66665506362915,6,2,876,112
880,107,0.753252713703521,idff99de96,right_ankle,3.76388502120972,-4,1,876,112
13141,105,0.325042972099405,idff99de96,left_wrist,3.73769688606262,3,1,13144,103
13142,103,0.377617648407396,idff99de96,left_hip,3.48931097984314,2,2,13144,103
13142,103,0.749560818168097,idff99de96,left_ankle,3.66665506362915,2,2,13144,103
13143,101,0.840880582524205,idff99de96,right_ankle,3.76388502120972,1,3,13144,103
18931,50,0.17743418224901,idff99de96,left_wrist,3.73769688606262,2,48,18933,96
18937,97,0.317375012162625,idff99de96,left_hip,3.48931097984314,-4,-5,18933,96
18930,99,0.718571553514222,idff99de96,left_ankle,3.66665506362915,3,0,18933,96
18931,97,0.742091839004476,idff99de96,right_ankle,3.76388502120972,2,1,18933,96
12256,102,0.297359427179017,idff99de96,left_wrist,3.73769688606262,-8,-6,12248,104
12247,101,0.339046895480477,idff99de96,left_hip,3.48931097984314,1,4,12248,104
12245,103,0.754625499524748,idff99de96,left_ankle,3.66665506362915,3,4,12248,104
12246,102,0.83012899001581,idff99de96,right_ankle,3.76388502120972,2,4,12248,104
11456,95,0.326825020567345,idff99de96,left_wrist,3.73769688606262,-11,-5,11445,101
11445,99,0.386527652113458,idff99de96,left_hip,3.48931097984314,0,2,11445,101
11444,99,0.685459678138365,idff99de96,left_ankle,3.66665506362915,1,3,11445,101
11442,99,0.915446735113433,idff99de96,right_ankle,3.76388502120972,3,5,11445,101
10758,97,0.41844102098352,idff99de96,left_wrist,3.73769688606262,-19,-8,10739,108
10740,105,0.339364601936768,idff99de96,left_hip,3.48931097984314,-1,2,10739,108
10740,104,0.778113781693226,idff99de96,left_ankle,3.66665506362915,-1,3,10739,108
10743,101,0.833717140029145,idff99de96,right_ankle,3.76388502120972,-4,3,10739,108
20018,103,0.335242551654958,idff99de96,left_wrist,3.73769688606262,2,1,20020,102
20021,101,0.357290475089569,idff99de96,left_hip,3.48931097984314,-1,0,20020,102
20018,102,0.746210134938733,idff99de96,left_ankle,3.66665506362915,2,2,20020,102
20017,103,0.934399833940771,idff99de96,right_ankle,3.76388502120972,3,2,20020,102
10322,86,0.263108513181542,idff99de96,left_wrist,3.73769688606262,10,26,10332,102
10328,105,0.381250962181059,idff99de96,left_hip,3.48931097984314,4,1,10332,102
10327,106,0.71211224578498,idff99de96,left_ankle,3.66665506362915,5,1,10332,102
10329,105,0.891901151849036,idff99de96,right_ankle,3.76388502120972,3,0,10332,102
12547,93,0.169441532897234,id4ea159a8,left_wrist,3.8009090423584,-1,0,12546,94
12545,96,0.352083120770073,id4ea159a8,left_hip,3.49331998825073,1,-1,12546,94
12544,96,0.84615693685176,id4ea159a8,left_ankle,3.79715490341187,2,0,12546,94
12544,96,0.772369594186552,id4ea159a8,right_ankle,3.85589814186096,2,0,12546,94
11019,96,0.213933367348043,id4ea159a8,left_wrist,3.8009090423584,-4,-1,11015,99
11016,98,0.345277762480354,id4ea159a8,left_hip,3.49331998825073,-1,0,11015,99
11015,98,0.795606373042869,id4ea159a8,left_ankle,3.79715490341187,0,1,11015,99
11014,97,0.741012596182429,id4ea159a8,right_ankle,3.85589814186096,1,3,11015,99
4380,92,0.19865448432321,id4ea159a8,left_wrist,3.8009090423584,0,4,4380,96
4381,95,0.446426371580994,id4ea159a8,left_hip,3.49331998825073,-1,0,4380,96
4379,96,0.928332231372693,id4ea159a8,left_ankle,3.79715490341187,1,1,4380,96
4377,96,0.791737615907379,id4ea159a8,right_ankle,3.85589814186096,3,3,4380,96
4758,97,0.174377630934997,id4ea159a8,left_wrist,3.8009090423584,0,0,4758,97
4759,97,0.432508155861686,id4ea159a8,left_hip,3.49331998825073,-1,-1,4758,97
4756,98,0.87597711582776,id4ea159a8,left_ankle,3.79715490341187,2,1,4758,97
4756,96,0.766484347026545,id4ea159a8,right_ankle,3.85589814186096,2,3,4758,97
13398,91,0.210714842117464,id4ea159a8,left_wrist,3.8009090423584,-4,0,13394,95
13396,94,0.364178075458681,id4ea159a8,left_hip,3.49331998825073,-2,-1,13394,95
13393,97,0.804053857122272,id4ea159a8,left_ankle,3.79715490341187,1,-1,13394,95
13393,95,0.735465477945888,id4ea159a8,right_ankle,3.85589814186096,1,1,13394,95
8356,95,0.275925097072792,id4ea159a8,left_wrist,3.8009090423584,1,1,8357,95
8357,95,0.386778368409376,id4ea159a8,left_hip,3.49331998825073,0,0,8357,95
8356,96,0.792573417500675,id4ea159a8,left_ankle,3.79715490341187,1,0,8357,95
8353,96,0.653077463155734,id4ea159a8,right_ankle,3.85589814186096,4,3,8357,95
3242,97,0.186833761394188,id4ea159a8,left_wrist,3.8009090423584,2,-3,3244,92
3243,95,0.386730014482969,id4ea159a8,left_hip,3.49331998825073,1,-2,3244,92
3243,93,0.875828436956364,id4ea159a8,left_ankle,3.79715490341187,1,0,3244,92
3242,94,0.827838058401718,id4ea159a8,right_ankle,3.85589814186096,2,0,3244,92
13684,175,0.202499538963924,id4ea159a8,left_wrist,3.8009090423584,-7,-88,13677,94
13679,93,0.382419503488941,id4ea159a8,left_hip,3.49331998825073,-2,-1,13677,94
13676,94,0.802040399505033,id4ea159a8,left_ankle,3.79715490341187,1,1,13677,94
13676,95,0.795143248637558,id4ea159a8,right_ankle,3.85589814186096,1,0,13677,94
2002,104,0.233965812747766,id4ea159a8,left_wrist,3.8009090423584,7,-2,2009,95
2007,97,0.399528260972607,id4ea159a8,left_hip,3.49331998825073,2,0,2009,95
2007,95,0.821970318424243,id4ea159a8,left_ankle,3.79715490341187,2,2,2009,95
2007,95,0.790433229805429,id4ea159a8,right_ankle,3.85589814186096,2,2,2009,95
15873,95,0.12285687239607,id4ea159a8,left_wrist,3.8009090423584,-3,-2,15870,96
15871,96,0.409217399882442,id4ea159a8,left_hip,3.49331998825073,-1,-1,15870,96
15869,96,0.849775456723073,id4ea159a8,left_ankle,3.79715490341187,1,1,15870,96
15869,97,0.799666568357482,id4ea159a8,right_ankle,3.85589814186096,1,0,15870,96
11304,98,0.20452342178242,id4ea159a8,left_wrist,3.8009090423584,2,-1,11306,95
11303,97,0.340252637048883,id4ea159a8,left_hip,3.49331998825073,3,1,11306,95
11304,96,0.811043931465658,id4ea159a8,left_ankle,3.79715490341187,2,1,11306,95
11303,96,0.733583445527687,id4ea159a8,right_ankle,3.85589814186096,3,2,11306,95
10349,97,0.178066626451063,id4ea159a8,left_wrist,3.8009090423584,-3,-3,10346,97
10346,97,0.356800300555761,id4ea159a8,left_hip,3.49331998825073,0,0,10346,97
10345,97,0.793766165350853,id4ea159a8,left_ankle,3.79715490341187,1,1,10346,97
10345,96,0.803546712227038,id4ea159a8,right_ankle,3.85589814186096,1,2,10346,97
6091,95,0.211620403909465,id4ea159a8,left_wrist,3.8009090423584,2,1,6093,94
6093,94,0.388807385425149,id4ea159a8,left_hip,3.49331998825073,0,0,6093,94
6091,95,0.891053275146715,id4ea159a8,left_ankle,3.79715490341187,2,1,6093,94
6091,95,0.828378801559152,id4ea159a8,right_ankle,3.85589814186096,2,1,6093,94
8450,97,0.232585592463092,id4ea159a8,left_wrist,3.8009090423584,1,0,8451,96
8451,96,0.348915835740926,id4ea159a8,left_hip,3.49331998825073,0,0,8451,96
8451,95,0.750022276773398,id4ea159a8,left_ankle,3.79715490341187,0,1,8451,96
8448,97,0.729001178745138,id4ea159a8,right_ankle,3.85589814186096,3,2,8451,96
9213,96,0.173121925124549,id4ea159a8,left_wrist,3.8009090423584,-1,1,9212,98
9215,95,0.333159827994226,id4ea159a8,left_hip,3.49331998825073,-3,0,9212,98
9212,97,0.771892282126911,id4ea159a8,left_ankle,3.79715490341187,0,1,9212,98
9211,97,0.757166166324209,id4ea159a8,right_ankle,3.85589814186096,1,2,9212,98
3338,92,0.219811802843262,id4ea159a8,left_wrist,3.8009090423584,-3,1,3335,96
3337,93,0.398802697349587,id4ea159a8,left_hip,3.49331998825073,-2,1,3335,96
3335,95,0.832857909718692,id4ea159a8,left_ankle,3.79715490341187,0,1,3335,96
3335,94,0.796459770125349,id4ea159a8,right_ankle,3.85589814186096,0,2,3335,96
9688,100,0.198992496749868,id4ea159a8,left_wrist,3.8009090423584,-1,-5,9687,96
9688,96,0.391957348086748,id4ea159a8,left_hip,3.49331998825073,-1,-1,9687,96
9687,95,0.809568621739116,id4ea159a8,left_ankle,3.79715490341187,0,1,9687,96
9687,94,0.779893434110232,id4ea159a8,right_ankle,3.85589814186096,0,2,9687,96
1443,97,0.181963697241256,id4ea159a8,left_wrist,3.8009090423584,0,-1,1443,96
1443,96,0.403219156170442,id4ea159a8,left_hip,3.49331998825073,0,0,1443,96
1442,96,0.841278074360623,id4ea159a8,left_ankle,3.79715490341187,1,1,1443,96
1442,95,0.822553101493717,id4ea159a8,right_ankle,3.85589814186096,1,2,1443,96
5234,94,0.190795696189532,id4ea159a8,left_wrist,3.8009090423584,-1,0,5233,95
5233,95,0.406477294553924,id4ea159a8,left_hip,3.49331998825073,0,0,5233,95
5232,95,0.830461489588505,id4ea159a8,left_ankle,3.79715490341187,1,1,5233,95
5230,96,0.884806801648342,id4ea159a8,right_ankle,3.85589814186096,3,2,5233,95
4001,95,0.186196486407233,id4ea159a8,left_wrist,3.8009090423584,-2,-1,3999,96
4000,95,0.37620883107908,id4ea159a8,left_hip,3.49331998825073,-1,0,3999,96
3997,97,0.803106450306954,id4ea159a8,left_ankle,3.79715490341187,2,1,3999,96
3997,96,0.842771453405908,id4ea159a8,right_ankle,3.85589814186096,2,2,3999,96
6022,116,0.261915076529114,idc91a49d0,left_wrist,3.59860587120056,1,0,6023,115
6024,113,0.276376018110514,idc91a49d0,left_hip,3.43942308425903,-1,1,6023,115
6022,114,0.572822348655715,idc91a49d0,left_ankle,3.33509182929993,1,2,6023,115
6018,115,0.591457172219306,idc91a49d0,right_ankle,3.31751894950867,5,5,6023,115
18683,110,0.2120322775245,idc91a49d0,left_wrist,3.59860587120056,-3,-4,18680,109
18680,110,0.312896543972942,idc91a49d0,left_hip,3.43942308425903,0,-1,18680,109
18681,109,0.64370734324015,idc91a49d0,left_ankle,3.33509182929993,-1,-1,18680,109
18681,108,0.728844558149339,idc91a49d0,right_ankle,3.31751894950867,-1,0,18680,109
9342,115,0.201599709653244,idc91a49d0,left_wrist,3.59860587120056,2,5,9344,118
9345,117,0.240944583811919,idc91a49d0,left_hip,3.43942308425903,-1,0,9344,118
9342,117,0.539502931628274,idc91a49d0,left_ankle,3.33509182929993,2,3,9344,118
9342,114,0.61511482271187,idc91a49d0,right_ankle,3.31751894950867,2,6,9344,118
16279,108,0.231671910624025,idc91a49d0,left_wrist,3.59860587120056,-5,-2,16274,111
16274,111,0.303824771419856,idc91a49d0,left_hip,3.43942308425903,0,0,16274,111
16273,112,0.731768664800379,idc91a49d0,left_ankle,3.33509182929993,1,0,16274,111
16275,108,0.739244990499886,idc91a49d0,right_ankle,3.31751894950867,-1,2,16274,111
18465,110,0.239120208901491,idc91a49d0,left_wrist,3.59860587120056,-4,-3,18461,111
18462,110,0.299793676343478,idc91a49d0,left_hip,3.43942308425903,-1,0,18461,111
18462,110,0.6878016506453,idc91a49d0,left_ankle,3.33509182929993,-1,0,18461,111
18462,109,0.687289955374181,idc91a49d0,right_ankle,3.31751894950867,-1,1,18461,111
8681,110,0.269390024742953,idc91a49d0,left_wrist,3.59860587120056,-2,-1,8679,111
8679,111,0.275833829854654,idc91a49d0,left_hip,3.43942308425903,0,0,8679,111
8677,112,0.681291977768199,idc91a49d0,left_ankle,3.33509182929993,2,1,8679,111
8677,111,0.654743661761357,idc91a49d0,right_ankle,3.31751894950867,2,2,8679,111
1379,109,0.209191785645125,idc91a49d0,left_wrist,3.59860587120056,0,5,1379,114
1379,113,0.275587100061645,idc91a49d0,left_hip,3.43942308425903,0,1,1379,114
1377,113,0.634401718432736,idc91a49d0,left_ankle,3.33509182929993,2,3,1379,114
1377,112,0.689422150240152,idc91a49d0,right_ankle,3.31751894950867,2,4,1379,114
7037,112,0.177144519558478,idc91a49d0,left_wrist,3.59860587120056,-1,-2,7036,111
7036,111,0.285056429412391,idc91a49d0,left_hip,3.43942308425903,0,0,7036,111
7034,112,0.655554709759737,idc91a49d0,left_ankle,3.33509182929993,2,1,7036,111
7035,111,0.673382266993179,idc91a49d0,right_ankle,3.31751894950867,1,1,7036,111
15088,110,0.229252390457588,idc91a49d0,left_wrist,3.59860587120056,-4,-3,15084,111
15086,109,0.305868794510414,idc91a49d0,left_hip,3.43942308425903,-2,0,15084,111
15085,110,0.654836017881875,idc91a49d0,left_ankle,3.33509182929993,-1,0,15084,111
15084,110,0.665642125760637,idc91a49d0,right_ankle,3.31751894950867,0,1,15084,111
7037,112,0.177144519558478,idc91a49d0,left_wrist,3.59860587120056,-1,-2,7036,111
7036,111,0.285056429412391,idc91a49d0,left_hip,3.43942308425903,0,0,7036,111
7034,112,0.655554709759737,idc91a49d0,left_ankle,3.33509182929993,2,1,7036,111
7035,111,0.673382266993179,idc91a49d0,right_ankle,3.31751894950867,1,1,7036,111
13218,111,0.254794894127004,idc91a49d0,left_wrist,3.59860587120056,-3,-3,13215,111
13216,110,0.291929025676477,idc91a49d0,left_hip,3.43942308425903,-1,0,13215,111
13215,109,0.652320815531007,idc91a49d0,left_ankle,3.33509182929993,0,2,13215,111
13214,111,0.662045694570551,idc91a49d0,right_ankle,3.31751894950867,1,1,13215,111
17592,111,0.221237549619464,idc91a49d0,left_wrist,3.59860587120056,-2,-5,17590,108
17590,109,0.305522721265941,idc91a49d0,left_hip,3.43942308425903,0,-1,17590,108
17590,110,0.628886051843372,idc91a49d0,left_ankle,3.33509182929993,0,-2,17590,108
17590,110,0.720951486390553,idc91a49d0,right_ankle,3.31751894950867,0,-2,17590,108
17919,111,0.242899880318646,idc91a49d0,left_wrist,3.59860587120056,-2,-3,17917,110
17917,110,0.321854612742804,idc91a49d0,left_hip,3.43942308425903,0,0,17917,110
17916,110,0.729996008065519,idc91a49d0,left_ankle,3.33509182929993,1,1,17917,110
17916,112,0.734555650219061,idc91a49d0,right_ankle,3.31751894950867,1,-1,17917,110
8241,111,0.255458088863014,idc91a49d0,left_wrist,3.59860587120056,-1,-2,8240,110
8240,110,0.301828906789684,idc91a49d0,left_hip,3.43942308425903,0,0,8240,110
8239,110,0.683244176370957,idc91a49d0,left_ankle,3.33509182929993,1,1,8240,110
8238,111,0.749545754365013,idc91a49d0,right_ankle,3.31751894950867,2,1,8240,110
8022,111,0.223993052731571,idc91a49d0,left_wrist,3.59860587120056,-2,-2,8020,111
8020,111,0.286498513962212,idc91a49d0,left_hip,3.43942308425903,0,0,8020,111
8017,113,0.659000256562859,idc91a49d0,left_ankle,3.33509182929993,3,1,8020,111
8018,111,0.649388739737366,idc91a49d0,right_ankle,3.31751894950867,2,2,8020,111
18683,110,0.2120322775245,idc91a49d0,left_wrist,3.59860587120056,-3,-4,18680,109
18680,110,0.312896543972942,idc91a49d0,left_hip,3.43942308425903,0,-1,18680,109
18681,109,0.64370734324015,idc91a49d0,left_ankle,3.33509182929993,-1,-1,18680,109
18681,108,0.728844558149339,idc91a49d0,right_ankle,3.31751894950867,-1,0,18680,109
13437,112,0.243072712007943,idc91a49d0,left_wrist,3.59860587120056,-1,-3,13436,110
13436,111,0.291357183516813,idc91a49d0,left_hip,3.43942308425903,0,-1,13436,110
13436,110,0.650389517704754,idc91a49d0,left_ankle,3.33509182929993,0,0,13436,110
13434,111,0.716028532612762,idc91a49d0,right_ankle,3.31751894950867,2,1,13436,110
15524,107,0.229016587215713,idc91a49d0,left_wrist,3.59860587120056,-5,-4,15519,108
15519,109,0.318654202581522,idc91a49d0,left_hip,3.43942308425903,0,-1,15519,108
15519,109,0.690251507963074,idc91a49d0,left_ankle,3.33509182929993,0,-1,15519,108
15518,110,0.73952560579507,idc91a49d0,right_ankle,3.31751894950867,1,-1,15519,108
12668,111,0.222884014376914,idc91a49d0,left_wrist,3.59860587120056,-2,-1,12666,112
12667,111,0.265603971695554,idc91a49d0,left_hip,3.43942308425903,-1,0,12666,112
12663,115,0.639291511811749,idc91a49d0,left_ankle,3.33509182929993,3,0,12666,112
12664,113,0.712899955558001,idc91a49d0,right_ankle,3.31751894950867,2,1,12666,112
18900,110,0.24026239909143,idc91a49d0,left_wrist,3.59860587120056,-4,-4,18896,110
18897,110,0.305498228354667,idc91a49d0,left_hip,3.43942308425903,-1,-1,18896,110
18896,111,0.67874186279543,idc91a49d0,left_ankle,3.33509182929993,0,-1,18896,110
18897,110,0.692842174468931,idc91a49d0,right_ankle,3.31751894950867,-1,-1,18896,110
6992,104,0.24544809257189,id1c7e64ad,left_wrist,4.57753205299377,-1,-1,6991,104
6990,104,0.280399995371616,id1c7e64ad,left_hip,4.83174014091492,1,1,6991,104
6989,104,0.652104789546936,id1c7e64ad,left_ankle,4.66496586799622,2,2,6991,104
6987,106,0.61717005500992,id1c7e64ad,right_ankle,4.73506784439087,4,2,6991,104
4632,106,0.242416930005262,id1c7e64ad,left_wrist,4.57753205299377,-2,-2,4630,106
4630,105,0.263893089676682,id1c7e64ad,left_hip,4.83174014091492,0,1,4630,106
4629,106,0.625619185405813,id1c7e64ad,left_ankle,4.66496586799622,1,1,4630,106
4630,106,0.677161538294307,id1c7e64ad,right_ankle,4.73506784439087,0,0,4630,106
21124,105,0.292530787346259,id1c7e64ad,left_wrist,4.57753205299377,-1,-5,21123,101
21126,101,0.302621908135741,id1c7e64ad,left_hip,4.83174014091492,-3,-3,21123,101
21124,101,0.667859909224358,id1c7e64ad,left_ankle,4.66496586799622,-1,-1,21123,101
21123,101,0.70835290659099,id1c7e64ad,right_ankle,4.73506784439087,0,0,21123,101
12085,101,0.265378743898492,id1c7e64ad,left_wrist,4.57753205299377,-1,-2,12084,100
12086,98,0.293283173183441,id1c7e64ad,left_hip,4.83174014091492,-2,0,12084,100
12084,101,0.698817095964659,id1c7e64ad,left_ankle,4.66496586799622,0,-1,12084,100
12082,102,0.694510370085676,id1c7e64ad,right_ankle,4.73506784439087,2,0,12084,100
20927,99,0.312004592604912,id1c7e64ad,left_wrist,4.57753205299377,-3,-2,20924,100
20927,100,0.290775372464277,id1c7e64ad,left_hip,4.83174014091492,-3,-3,20924,100
20923,101,0.714179014972031,id1c7e64ad,left_ankle,4.66496586799622,1,0,20924,100
20921,102,0.714590177973711,id1c7e64ad,right_ankle,4.73506784439087,3,1,20924,100
4632,106,0.242416930005262,id1c7e64ad,left_wrist,4.57753205299377,-2,-2,4630,106
4630,105,0.263893089676682,id1c7e64ad,left_hip,4.83174014091492,0,1,4630,106
4629,106,0.625619185405813,id1c7e64ad,left_ankle,4.66496586799622,1,1,4630,106
4630,106,0.677161538294307,id1c7e64ad,right_ankle,4.73506784439087,0,0,4630,106
18049,102,0.242142374931999,id1c7e64ad,left_wrist,4.57753205299377,-2,-2,18047,102
18051,100,0.286250926287517,id1c7e64ad,left_hip,4.83174014091492,-4,-2,18047,102
18048,101,0.685410584017653,id1c7e64ad,left_ankle,4.66496586799622,-1,0,18047,102
18047,103,0.664340962784356,id1c7e64ad,right_ankle,4.73506784439087,0,-1,18047,102
17345,100,0.266371538563346,id1c7e64ad,left_wrist,4.57753205299377,-3,-3,17342,100
17345,101,0.303909510579662,id1c7e64ad,left_hip,4.83174014091492,-3,-4,17342,100
17342,100,0.679568977095517,id1c7e64ad,left_ankle,4.66496586799622,0,0,17342,100
17341,99,0.702487103931357,id1c7e64ad,right_ankle,4.73506784439087,1,2,17342,100
22531,100,0.255327263926172,id1c7e64ad,left_wrist,4.57753205299377,-3,-3,22528,100
22531,100,0.297024414297204,id1c7e64ad,left_hip,4.83174014091492,-3,-3,22528,100
22528,99,0.747952255247746,id1c7e64ad,left_ankle,4.66496586799622,0,1,22528,100
22528,97,0.710712418841511,id1c7e64ad,right_ankle,4.73506784439087,0,3,22528,100
13085,99,0.222641974942519,id1c7e64ad,left_wrist,4.57753205299377,-2,0,13083,101
13084,101,0.281671311152189,id1c7e64ad,left_hip,4.83174014091492,-1,-1,13083,101
13082,102,0.726717196745895,id1c7e64ad,left_ankle,4.66496586799622,1,0,13083,101
13082,101,0.66496714722721,id1c7e64ad,right_ankle,4.73506784439087,1,1,13083,101
17046,103,0.292310420035148,id1c7e64ad,left_wrist,4.57753205299377,-3,-5,17043,101
17046,101,0.292119972136052,id1c7e64ad,left_hip,4.83174014091492,-3,-3,17043,101
17044,101,0.674467653285727,id1c7e64ad,left_ankle,4.66496586799622,-1,-1,17043,101
17043,100,0.656677786115062,id1c7e64ad,right_ankle,4.73506784439087,0,1,17043,101
9350,104,0.257685967445143,id1c7e64ad,left_wrist,4.57753205299377,0,-3,9350,101
9348,103,0.27890932376795,id1c7e64ad,left_hip,4.83174014091492,2,0,9350,101
9348,103,0.707036070002824,id1c7e64ad,left_ankle,4.66496586799622,2,0,9350,101
9348,102,0.679977929236605,id1c7e64ad,right_ankle,4.73506784439087,2,1,9350,101
2546,107,0.251878042540095,id1c7e64ad,left_wrist,4.57753205299377,-2,-3,2544,106
2544,107,0.272867056857911,id1c7e64ad,left_hip,4.83174014091492,0,-1,2544,106
2544,105,0.599884776002656,id1c7e64ad,left_ankle,4.66496586799622,0,1,2544,106
2542,107,0.679523272090112,id1c7e64ad,right_ankle,4.73506784439087,2,1,2544,106
22130,101,0.246423029946992,id1c7e64ad,left_wrist,4.57753205299377,-3,-3,22127,101
22130,100,0.289292946983762,id1c7e64ad,left_hip,4.83174014091492,-3,-2,22127,101
22128,101,0.659408987735802,id1c7e64ad,left_ankle,4.66496586799622,-1,-1,22127,101
22126,102,0.638192471372991,id1c7e64ad,right_ankle,4.73506784439087,1,0,22127,101
6786,103,0.234681886572597,id1c7e64ad,left_wrist,4.57753205299377,-2,0,6784,105
6783,105,0.279885671981014,id1c7e64ad,left_hip,4.83174014091492,1,1,6784,105
6783,104,0.646695391767791,id1c7e64ad,left_ankle,4.66496586799622,1,2,6784,105
6781,106,0.746945843810165,id1c7e64ad,right_ankle,4.73506784439087,3,2,6784,105
14098,104,0.224401028939723,id1c7e64ad,left_wrist,4.57753205299377,-1,-2,14097,103
14097,104,0.253536795174934,id1c7e64ad,left_hip,4.83174014091492,0,-1,14097,103
14097,102,0.707965588888542,id1c7e64ad,left_ankle,4.66496586799622,0,1,14097,103
14096,103,0.665458031404557,id1c7e64ad,right_ankle,4.73506784439087,1,1,14097,103
2755,105,0.241682652910227,id1c7e64ad,left_wrist,4.57753205299377,-1,-3,2754,103
2753,105,0.243314981731935,id1c7e64ad,left_hip,4.83174014091492,1,-1,2754,103
2753,104,0.6224676646879,id1c7e64ad,left_ankle,4.66496586799622,1,0,2754,103
2752,106,0.633386817800283,id1c7e64ad,right_ankle,4.73506784439087,2,-1,2754,103
20112,57,0.167755978485121,id1c7e64ad,left_wrist,4.57753205299377,-2,45,20110,104
20111,105,0.290367497043075,id1c7e64ad,left_hip,4.83174014091492,-1,-2,20110,104
20110,103,0.627599954286335,id1c7e64ad,left_ankle,4.66496586799622,0,1,20110,104
20111,102,0.64387350232725,id1c7e64ad,right_ankle,4.73506784439087,-1,1,20110,104
7617,101,0.237682717071698,id1c7e64ad,left_wrist,4.57753205299377,-4,-2,7613,103
7613,102,0.249824843250602,id1c7e64ad,left_hip,4.83174014091492,0,1,7613,103
7614,103,0.68935668392809,id1c7e64ad,left_ankle,4.66496586799622,-1,-1,7613,103
7614,102,0.687073524929474,id1c7e64ad,right_ankle,4.73506784439087,-1,0,7613,103
18670,104,0.280829090967076,id1c7e64ad,left_wrist,4.57753205299377,-1,-2,18669,103
18671,103,0.2538712189756,id1c7e64ad,left_hip,4.83174014091492,-2,-2,18669,103
18668,105,0.675042021760207,id1c7e64ad,left_ankle,4.66496586799622,1,-1,18669,103
18669,104,0.611694789544454,id1c7e64ad,right_ankle,4.73506784439087,0,-1,18669,103
5115,95,0.215688128575205,id8e66893c,left_wrist,3.37946105003357,13,14,5128,96
5127,96,0.384782017558318,id8e66893c,left_hip,3.32440495491028,1,1,5128,96
5128,96,0.560415684134426,id8e66893c,left_ankle,3.32802200317383,0,0,5128,96
5125,99,0.65926644371357,id8e66893c,right_ankle,3.54305386543274,3,0,5128,96
4251,97,0.163908968946017,id8e66893c,left_wrist,3.37946105003357,12,13,4263,98
4263,97,0.367062775124754,id8e66893c,left_hip,3.32440495491028,0,1,4263,98
4264,97,0.643427342499382,id8e66893c,left_ankle,3.32802200317383,-1,0,4263,98
4263,97,0.630028998715255,id8e66893c,right_ankle,3.54305386543274,0,1,4263,98
5021,95,0.206446455710946,id8e66893c,left_wrist,3.37946105003357,12,13,5033,96
5032,96,0.390792158842148,id8e66893c,left_hip,3.32440495491028,1,1,5033,96
5033,96,0.620370150887524,id8e66893c,left_ankle,3.32802200317383,0,0,5033,96
5031,95,0.59332342023245,id8e66893c,right_ankle,3.54305386543274,2,3,5033,96
7070,97,0.179987806891277,id8e66893c,left_wrist,3.37946105003357,-7,-7,7063,97
7068,97,0.349482641973636,id8e66893c,left_hip,3.32440495491028,-5,-5,7063,97
7069,96,0.557087033821783,id8e66893c,left_ankle,3.32802200317383,-6,-5,7063,97
7066,99,0.610678963594386,id8e66893c,right_ankle,3.54305386543274,-3,-5,7063,97
10886,95,0.280291738463908,id8e66893c,left_wrist,3.37946105003357,-5,-3,10881,97
10887,99,0.259962121187639,id8e66893c,left_hip,3.32440495491028,-6,-8,10881,97
10887,96,0.51701958231688,id8e66893c,left_ankle,3.32802200317383,-6,-5,10881,97
10884,102,0.479166569000798,id8e66893c,right_ankle,3.54305386543274,-3,-8,10881,97
17187,100,0.323121180903822,id8e66893c,left_wrist,3.37946105003357,-5,-7,17182,98
17188,98,0.347344035308389,id8e66893c,left_hip,3.32440495491028,-6,-6,17182,98
17187,99,0.607869861519351,id8e66893c,left_ankle,3.32802200317383,-5,-6,17182,98
17187,99,0.68049867434541,id8e66893c,right_ankle,3.54305386543274,-5,-6,17182,98
4069,100,0.18468293311885,id8e66893c,left_wrist,3.37946105003357,-5,-6,4064,99
4068,98,0.332622943538363,id8e66893c,left_hip,3.32440495491028,-4,-3,4064,99
4070,98,0.579782248717614,id8e66893c,left_ankle,3.32802200317383,-6,-5,4064,99
4070,99,0.574014598340997,id8e66893c,right_ankle,3.54305386543274,-6,-6,4064,99
17091,97,0.269701928570905,id8e66893c,left_wrist,3.37946105003357,-4,-5,17087,96
17090,99,0.35922148365628,id8e66893c,left_hip,3.32440495491028,-3,-6,17087,96
17090,98,0.594721065909313,id8e66893c,left_ankle,3.32802200317383,-3,-5,17087,96
17090,98,0.660828575877731,id8e66893c,right_ankle,3.54305386543274,-3,-5,17087,96
17869,54,0.369437265801963,id8e66893c,left_wrist,3.37946105003357,-6,38,17863,98
17869,98,0.399695857347992,id8e66893c,left_hip,3.32440495491028,-6,-6,17863,98
17869,98,0.667009852476818,id8e66893c,left_ankle,3.32802200317383,-6,-6,17863,98
17869,98,0.637043715903611,id8e66893c,right_ankle,3.54305386543274,-6,-6,17863,98
12541,97,0.166440177278538,id8e66893c,left_wrist,3.37946105003357,-7,-6,12534,98
12539,98,0.335289627110134,id8e66893c,left_hip,3.32440495491028,-5,-5,12534,98
12540,97,0.628542575241427,id8e66893c,left_ankle,3.32802200317383,-6,-5,12534,98
12539,99,0.648886587181605,id8e66893c,right_ankle,3.54305386543274,-5,-6,12534,98
11949,95,0.182105132180886,id8e66893c,left_wrist,3.37946105003357,2,5,11951,98
11956,98,0.339628959723176,id8e66893c,left_hip,3.32440495491028,-5,-5,11951,98
11957,97,0.580871710102101,id8e66893c,left_ankle,3.32802200317383,-6,-5,11951,98
11956,98,0.626485941951646,id8e66893c,right_ankle,3.54305386543274,-5,-5,11951,98
1257,66,0.124327957605588,id8e66893c,left_wrist,3.37946105003357,-6,25,1251,97
1255,97,0.358697278246037,id8e66893c,left_hip,3.32440495491028,-4,-4,1251,97
1256,96,0.600643035973314,id8e66893c,left_ankle,3.32802200317383,-5,-4,1251,97
1255,96,0.633005402020902,id8e66893c,right_ankle,3.54305386543274,-4,-3,1251,97
4069,100,0.18468293311885,id8e66893c,left_wrist,3.37946105003357,-5,-6,4064,99
4068,98,0.332622943538363,id8e66893c,left_hip,3.32440495491028,-4,-3,4064,99
4070,98,0.579782248717614,id8e66893c,left_ankle,3.32802200317383,-6,-5,4064,99
4070,99,0.574014598340997,id8e66893c,right_ankle,3.54305386543274,-6,-6,4064,99
3392,98,0.188112273501562,id8e66893c,left_wrist,3.37946105003357,-1,-3,3391,96
3390,99,0.308192269965608,id8e66893c,left_hip,3.32440495491028,1,-2,3391,96
3391,99,0.536040635756518,id8e66893c,left_ankle,3.32802200317383,0,-3,3391,96
3391,99,0.608150569844676,id8e66893c,right_ankle,3.54305386543274,0,-3,3391,96
13023,88,0.16899475750208,id8e66893c,left_wrist,3.37946105003357,-6,4,13017,98
13022,96,0.352891070673219,id8e66893c,left_hip,3.32440495491028,-5,-3,13017,98
13022,96,0.633347301526957,id8e66893c,left_ankle,3.32802200317383,-5,-3,13017,98
13020,96,0.588177571915853,id8e66893c,right_ankle,3.54305386543274,-3,-1,13017,98
7263,99,0.202519035918529,id8e66893c,left_wrist,3.37946105003357,-6,-7,7257,98
7261,99,0.330990466171915,id8e66893c,left_hip,3.32440495491028,-4,-5,7257,98
7263,98,0.587524576409322,id8e66893c,left_ankle,3.32802200317383,-6,-6,7257,98
7262,98,0.588122988627325,id8e66893c,right_ankle,3.54305386543274,-5,-5,7257,98
14659,98,0.30977107403797,id8e66893c,left_wrist,3.37946105003357,-3,-6,14656,95
14660,97,0.404980346465669,id8e66893c,left_hip,3.32440495491028,-4,-6,14656,95
14659,98,0.645585980960495,id8e66893c,left_ankle,3.32802200317383,-3,-6,14656,95
14657,100,0.64435822452805,id8e66893c,right_ankle,3.54305386543274,-1,-6,14656,95
9420,100,0.297187860737224,id8e66893c,left_wrist,3.37946105003357,-7,-6,9413,101
9419,100,0.290854547573204,id8e66893c,left_hip,3.32440495491028,-6,-5,9413,101
9420,98,0.558607338334936,id8e66893c,left_ankle,3.32802200317383,-7,-4,9413,101
9420,101,0.519875438126578,id8e66893c,right_ankle,3.54305386543274,-7,-7,9413,101
13600,55,0.268245917077165,id8e66893c,left_wrist,3.37946105003357,-5,41,13595,101
13601,98,0.352398826457123,id8e66893c,left_hip,3.32440495491028,-6,-3,13595,101
13601,98,0.613065413369979,id8e66893c,left_ankle,3.32802200317383,-6,-3,13595,101
13600,98,0.642618817066556,id8e66893c,right_ankle,3.54305386543274,-5,-2,13595,101
18743,88,0.203756412493393,id8e66893c,left_wrist,3.37946105003357,-1,5,18742,94
18742,99,0.348588778024471,id8e66893c,left_hip,3.32440495491028,0,-5,18742,94
18743,98,0.592112555459463,id8e66893c,left_ankle,3.32802200317383,-1,-5,18742,94
18742,97,0.622171459193244,id8e66893c,right_ankle,3.54305386543274,0,-3,18742,94
7263,99,0.202519035918529,id8e66893c,left_wrist,3.37946105003357,-6,-7,7257,98
7261,99,0.330990466171915,id8e66893c,left_hip,3.32440495491028,-4,-5,7257,98
7263,98,0.587524576409322,id8e66893c,left_ankle,3.32802200317383,-6,-6,7257,98
7262,98,0.588122988627325,id8e66893c,right_ankle,3.54305386543274,-5,-5,7257,98
14659,98,0.30977107403797,id8e66893c,left_wrist,3.37946105003357,-3,-6,14656,95
14660,97,0.404980346465669,id8e66893c,left_hip,3.32440495491028,-4,-6,14656,95
14659,98,0.645585980960495,id8e66893c,left_ankle,3.32802200317383,-3,-6,14656,95
14657,100,0.64435822452805,id8e66893c,right_ankle,3.54305386543274,-1,-6,14656,95
20853,94,0.283860589848904,id34e056c8,left_wrist,4.56383109092712,-2,-3,20851,93
20858,93,0.35236631501698,id34e056c8,left_hip,4.47977304458618,-7,-7,20851,93
20850,95,0.771596051577632,id34e056c8,left_ankle,4.23649597167969,1,-1,20851,93
20852,93,0.670953265882612,id34e056c8,right_ankle,5.38907122612,-1,-1,20851,93
4747,94,0.294843249763421,id34e056c8,left_wrist,4.56383109092712,3,3,4750,94
4750,95,0.362138919476763,id34e056c8,left_hip,4.47977304458618,0,-1,4750,94
4748,94,0.740438463268121,id34e056c8,left_ankle,4.23649597167969,2,2,4750,94
4749,93,0.706800065887164,id34e056c8,right_ankle,5.38907122612,1,2,4750,94
14531,88,0.225497388300374,id34e056c8,left_wrist,4.56383109092712,1,3,14532,90
14534,91,0.370959988143957,id34e056c8,left_hip,4.47977304458618,-2,-3,14532,90
14530,91,0.794106008918461,id34e056c8,left_ankle,4.23649597167969,2,1,14532,90
14529,92,0.747303166245259,id34e056c8,right_ankle,5.38907122612,3,1,14532,90
2809,91,0.312979516848152,id34e056c8,left_wrist,4.56383109092712,1,3,2810,93
2812,92,0.367012957541947,id34e056c8,left_hip,4.47977304458618,-2,-1,2810,93
2809,91,0.72122853989197,id34e056c8,left_ankle,4.23649597167969,1,3,2810,93
2808,94,0.782769524253217,id34e056c8,right_ankle,5.38907122612,2,1,2810,93
6041,93,0.251716782227824,id34e056c8,left_wrist,4.56383109092712,0,0,6041,93
6038,99,0.334052608928169,id34e056c8,left_hip,4.47977304458618,3,-3,6041,93
6039,93,0.81457204235453,id34e056c8,left_ankle,4.23649597167969,2,2,6041,93
6040,94,0.679836068002347,id34e056c8,right_ankle,5.38907122612,1,0,6041,93
8611,90,0.155166849744823,id34e056c8,left_wrist,4.56383109092712,-7,1,8604,98
8603,98,0.24649695847194,id34e056c8,left_hip,4.47977304458618,1,1,8604,98
8604,95,0.711192639821986,id34e056c8,left_ankle,4.23649597167969,0,3,8604,98
8605,96,0.57369141795568,id34e056c8,right_ankle,5.38907122612,-1,1,8604,98
371,89,0.219440730997337,id34e056c8,left_wrist,4.56383109092712,2,2,373,89
376,88,0.346678595426967,id34e056c8,left_hip,4.47977304458618,-3,-2,373,89
370,91,0.852456934555751,id34e056c8,left_ankle,4.23649597167969,3,1,373,89
370,90,0.737146560864133,id34e056c8,right_ankle,5.38907122612,3,2,373,89
8513,96,0.2625008681265,id34e056c8,left_wrist,4.56383109092712,0,-4,8513,92
8517,87,0.218798417832709,id34e056c8,left_hip,4.47977304458618,-4,1,8513,92
8513,92,0.784470466036479,id34e056c8,left_ankle,4.23649597167969,0,0,8513,92
8513,93,0.596995378720821,id34e056c8,right_ankle,5.38907122612,0,-1,8513,92
19344,93,0.257672807115036,id34e056c8,left_wrist,4.56383109092712,-7,1,19337,101
19348,88,0.292818803647787,id34e056c8,left_hip,4.47977304458618,-11,2,19337,101
19340,97,0.793488991919055,id34e056c8,left_ankle,4.23649597167969,-3,1,19337,101
19342,98,0.657846788729178,id34e056c8,right_ankle,5.38907122612,-5,-2,19337,101
7596,93,0.275316542049018,id34e056c8,left_wrist,4.56383109092712,3,3,7599,93
7600,93,0.306553665693348,id34e056c8,left_hip,4.47977304458618,-1,-1,7599,93
7597,93,0.849850848562089,id34e056c8,left_ankle,4.23649597167969,2,2,7599,93
7598,93,0.73627118150618,id34e056c8,right_ankle,5.38907122612,1,1,7599,93
10799,96,0.216173384026867,id34e056c8,left_wrist,4.56383109092712,3,-1,10802,92
10804,92,0.355885706340513,id34e056c8,left_hip,4.47977304458618,-2,-2,10802,92
10801,91,0.743856096938974,id34e056c8,left_ankle,4.23649597167969,1,2,10802,92
10800,92,0.750445875708836,id34e056c8,right_ankle,5.38907122612,2,2,10802,92
13352,90,0.280559357168118,id34e056c8,left_wrist,4.56383109092712,1,3,13353,92
13357,90,0.356326866661727,id34e056c8,left_hip,4.47977304458618,-4,-2,13353,92
13352,92,0.798255560144526,id34e056c8,left_ankle,4.23649597167969,1,1,13353,92
13352,92,0.76466838187739,id34e056c8,right_ankle,5.38907122612,1,1,13353,92
10984,94,0.261997270557127,id34e056c8,left_wrist,4.56383109092712,-1,-5,10983,90
10987,93,0.376479998001571,id34e056c8,left_hip,4.47977304458618,-4,-7,10983,90
10982,90,0.765358647159094,id34e056c8,left_ankle,4.23649597167969,1,1,10983,90
10982,91,0.762971517107561,id34e056c8,right_ankle,5.38907122612,1,0,10983,90
4189,95,0.309358011758538,id34e056c8,left_wrist,4.56383109092712,5,3,4194,93
4193,92,0.371081009205267,id34e056c8,left_hip,4.47977304458618,1,2,4194,93
4191,93,0.825217700853291,id34e056c8,left_ankle,4.23649597167969,3,3,4194,93
4192,93,0.690278302526122,id34e056c8,right_ankle,5.38907122612,2,2,4194,93
18397,95,0.301833940288936,id34e056c8,left_wrist,4.56383109092712,-2,-2,18395,95
18401,95,0.34263133496306,id34e056c8,left_hip,4.47977304458618,-6,-6,18395,95
18394,95,0.746604615341943,id34e056c8,left_ankle,4.23649597167969,1,1,18395,95
18396,95,0.689060380168397,id34e056c8,right_ankle,5.38907122612,-1,-1,18395,95
14892,94,0.256836603581732,id34e056c8,left_wrist,4.56383109092712,3,2,14895,93
14900,90,0.335774269627414,id34e056c8,left_hip,4.47977304458618,-5,-2,14895,93
14894,92,0.840415212615582,id34e056c8,left_ankle,4.23649597167969,1,2,14895,93
14894,91,0.676051017359997,id34e056c8,right_ankle,5.38907122612,1,3,14895,93
17736,93,0.294058123234024,id34e056c8,left_wrist,4.56383109092712,0,2,17736,95
17742,95,0.37335507528079,id34e056c8,left_hip,4.47977304458618,-6,-6,17736,95
17734,95,0.791151578834055,id34e056c8,left_ankle,4.23649597167969,2,2,17736,95
17736,95,0.701400320671519,id34e056c8,right_ankle,5.38907122612,0,0,17736,95
2441,92,0.246010858694266,id34e056c8,left_wrist,4.56383109092712,1,3,2442,94
2442,93,0.327603614527202,id34e056c8,left_hip,4.47977304458618,0,1,2442,94
2441,92,0.724809015970215,id34e056c8,left_ankle,4.23649597167969,1,3,2442,94
2441,94,0.714063265566567,id34e056c8,right_ankle,5.38907122612,1,1,2442,94
16173,92,0.244685135969986,id34e056c8,left_wrist,4.56383109092712,0,0,16173,92
16177,93,0.348887559696421,id34e056c8,left_hip,4.47977304458618,-4,-5,16173,92
16172,93,0.827059298427846,id34e056c8,left_ankle,4.23649597167969,1,0,16173,92
16173,93,0.689328971593664,id34e056c8,right_ankle,5.38907122612,0,-1,16173,92
9162,97,0.197804809238435,id34e056c8,left_wrist,4.56383109092712,3,1,9165,95
9164,97,0.307636404404644,id34e056c8,left_hip,4.47977304458618,1,-1,9165,95
9164,93,0.749306785651052,id34e056c8,left_ankle,4.23649597167969,1,3,9165,95
9164,94,0.694891582529886,id34e056c8,right_ankle,5.38907122612,1,2,9165,95
14330,107,0.340660075438434,idc735fc09,left_wrist,3.32541799545288,0,-3,14330,104
14331,105,0.35667677002693,idc735fc09,left_hip,2.87056708335876,-1,-2,14330,104
14330,105,0.678273562424763,idc735fc09,left_ankle,3.18695402145386,0,-1,14330,104
14330,103,0.74175480873613,idc735fc09,right_ankle,2.80694007873535,0,1,14330,104
11333,109,0.179296046089405,idc735fc09,left_wrist,3.32541799545288,1,-3,11334,105
11333,105,0.345823831573234,idc735fc09,left_hip,2.87056708335876,1,1,11334,105
11332,105,0.711243107189337,idc735fc09,left_ankle,3.18695402145386,2,2,11334,105
11331,105,0.905870856637558,idc735fc09,right_ankle,2.80694007873535,3,3,11334,105
13810,105,0.310027111108772,idc735fc09,left_wrist,3.32541799545288,-2,-2,13808,105
13810,105,0.381983297612903,idc735fc09,left_hip,2.87056708335876,-2,-2,13808,105
13809,105,0.643535845443987,idc735fc09,left_ankle,3.18695402145386,-1,-1,13808,105
13808,105,0.812910959777281,idc735fc09,right_ankle,2.80694007873535,0,0,13808,105
9678,105,0.283873588077464,idc735fc09,left_wrist,3.32541799545288,2,1,9680,104
9680,103,0.382758964818313,idc735fc09,left_hip,2.87056708335876,0,1,9680,104
9679,103,0.710686005836437,idc735fc09,left_ankle,3.18695402145386,1,2,9680,104
9678,102,0.91036161098923,idc735fc09,right_ankle,2.80694007873535,2,4,9680,104
9269,103,0.308866914633272,idc735fc09,left_wrist,3.32541799545288,-2,-2,9267,103
9268,104,0.397292671344371,idc735fc09,left_hip,2.87056708335876,-1,-2,9267,103
9266,104,0.666710462268892,idc735fc09,left_ankle,3.18695402145386,1,0,9267,103
9266,104,0.839176078327503,idc735fc09,right_ankle,2.80694007873535,1,0,9267,103
13709,102,0.279647352070683,idc735fc09,left_wrist,3.32541799545288,-2,-2,13707,102
13708,103,0.369691019276604,idc735fc09,left_hip,2.87056708335876,-1,-2,13707,102
13705,105,0.687383232037731,idc735fc09,left_ankle,3.18695402145386,2,-1,13707,102
13706,103,0.878685165497958,idc735fc09,right_ankle,2.80694007873535,1,0,13707,102
576,106,0.284979081155367,idc735fc09,left_wrist,3.32541799545288,0,0,576,106
575,107,0.311290146821058,idc735fc09,left_hip,2.87056708335876,1,0,576,106
574,108,0.727115939084956,idc735fc09,left_ankle,3.18695402145386,2,0,576,106
575,105,0.744691023783023,idc735fc09,right_ankle,2.80694007873535,1,2,576,106
8335,104,0.273206890863733,idc735fc09,left_wrist,3.32541799545288,-1,-1,8334,104
8335,104,0.361915961376283,idc735fc09,left_hip,2.87056708335876,-1,-1,8334,104
8333,105,0.678906361381225,idc735fc09,left_ankle,3.18695402145386,1,0,8334,104
8330,109,0.900769757672951,idc735fc09,right_ankle,2.80694007873535,4,-1,8334,104
12783,105,0.310587405313148,idc735fc09,left_wrist,3.32541799545288,-2,0,12781,107
12783,106,0.349719498172591,idc735fc09,left_hip,2.87056708335876,-2,-1,12781,107
12782,105,0.671625810410953,idc735fc09,left_ankle,3.18695402145386,-1,1,12781,107
12783,105,0.807498099512235,idc735fc09,right_ankle,2.80694007873535,-2,0,12781,107
12157,104,0.185773830278218,idc735fc09,left_wrist,3.32541799545288,2,2,12159,104
12159,104,0.330463690418629,idc735fc09,left_hip,2.87056708335876,0,0,12159,104
12158,105,0.677147050912532,idc735fc09,left_ankle,3.18695402145386,1,0,12159,104
12158,104,0.945799098254025,idc735fc09,right_ankle,2.80694007873535,1,1,12159,104
8335,104,0.273206890863733,idc735fc09,left_wrist,3.32541799545288,-1,-1,8334,104
8335,104,0.361915961376283,idc735fc09,left_hip,2.87056708335876,-1,-1,8334,104
8333,105,0.678906361381225,idc735fc09,left_ankle,3.18695402145386,1,0,8334,104
8330,109,0.900769757672951,idc735fc09,right_ankle,2.80694007873535,4,-1,8334,104
14957,106,0.407682091977176,idc735fc09,left_wrist,3.32541799545288,-1,-2,14956,105
14957,104,0.386816300506905,idc735fc09,left_hip,2.87056708335876,-1,0,14956,105
14955,105,0.639010930467061,idc735fc09,left_ankle,3.18695402145386,1,1,14956,105
14955,105,0.847563661904614,idc735fc09,right_ankle,2.80694007873535,1,1,14956,105
7598,105,0.264082926242132,idc735fc09,left_wrist,3.32541799545288,2,2,7600,105
7600,105,0.328911319762483,idc735fc09,left_hip,2.87056708335876,0,0,7600,105
7598,107,0.758632614595989,idc735fc09,left_ankle,3.18695402145386,2,0,7600,105
7599,103,0.931616166395597,idc735fc09,right_ankle,2.80694007873535,1,3,7600,105
4273,106,0.219123905246579,idc735fc09,left_wrist,3.32541799545288,3,2,4276,105
4276,105,0.294805109882126,idc735fc09,left_hip,2.87056708335876,0,0,4276,105
4274,106,0.741800053424381,idc735fc09,left_ankle,3.18695402145386,2,1,4276,105
4273,106,0.883264880717532,idc735fc09,right_ankle,2.80694007873535,3,2,4276,105
1311,108,0.263170911563625,idc735fc09,left_wrist,3.32541799545288,2,1,1313,107
1312,108,0.28130275842101,idc735fc09,left_hip,2.87056708335876,1,0,1313,107
1312,107,0.669951224604976,idc735fc09,left_ankle,3.18695402145386,1,1,1313,107
1311,107,0.853221283848258,idc735fc09,right_ankle,2.80694007873535,2,2,1313,107
1735,108,0.238578652379476,idc735fc09,left_wrist,3.32541799545288,4,4,1739,108
1738,108,0.294131596118231,idc735fc09,left_hip,2.87056708335876,1,1,1739,108
1735,108,0.718316346298395,idc735fc09,left_ankle,3.18695402145386,4,4,1739,108
1737,107,0.791944538576871,idc735fc09,right_ankle,2.80694007873535,2,3,1739,108
5532,106,0.234574781201934,idc735fc09,left_wrist,3.32541799545288,2,2,5534,106
5534,106,0.2787594607009,idc735fc09,left_hip,2.87056708335876,0,0,5534,106
5531,107,0.717251234749943,idc735fc09,left_ankle,3.18695402145386,3,2,5534,106
5532,105,0.76842845561967,idc735fc09,right_ankle,2.80694007873535,2,3,5534,106
9061,105,0.30121777113438,idc735fc09,left_wrist,3.32541799545288,2,-1,9063,102
9062,105,0.375734567287728,idc735fc09,left_hip,2.87056708335876,1,-2,9063,102
9060,105,0.650047397711533,idc735fc09,left_ankle,3.18695402145386,3,0,9063,102
9061,103,0.842095242439264,idc735fc09,right_ankle,2.80694007873535,2,1,9063,102
11540,100,0.209714335975349,idc735fc09,left_wrist,3.32541799545288,1,-2,11541,97
11540,104,0.358401848289354,idc735fc09,left_hip,2.87056708335876,1,-6,11541,97
11539,101,0.72641167585927,idc735fc09,left_ankle,3.18695402145386,2,-2,11541,97
11538,101,0.770886638786972,idc735fc09,right_ankle,2.80694007873535,3,-1,11541,97
7079,104,0.261649763144424,idc735fc09,left_wrist,3.32541799545288,2,3,7081,105
7081,105,0.319842720950329,idc735fc09,left_hip,2.87056708335876,0,0,7081,105
7080,105,0.770933584702195,idc735fc09,left_ankle,3.18695402145386,1,1,7081,105
7078,106,0.840767056175836,idc735fc09,right_ankle,2.80694007873535,3,2,7081,105
18595,105,0.335123642518958,id86237981,left_wrist,3.83954691886902,-3,-2,18592,106
18596,105,0.355985879624419,id86237981,left_hip,3.74081707000732,-4,-3,18592,106
18592,106,0.797246465282311,id86237981,left_ankle,3.99342799186707,0,0,18592,106
18593,104,0.758346707303207,id86237981,right_ankle,3.94927716255188,-1,1,18592,106
6002,104,0.294851846714626,id86237981,left_wrist,3.83954691886902,-1,0,6001,105
6001,105,0.346940865926058,id86237981,left_hip,3.74081707000732,0,0,6001,105
5999,106,0.768228507016576,id86237981,left_ankle,3.99342799186707,2,1,6001,105
5999,105,0.759180937307886,id86237981,right_ankle,3.94927716255188,2,2,6001,105
9334,106,0.285727826376619,id86237981,left_wrist,3.83954691886902,0,0,9334,106
9335,107,0.355897586662206,id86237981,left_hip,3.74081707000732,-1,-2,9334,106
9334,106,0.781159034396649,id86237981,left_ankle,3.99342799186707,0,0,9334,106
9332,107,0.805823286739246,id86237981,right_ankle,3.94927716255188,2,1,9334,106
6840,105,0.321549293534717,id86237981,left_wrist,3.83954691886902,0,-1,6840,104
6842,105,0.357050842257813,id86237981,left_hip,3.74081707000732,-2,-3,6840,104
6840,104,0.738229681462017,id86237981,left_ankle,3.99342799186707,0,0,6840,104
6837,108,0.811368350518288,id86237981,right_ankle,3.94927716255188,3,-1,6840,104
13270,105,0.288854514399798,id86237981,left_wrist,3.83954691886902,0,-1,13270,104
13274,104,0.359929366356344,id86237981,left_hip,3.74081707000732,-4,-4,13270,104
13270,102,0.68948221599802,id86237981,left_ankle,3.99342799186707,0,2,13270,104
13270,103,0.768501493511235,id86237981,right_ankle,3.94927716255188,0,1,13270,104
5275,105,0.287586672389558,id86237981,left_wrist,3.83954691886902,-3,-2,5272,106
5274,104,0.367647202984009,id86237981,left_hip,3.74081707000732,-2,0,5272,106
5272,104,0.707876261862822,id86237981,left_ankle,3.99342799186707,0,2,5272,106
5270,106,0.883959773914823,id86237981,right_ankle,3.94927716255188,2,2,5272,106
9750,105,0.284155703857522,id86237981,left_wrist,3.83954691886902,0,-2,9750,103
9754,103,0.368609035539612,id86237981,left_hip,3.74081707000732,-4,-4,9750,103
9750,103,0.727046879890575,id86237981,left_ankle,3.99342799186707,0,0,9750,103
9749,103,0.858453258935422,id86237981,right_ankle,3.94927716255188,1,1,9750,103
15565,105,0.332407477556182,id86237981,left_wrist,3.83954691886902,-5,-5,15560,105
15564,105,0.375436947148719,id86237981,left_hip,3.74081707000732,-4,-4,15560,105
15561,105,0.732495271073598,id86237981,left_ankle,3.99342799186707,-1,-1,15560,105
15560,103,0.804774533847684,id86237981,right_ankle,3.94927716255188,0,2,15560,105
1728,105,0.281665812700507,id86237981,left_wrist,3.83954691886902,-2,-1,1726,106
1725,105,0.335468218371882,id86237981,left_hip,3.74081707000732,1,2,1726,106
1723,108,0.784553282883549,id86237981,left_ankle,3.99342799186707,3,1,1726,106
1724,108,0.842666443368392,id86237981,right_ankle,3.94927716255188,2,0,1726,106
17760,102,0.346216888013045,id86237981,left_wrist,3.83954691886902,-5,-2,17755,105
17759,105,0.378599078672083,id86237981,left_hip,3.74081707000732,-4,-4,17755,105
17755,105,0.779837335761761,id86237981,left_ankle,3.99342799186707,0,0,17755,105
17756,104,0.779316997931166,id86237981,right_ankle,3.94927716255188,-1,0,17755,105
6944,107,0.299890588514431,id86237981,left_wrist,3.83954691886902,-1,-2,6943,106
6946,105,0.375613400592431,id86237981,left_hip,3.74081707000732,-3,-2,6943,106
6943,106,0.779351303076154,id86237981,left_ankle,3.99342799186707,0,0,6943,106
6944,104,0.760848593505074,id86237981,right_ankle,3.94927716255188,-1,1,6943,106
17126,105,0.321583098376663,id86237981,left_wrist,3.83954691886902,-2,-1,17124,106
17127,105,0.380948203587146,id86237981,left_hip,3.74081707000732,-3,-2,17124,106
17124,106,0.739555690775839,id86237981,left_ankle,3.99342799186707,0,0,17124,106
17123,106,0.767047115732398,id86237981,right_ankle,3.94927716255188,1,1,17124,106
7050,105,0.320105063151204,id86237981,left_wrist,3.83954691886902,-2,-2,7048,105
7050,106,0.35968167284195,id86237981,left_hip,3.74081707000732,-2,-3,7048,105
7048,105,0.746729441787522,id86237981,left_ankle,3.99342799186707,0,0,7048,105
7047,106,0.826903370213264,id86237981,right_ankle,3.94927716255188,1,0,7048,105
6840,105,0.321549293534717,id86237981,left_wrist,3.83954691886902,0,-1,6840,104
6842,105,0.357050842257813,id86237981,left_hip,3.74081707000732,-2,-3,6840,104
6840,104,0.738229681462017,id86237981,left_ankle,3.99342799186707,0,0,6840,104
6837,108,0.811368350518288,id86237981,right_ankle,3.94927716255188,3,-1,6840,104
9750,105,0.284155703857522,id86237981,left_wrist,3.83954691886902,0,-2,9750,103
9754,103,0.368609035539612,id86237981,left_hip,3.74081707000732,-4,-4,9750,103
9750,103,0.727046879890575,id86237981,left_ankle,3.99342799186707,0,0,9750,103
9749,103,0.858453258935422,id86237981,right_ankle,3.94927716255188,1,1,9750,103
18177,105,0.257613763801032,id86237981,left_wrist,3.83954691886902,-2,-2,18175,105
18176,107,0.393920382008342,id86237981,left_hip,3.74081707000732,-1,-3,18175,105
18175,106,0.752452609552554,id86237981,left_ankle,3.99342799186707,0,-1,18175,105
18173,105,0.818041643373846,id86237981,right_ankle,3.94927716255188,2,2,18175,105
17550,108,0.29709483808335,id86237981,left_wrist,3.83954691886902,-4,-5,17546,107
17547,108,0.376682050889125,id86237981,left_hip,3.74081707000732,-1,-2,17546,107
17546,107,0.743127537412789,id86237981,left_ankle,3.99342799186707,0,0,17546,107
17546,106,0.82398421078017,id86237981,right_ankle,3.94927716255188,0,1,17546,107
7980,105,0.28228328037515,id86237981,left_wrist,3.83954691886902,-1,-2,7979,104
7982,103,0.344631059489608,id86237981,left_hip,3.74081707000732,-3,-2,7979,104
7979,105,0.818433026434354,id86237981,left_ankle,3.99342799186707,0,-1,7979,104
7978,105,0.840214050140952,id86237981,right_ankle,3.94927716255188,1,0,7979,104
15876,105,0.280822776555025,id86237981,left_wrist,3.83954691886902,-3,-2,15873,106
15877,105,0.359975673834315,id86237981,left_hip,3.74081707000732,-4,-3,15873,106
15874,105,0.720642301050411,id86237981,left_ankle,3.99342799186707,-1,0,15873,106
15874,104,0.810020824267788,id86237981,right_ankle,3.94927716255188,-1,1,15873,106
19539,106,0.343959391635172,id86237981,left_wrist,3.83954691886902,-3,-2,19536,107
19538,106,0.410172396574211,id86237981,left_hip,3.74081707000732,-2,-1,19536,107
19536,108,0.794007865543798,id86237981,left_ankle,3.99342799186707,0,-1,19536,107
19536,104,0.738214728487547,id86237981,right_ankle,3.94927716255188,0,3,19536,107
8582,121,0.1487169354917,idf5e3678b,left_wrist,3.36536192893982,9,-4,8591,108
8591,108,0.317714419854144,idf5e3678b,left_hip,3.18920302391052,0,0,8591,108
8590,109,0.658431547572099,idf5e3678b,left_ankle,3.27432608604431,1,0,8591,108
8590,106,0.756068938141162,idf5e3678b,right_ankle,3.55841684341431,1,3,8591,108
14151,57,0.174522816111911,idf5e3678b,left_wrist,3.36536192893982,-9,42,14142,108
14144,107,0.307577200872548,idf5e3678b,left_hip,3.18920302391052,-2,-1,14142,108
14143,108,0.675761408098953,idf5e3678b,left_ankle,3.27432608604431,-1,-1,14142,108
14143,108,0.705166573024959,idf5e3678b,right_ankle,3.55841684341431,-1,-1,14142,108
7940,106,0.144970007644777,idf5e3678b,left_wrist,3.36536192893982,8,10,7948,108
7948,108,0.31088724294917,idf5e3678b,left_hip,3.18920302391052,0,0,7948,108
7947,108,0.659083703312791,idf5e3678b,left_ankle,3.27432608604431,1,1,7948,108
7946,110,0.740570712441173,idf5e3678b,right_ankle,3.55841684341431,2,0,7948,108
6453,60,0.139702513704573,idf5e3678b,left_wrist,3.36536192893982,-5,41,6448,106
6448,110,0.272638054220188,idf5e3678b,left_hip,3.18920302391052,0,-4,6448,106
6447,110,0.639086722245896,idf5e3678b,left_ankle,3.27432608604431,1,-3,6448,106
6448,109,0.662469016130868,idf5e3678b,right_ankle,3.55841684341431,0,-3,6448,106
14997,106,0.164622990385037,idf5e3678b,left_wrist,3.36536192893982,-7,-7,14990,106
14992,106,0.343020996219313,idf5e3678b,left_hip,3.18920302391052,-2,-2,14990,106
14991,106,0.690389179713176,idf5e3678b,left_ankle,3.27432608604431,-1,-1,14990,106
14989,105,0.755038391591624,idf5e3678b,right_ankle,3.55841684341431,1,2,14990,106
4038,108,0.18419022219598,idf5e3678b,left_wrist,3.36536192893982,-5,-3,4033,110
4035,109,0.308190559406093,idf5e3678b,left_hip,3.18920302391052,-2,-1,4033,110
4033,109,0.645774368071477,idf5e3678b,left_ankle,3.27432608604431,0,1,4033,110
4033,108,0.64498529109648,idf5e3678b,right_ankle,3.55841684341431,0,2,4033,110
14151,57,0.174522816111911,idf5e3678b,left_wrist,3.36536192893982,-9,42,14142,108
14144,107,0.307577200872548,idf5e3678b,left_hip,3.18920302391052,-2,-1,14142,108
14143,108,0.675761408098953,idf5e3678b,left_ankle,3.27432608604431,-1,-1,14142,108
14143,108,0.705166573024959,idf5e3678b,right_ankle,3.55841684341431,-1,-1,14142,108
2485,114,0.181861034927217,idf5e3678b,left_wrist,3.36536192893982,-2,-3,2483,113
2483,114,0.265647283491631,idf5e3678b,left_hip,3.18920302391052,0,-1,2483,113
2481,115,0.587253509412763,idf5e3678b,left_ankle,3.27432608604431,2,0,2483,113
2484,113,0.672077859063041,idf5e3678b,right_ankle,3.55841684341431,-1,-1,2483,113
4908,111,0.154714782513183,idf5e3678b,left_wrist,3.36536192893982,-9,-8,4899,112
4901,111,0.292257486671704,idf5e3678b,left_hip,3.18920302391052,-2,-1,4899,112
4899,112,0.611769737209019,idf5e3678b,left_ankle,3.27432608604431,0,0,4899,112
4900,112,0.633078972404653,idf5e3678b,right_ankle,3.55841684341431,-1,-1,4899,112
2933,113,0.192720059809826,idf5e3678b,left_wrist,3.36536192893982,-3,-5,2930,111
2931,111,0.331432101791382,idf5e3678b,left_hip,3.18920302391052,-1,-1,2930,111
2929,111,0.586208532779881,idf5e3678b,left_ankle,3.27432608604431,1,1,2930,111
2929,113,0.662503632306895,idf5e3678b,right_ankle,3.55841684341431,1,-1,2930,111
4794,115,0.146841227635357,idf5e3678b,left_wrist,3.36536192893982,-5,-9,4789,111
4791,111,0.28408370759559,idf5e3678b,left_hip,3.18920302391052,-2,-2,4789,111
4789,111,0.576334838223464,idf5e3678b,left_ankle,3.27432608604431,0,0,4789,111
4790,111,0.668291794108561,idf5e3678b,right_ankle,3.55841684341431,-1,-1,4789,111
1254,111,0.144339574040505,idf5e3678b,left_wrist,3.36536192893982,-4,-4,1250,111
1251,111,0.26637491191051,idf5e3678b,left_hip,3.18920302391052,-1,-1,1250,111
1250,110,0.628893139609465,idf5e3678b,left_ankle,3.27432608604431,0,1,1250,111
1250,111,0.63989976708912,idf5e3678b,right_ankle,3.55841684341431,0,0,1250,111
12740,107,0.151357220100506,idf5e3678b,left_wrist,3.36536192893982,-10,-9,12730,108
12730,110,0.309076349891827,idf5e3678b,left_hip,3.18920302391052,0,-2,12730,108
12731,108,0.64722465348215,idf5e3678b,left_ankle,3.27432608604431,-1,-1,12730,108
12730,108,0.73224427198849,idf5e3678b,right_ankle,3.55841684341431,0,0,12730,108
17425,108,0.215005713438689,idf5e3678b,left_wrist,3.36536192893982,-4,-5,17421,107
17422,108,0.339114573092541,idf5e3678b,left_hip,3.18920302391052,-1,-2,17421,107
17421,108,0.65408677068614,idf5e3678b,left_ankle,3.27432608604431,0,-1,17421,107
17421,108,0.711278163503773,idf5e3678b,right_ankle,3.55841684341431,0,-1,17421,107
15416,104,0.178513412176298,idf5e3678b,left_wrist,3.36536192893982,-10,-6,15406,108
15410,106,0.301734221863081,idf5e3678b,left_hip,3.18920302391052,-4,-2,15406,108
15408,107,0.659621099279551,idf5e3678b,left_ankle,3.27432608604431,-2,-1,15406,108
15406,106,0.664417159207789,idf5e3678b,right_ankle,3.55841684341431,0,2,15406,108
15834,104,0.208708594975152,idf5e3678b,left_wrist,3.36536192893982,-5,-4,15829,105
15830,106,0.344950843714215,idf5e3678b,left_hip,3.18920302391052,-1,-2,15829,105
15830,104,0.636202613304003,idf5e3678b,left_ankle,3.27432608604431,-1,0,15829,105
15827,106,0.727718799469107,idf5e3678b,right_ankle,3.55841684341431,2,1,15829,105
9017,118,0.124154399843695,idf5e3678b,left_wrist,3.36536192893982,-1,-11,9016,108
9016,109,0.27305021192549,idf5e3678b,left_hip,3.18920302391052,0,-1,9016,108
9017,107,0.599948177289898,idf5e3678b,left_ankle,3.27432608604431,-1,0,9016,108
9014,109,0.645709408746358,idf5e3678b,right_ankle,3.55841684341431,2,1,9016,108
8153,108,0.131878919090001,idf5e3678b,left_wrist,3.36536192893982,9,10,8162,109
8163,108,0.305130740807974,idf5e3678b,left_hip,3.18920302391052,-1,0,8162,109
8163,108,0.667672824801893,idf5e3678b,left_ankle,3.27432608604431,-1,0,8162,109
8160,109,0.747978531223259,idf5e3678b,right_ankle,3.55841684341431,2,2,8162,109
16045,106,0.197985720781197,idf5e3678b,left_wrist,3.36536192893982,-7,-4,16038,109
16041,107,0.326097096517419,idf5e3678b,left_hip,3.18920302391052,-3,-1,16038,109
16039,107,0.610189928836558,idf5e3678b,left_ankle,3.27432608604431,-1,1,16038,109
16039,106,0.733437218209289,idf5e3678b,right_ankle,3.55841684341431,-1,2,16038,109
12092,107,0.127804729469491,idf5e3678b,left_wrist,3.36536192893982,-9,-8,12083,108
12084,108,0.321434845105683,idf5e3678b,left_hip,3.18920302391052,-1,-1,12083,108
12082,109,0.658045047203603,idf5e3678b,left_ankle,3.27432608604431,1,0,12083,108
12082,109,0.74227802253072,idf5e3678b,right_ankle,3.55841684341431,1,0,12083,108
14694,104,0.121451915608604,id37a54bbf,left_wrist,4.42590093612671,-4,-4,14690,104
14687,104,0.239197466066051,id37a54bbf,left_hip,4.30150103569031,3,3,14690,104
14689,103,0.746237599168368,id37a54bbf,left_ankle,3.98938083648682,1,2,14690,104
14689,105,0.673804213283825,id37a54bbf,right_ankle,4.42314004898071,1,0,14690,104
7988,101,0.156376212224706,id37a54bbf,left_wrist,4.42590093612671,-4,-3,7984,102
7981,103,0.247223260001648,id37a54bbf,left_hip,4.30150103569031,3,2,7984,102
7979,105,0.653160478021331,id37a54bbf,left_ankle,3.98938083648682,5,2,7984,102
7982,104,0.679782440719541,id37a54bbf,right_ankle,4.42314004898071,2,0,7984,102
6135,102,0.127538262214403,id37a54bbf,left_wrist,4.42590093612671,8,8,6143,102
6139,102,0.246933075902813,id37a54bbf,left_hip,4.30150103569031,4,4,6143,102
6141,101,0.741835950739534,id37a54bbf,left_ankle,3.98938083648682,2,3,6143,102
6138,103,0.656400393740564,id37a54bbf,right_ankle,4.42314004898071,5,4,6143,102
22286,103,0.119894876264316,id37a54bbf,left_wrist,4.42590093612671,-5,-4,22281,104
22278,104,0.254654326145079,id37a54bbf,left_hip,4.30150103569031,3,3,22281,104
22279,105,0.800267844314781,id37a54bbf,left_ankle,3.98938083648682,2,1,22281,104
22279,104,0.578628208045302,id37a54bbf,right_ankle,4.42314004898071,2,2,22281,104
14179,112,0.0982876916209594,id37a54bbf,left_wrist,4.42590093612671,3,-6,14182,103
14178,103,0.226587624696777,id37a54bbf,left_hip,4.30150103569031,4,4,14182,103
14180,104,0.802419094408565,id37a54bbf,left_ankle,3.98938083648682,2,1,14182,103
14179,104,0.667032346326668,id37a54bbf,right_ankle,4.42314004898071,3,2,14182,103
4835,88,0.0921239856227183,id37a54bbf,left_wrist,4.42590093612671,-5,8,4830,101
4826,102,0.252236681283137,id37a54bbf,left_hip,4.30150103569031,4,3,4830,101
4826,104,0.748625771097744,id37a54bbf,left_ankle,3.98938083648682,4,1,4830,101
4828,99,0.686467011601046,id37a54bbf,right_ankle,4.42314004898071,2,4,4830,101
3004,101,0.124765416506359,id37a54bbf,left_wrist,4.42590093612671,8,8,3012,101
3007,102,0.254024648861958,id37a54bbf,left_hip,4.30150103569031,5,4,3012,101
3010,102,0.698804022951006,id37a54bbf,left_ankle,3.98938083648682,2,1,3012,101
3007,102,0.642767801858627,id37a54bbf,right_ankle,4.42314004898071,5,4,3012,101
10742,101,0.108215191036384,id37a54bbf,left_wrist,4.42590093612671,-6,-6,10736,101
10732,103,0.253508925321353,id37a54bbf,left_hip,4.30150103569031,4,2,10736,101
10735,101,0.831307621122081,id37a54bbf,left_ankle,3.98938083648682,1,1,10736,101
10735,103,0.712049386075465,id37a54bbf,right_ankle,4.42314004898071,1,-1,10736,101
20660,104,0.124032100877979,id37a54bbf,left_wrist,4.42590093612671,-5,-6,20655,103
20656,99,0.231721589060521,id37a54bbf,left_hip,4.30150103569031,-1,3,20655,103
20653,104,0.714960653965787,id37a54bbf,left_ankle,3.98938083648682,2,1,20655,103
20656,99,0.590622062811992,id37a54bbf,right_ankle,4.42314004898071,-1,3,20655,103
13465,111,0.127657564288607,id37a54bbf,left_wrist,4.42590093612671,7,-1,13472,103
13468,103,0.23646428470806,id37a54bbf,left_hip,4.30150103569031,4,4,13472,103
13470,103,0.723157421895238,id37a54bbf,left_ankle,3.98938083648682,2,2,13472,103
13469,101,0.603719837920554,id37a54bbf,right_ankle,4.42314004898071,3,5,13472,103
21876,103,0.101989041405879,id37a54bbf,left_wrist,4.42590093612671,-4,-5,21872,102
21869,101,0.246930360894703,id37a54bbf,left_hip,4.30150103569031,3,4,21872,102
21868,104,0.787386189279498,id37a54bbf,left_ankle,3.98938083648682,4,2,21872,102
21869,104,0.626830404766401,id37a54bbf,right_ankle,4.42314004898071,3,1,21872,102
16408,50,0.128684564256095,id37a54bbf,left_wrist,4.42590093612671,4,57,16412,103
16408,103,0.217116870159438,id37a54bbf,left_hip,4.30150103569031,4,4,16412,103
16411,102,0.796874450285047,id37a54bbf,left_ankle,3.98938083648682,1,2,16412,103
16410,102,0.676772176526472,id37a54bbf,right_ankle,4.42314004898071,2,3,16412,103
8088,105,0.127895380146608,id37a54bbf,left_wrist,4.42590093612671,-3,-5,8085,103
8083,100,0.262323936856494,id37a54bbf,left_hip,4.30150103569031,2,5,8085,103
8083,103,0.735127741096164,id37a54bbf,left_ankle,3.98938083648682,2,2,8085,103
8085,100,0.695485742237056,id37a54bbf,right_ankle,4.42314004898071,0,3,8085,103
9716,101,0.101952960844546,id37a54bbf,left_wrist,4.42590093612671,-4,-2,9712,103
9709,103,0.251443888600802,id37a54bbf,left_hip,4.30150103569031,3,3,9712,103
9711,99,0.682737305289575,id37a54bbf,left_ankle,3.98938083648682,1,5,9712,103
9709,104,0.644538650772497,id37a54bbf,right_ankle,4.42314004898071,3,2,9712,103
3410,111,0.133834372085036,id37a54bbf,left_wrist,4.42590093612671,7,-1,3417,103
3414,102,0.243621905683139,id37a54bbf,left_hip,4.30150103569031,3,4,3417,103
3413,105,0.779468295834834,id37a54bbf,left_ankle,3.98938083648682,4,2,3417,103
3414,102,0.650969971647722,id37a54bbf,right_ankle,4.42314004898071,3,4,3417,103
401,93,0.102476806951558,id37a54bbf,left_wrist,4.42590093612671,-10,-5,391,98
392,93,0.295242549725917,id37a54bbf,left_hip,4.30150103569031,-1,4,391,98
387,100,0.860708540972567,id37a54bbf,left_ankle,3.98938083648682,4,2,391,98
387,101,0.824593946770993,id37a54bbf,right_ankle,4.42314004898071,4,1,391,98
15961,155,0.259971029994043,id37a54bbf,left_wrist,4.42590093612671,48,-6,16009,101
16005,102,0.239673047031476,id37a54bbf,left_hip,4.30150103569031,4,3,16009,101
16008,102,0.729517291912689,id37a54bbf,left_ankle,3.98938083648682,1,0,16009,101
16006,105,0.684381940057587,id37a54bbf,right_ankle,4.42314004898071,3,-1,16009,101
2404,94,0.114055065992851,id37a54bbf,left_wrist,4.42590093612671,0,7,2404,101
2400,102,0.249997673319862,id37a54bbf,left_hip,4.30150103569031,4,3,2404,101
2400,102,0.668687656047456,id37a54bbf,left_ankle,3.98938083648682,4,3,2404,101
2400,102,0.662334164209888,id37a54bbf,right_ankle,4.42314004898071,4,3,2404,101
10026,103,0.0933104397159814,id37a54bbf,left_wrist,4.42590093612671,-6,-4,10020,105
10017,105,0.247354955672818,id37a54bbf,left_hip,4.30150103569031,3,3,10020,105
10020,104,0.801230019286942,id37a54bbf,left_ankle,3.98938083648682,0,1,10020,105
10019,105,0.668915443519795,id37a54bbf,right_ankle,4.42314004898071,1,1,10020,105
14389,101,0.122363140421938,id37a54bbf,left_wrist,4.42590093612671,-3,-3,14386,101
14383,102,0.25074492561466,id37a54bbf,left_hip,4.30150103569031,3,2,14386,101
14381,105,0.64491416666088,id37a54bbf,left_ankle,3.98938083648682,5,1,14386,101
14383,104,0.660620467367025,id37a54bbf,right_ankle,4.42314004898071,3,0,14386,101
17387,96,0.214173935817956,id3e3e50c7,left_wrist,3.02282500267029,1,-2,17388,93
17390,94,0.379034661233319,id3e3e50c7,left_hip,2.95024609565735,-2,-3,17388,93
17386,95,0.714199672980492,id3e3e50c7,left_ankle,2.98245406150818,2,0,17388,93
17387,94,0.734584833872353,id3e3e50c7,right_ankle,3.08646583557129,1,0,17388,93
8649,94,0.220702551016347,id3e3e50c7,left_wrist,3.02282500267029,1,1,8650,94
8652,93,0.364806931980657,id3e3e50c7,left_hip,2.95024609565735,-2,-1,8650,94
8649,94,0.686699530406365,id3e3e50c7,left_ankle,2.98245406150818,1,1,8650,94
8647,93,0.764397717426689,id3e3e50c7,right_ankle,3.08646583557129,3,4,8650,94
8465,93,0.200868117699434,id3e3e50c7,left_wrist,3.02282500267029,2,1,8467,92
8468,93,0.360840268698452,id3e3e50c7,left_hip,2.95024609565735,-1,-2,8467,92
8465,94,0.745297406697622,id3e3e50c7,left_ankle,2.98245406150818,2,0,8467,92
8463,93,0.784003589402041,id3e3e50c7,right_ankle,3.08646583557129,4,3,8467,92
3095,95,0.184769849267215,id3e3e50c7,left_wrist,3.02282500267029,3,2,3098,94
3098,94,0.360219512151136,id3e3e50c7,left_hip,2.95024609565735,0,0,3098,94
3096,95,0.725176392389054,id3e3e50c7,left_ankle,2.98245406150818,2,1,3098,94
3092,95,0.765216747058954,id3e3e50c7,right_ankle,3.08646583557129,6,5,3098,94
13112,87,0.202816204017116,id3e3e50c7,left_wrist,3.02282500267029,-1,3,13111,91
13114,91,0.398011310697476,id3e3e50c7,left_hip,2.95024609565735,-3,-3,13111,91
13110,90,0.699878482937658,id3e3e50c7,left_ankle,2.98245406150818,1,2,13111,91
13108,94,0.755518621397627,id3e3e50c7,right_ankle,3.08646583557129,3,0,13111,91
7910,90,0.188975872795031,id3e3e50c7,left_wrist,3.02282500267029,1,4,7911,93
7913,93,0.324839182939645,id3e3e50c7,left_hip,2.95024609565735,-2,-2,7911,93
7909,93,0.682235833171116,id3e3e50c7,left_ankle,2.98245406150818,2,2,7911,93
7908,94,0.758452759689456,id3e3e50c7,right_ankle,3.08646583557129,3,2,7911,93
8929,90,0.259479496200895,id3e3e50c7,left_wrist,3.02282500267029,0,2,8929,92
8931,91,0.38696387590083,id3e3e50c7,left_hip,2.95024609565735,-2,-1,8929,92
8926,92,0.73355914738986,id3e3e50c7,left_ankle,2.98245406150818,3,3,8929,92
8926,91,0.762016647913599,id3e3e50c7,right_ankle,3.08646583557129,3,4,8929,92
3661,90,0.190705455997873,id3e3e50c7,left_wrist,3.02282500267029,0,4,3661,94
3662,93,0.389141626040515,id3e3e50c7,left_hip,2.95024609565735,-1,0,3661,94
3660,93,0.786718000532759,id3e3e50c7,left_ankle,2.98245406150818,1,2,3661,94
3657,94,0.734866736198595,id3e3e50c7,right_ankle,3.08646583557129,4,4,3661,94
4032,98,0.216582180091161,id3e3e50c7,left_wrist,3.02282500267029,3,-1,4035,94
4035,94,0.391145233609131,id3e3e50c7,left_hip,2.95024609565735,0,0,4035,94
4033,95,0.740955009667904,id3e3e50c7,left_ankle,2.98245406150818,2,1,4035,94
4029,93,0.749262861015837,id3e3e50c7,right_ankle,3.08646583557129,6,7,4035,94
10382,90,0.208319117319693,id3e3e50c7,left_wrist,3.02282500267029,-1,2,10381,93
10383,92,0.402035524785535,id3e3e50c7,left_hip,2.95024609565735,-2,-1,10381,93
10380,92,0.730958851076064,id3e3e50c7,left_ankle,2.98245406150818,1,2,10381,93
10379,91,0.802075215052368,id3e3e50c7,right_ankle,3.08646583557129,2,4,10381,93
10104,86,0.20814775956932,id3e3e50c7,left_wrist,3.02282500267029,0,7,10104,93
10106,93,0.388664005019666,id3e3e50c7,left_hip,2.95024609565735,-2,-2,10104,93
10103,93,0.658516755346182,id3e3e50c7,left_ankle,2.98245406150818,1,1,10104,93
10101,95,0.759330945626074,id3e3e50c7,right_ankle,3.08646583557129,3,1,10104,93
1405,94,0.168845094042813,id3e3e50c7,left_wrist,3.02282500267029,1,2,1406,95
1407,94,0.404981009346277,id3e3e50c7,left_hip,2.95024609565735,-1,0,1406,95
1406,95,0.807550469782334,id3e3e50c7,left_ankle,2.98245406150818,0,0,1406,95
1404,93,0.758700191386043,id3e3e50c7,right_ankle,3.08646583557129,2,4,1406,95
649,95,0.198784683200305,id3e3e50c7,left_wrist,3.02282500267029,2,1,651,94
652,95,0.356175076528226,id3e3e50c7,left_hip,2.95024609565735,-1,-2,651,94
649,95,0.647018039667034,id3e3e50c7,left_ankle,2.98245406150818,2,1,651,94
647,96,0.736250273563624,id3e3e50c7,right_ankle,3.08646583557129,4,2,651,94
11196,89,0.228618907500741,id3e3e50c7,left_wrist,3.02282500267029,1,2,11197,90
11198,91,0.385532897909742,id3e3e50c7,left_hip,2.95024609565735,-1,-2,11197,90
11195,90,0.690427270906314,id3e3e50c7,left_ankle,2.98245406150818,2,2,11197,90
11194,92,0.806988458386181,id3e3e50c7,right_ankle,3.08646583557129,3,1,11197,90
16110,92,0.235859788601193,id3e3e50c7,left_wrist,3.02282500267029,1,0,16111,91
16113,91,0.415320581068287,id3e3e50c7,left_hip,2.95024609565735,-2,-2,16111,91
16109,91,0.728296254136182,id3e3e50c7,left_ankle,2.98245406150818,2,2,16111,91
16110,91,0.800413620275905,id3e3e50c7,right_ankle,3.08646583557129,1,1,16111,91
10471,91,0.214478648004866,id3e3e50c7,left_wrist,3.02282500267029,2,3,10473,92
10474,92,0.391166233816709,id3e3e50c7,left_hip,2.95024609565735,-1,-1,10473,92
10471,92,0.683573927298205,id3e3e50c7,left_ankle,2.98245406150818,2,2,10473,92
10469,95,0.794242182000965,id3e3e50c7,right_ankle,3.08646583557129,4,1,10473,92
9740,95,0.214664380861959,id3e3e50c7,left_wrist,3.02282500267029,2,-2,9742,91
9744,91,0.388894327365979,id3e3e50c7,left_hip,2.95024609565735,-2,-2,9742,91
9740,92,0.787216332700314,id3e3e50c7,left_ankle,2.98245406150818,2,1,9742,91
9738,92,0.775877014745584,id3e3e50c7,right_ankle,3.08646583557129,4,3,9742,91
9199,92,0.199767536531649,id3e3e50c7,left_wrist,3.02282500267029,1,1,9200,92
9203,91,0.402210057541938,id3e3e50c7,left_hip,2.95024609565735,-3,-2,9200,92
9197,93,0.756911370972344,id3e3e50c7,left_ankle,2.98245406150818,3,2,9200,92
9199,91,0.706268847634699,id3e3e50c7,right_ankle,3.08646583557129,1,2,9200,92
17112,92,0.17789424206991,id3e3e50c7,left_wrist,3.02282500267029,1,0,17113,91
17115,92,0.389602146314426,id3e3e50c7,left_hip,2.95024609565735,-2,-3,17113,91
17112,91,0.738818571842315,id3e3e50c7,left_ankle,2.98245406150818,1,1,17113,91
17112,91,0.761337517756554,id3e3e50c7,right_ankle,3.08646583557129,1,1,17113,91
8929,90,0.259479496200895,id3e3e50c7,left_wrist,3.02282500267029,0,2,8929,92
8931,91,0.38696387590083,id3e3e50c7,left_hip,2.95024609565735,-2,-1,8929,92
8926,92,0.73355914738986,id3e3e50c7,left_ankle,2.98245406150818,3,3,8929,92
8926,91,0.762016647913599,id3e3e50c7,right_ankle,3.08646583557129,3,4,8929,92
15082,97,0.175142830573836,idf1ce9a0f,left_wrist,4.72722697257996,-3,-5,15079,95
15076,98,0.245543868538881,idf1ce9a0f,left_hip,4.27627801895142,3,0,15079,95
15077,98,0.949862790262624,idf1ce9a0f,left_ankle,4.65261197090149,2,-1,15079,95
15079,97,0.764667223773105,idf1ce9a0f,right_ankle,4.25773596763611,0,-2,15079,95
13358,96,0.16364101521673,idf1ce9a0f,left_wrist,4.72722697257996,-5,-3,13353,98
13352,96,0.251856771407755,idf1ce9a0f,left_hip,4.27627801895142,1,3,13353,98
13352,98,0.985703413526277,idf1ce9a0f,left_ankle,4.65261197090149,1,1,13353,98
13354,97,0.80984158930379,idf1ce9a0f,right_ankle,4.25773596763611,-1,0,13353,98
5316,97,0.109776704199309,idf1ce9a0f,left_wrist,4.72722697257996,-5,-6,5311,96
5309,98,0.236745418969409,idf1ce9a0f,left_hip,4.27627801895142,2,0,5311,96
5309,98,0.891356498581029,idf1ce9a0f,left_ankle,4.65261197090149,2,0,5311,96
5311,98,0.691510988875453,idf1ce9a0f,right_ankle,4.25773596763611,0,-2,5311,96
5804,101,0.13703054081031,idf1ce9a0f,left_wrist,4.72722697257996,-6,-9,5798,98
5796,100,0.226485866908817,idf1ce9a0f,left_hip,4.27627801895142,2,0,5798,98
5796,100,0.962652593072963,idf1ce9a0f,left_ankle,4.65261197090149,2,0,5798,98
5799,100,0.674617804785075,idf1ce9a0f,right_ankle,4.25773596763611,-1,-3,5798,98
16134,95,0.258485043985675,idf1ce9a0f,left_wrist,4.72722697257996,-7,-6,16127,96
16126,96,0.30396428128371,idf1ce9a0f,left_hip,4.27627801895142,1,1,16127,96
16128,95,0.907281953523928,idf1ce9a0f,left_ankle,4.65261197090149,-1,0,16127,96
16128,96,0.7960070830105,idf1ce9a0f,right_ankle,4.25773596763611,-1,-1,16127,96
10084,96,0.257495255010296,idf1ce9a0f,left_wrist,4.72722697257996,2,3,10086,97
10085,96,0.252839536843085,idf1ce9a0f,left_hip,4.27627801895142,1,2,10086,97
10086,97,0.908315488253933,idf1ce9a0f,left_ankle,4.65261197090149,0,0,10086,97
10087,97,0.739403838490622,idf1ce9a0f,right_ankle,4.25773596763611,-1,-1,10086,97
3950,88,0.126642096390235,idf1ce9a0f,left_wrist,4.72722697257996,-9,1,3941,98
3941,98,0.254174056159361,idf1ce9a0f,left_hip,4.27627801895142,0,0,3941,98
3940,98,0.970578630779868,idf1ce9a0f,left_ankle,4.65261197090149,1,1,3941,98
3942,99,0.748270970137014,idf1ce9a0f,right_ankle,4.25773596763611,-1,-2,3941,98
16508,99,0.210585800682344,idf1ce9a0f,left_wrist,4.72722697257996,-6,-10,16502,95
16503,94,0.287962582000031,idf1ce9a0f,left_hip,4.27627801895142,-1,0,16502,95
16504,95,0.797462433864672,idf1ce9a0f,left_ankle,4.65261197090149,-2,-2,16502,95
16506,94,0.803036648087224,idf1ce9a0f,right_ankle,4.25773596763611,-4,-3,16502,95
2397,96,0.150725285366006,idf1ce9a0f,left_wrist,4.72722697257996,-6,-6,2391,96
2391,95,0.253506195198031,idf1ce9a0f,left_hip,4.27627801895142,0,1,2391,96
2391,96,1.01385996251026,idf1ce9a0f,left_ankle,4.65261197090149,0,0,2391,96
2391,98,0.795669269595889,idf1ce9a0f,right_ankle,4.25773596763611,0,-2,2391,96
19146,71,0.22548864558055,idf1ce9a0f,left_wrist,4.72722697257996,-24,-2,19122,93
19120,95,0.303578943545697,idf1ce9a0f,left_hip,4.27627801895142,2,0,19122,93
19123,95,0.938533164996139,idf1ce9a0f,left_ankle,4.65261197090149,-1,-3,19122,93
19123,95,0.803703383264282,idf1ce9a0f,right_ankle,4.25773596763611,-1,-3,19122,93
13647,96,0.209551572782448,idf1ce9a0f,left_wrist,4.72722697257996,-8,-5,13639,99
13641,96,0.264375090425757,idf1ce9a0f,left_hip,4.27627801895142,-2,1,13639,99
13641,97,0.864620625893642,idf1ce9a0f,left_ankle,4.65261197090149,-2,0,13639,99
13644,95,0.758953531983189,idf1ce9a0f,right_ankle,4.25773596763611,-5,-1,13639,99
12392,97,0.243963416678889,idf1ce9a0f,left_wrist,4.72722697257996,-6,-4,12386,99
12385,97,0.269004721732321,idf1ce9a0f,left_hip,4.27627801895142,1,3,12386,99
12386,97,0.929358360738736,idf1ce9a0f,left_ankle,4.65261197090149,0,2,12386,99
12387,97,0.71535770656368,idf1ce9a0f,right_ankle,4.25773596763611,-1,1,12386,99
7374,98,0.142391925792849,idf1ce9a0f,left_wrist,4.72722697257996,-6,-5,7368,99
7368,99,0.228605625810541,idf1ce9a0f,left_hip,4.27627801895142,0,0,7368,99
7369,98,0.917009121119014,idf1ce9a0f,left_ankle,4.65261197090149,-1,0,7368,99
7370,100,0.719635522113656,idf1ce9a0f,right_ankle,4.25773596763611,-2,-3,7368,99
10084,96,0.257495255010296,idf1ce9a0f,left_wrist,4.72722697257996,2,3,10086,97
10085,96,0.252839536843085,idf1ce9a0f,left_hip,4.27627801895142,1,2,10086,97
10086,97,0.908315488253933,idf1ce9a0f,left_ankle,4.65261197090149,0,0,10086,97
10087,97,0.739403838490622,idf1ce9a0f,right_ankle,4.25773596763611,-1,-1,10086,97
11158,87,0.279034329930612,idf1ce9a0f,left_wrist,4.72722697257996,-12,-1,11146,98
11143,98,0.241275554821708,idf1ce9a0f,left_hip,4.27627801895142,3,3,11146,98
11144,98,0.90527633700555,idf1ce9a0f,left_ankle,4.65261197090149,2,2,11146,98
11147,97,0.783662259321642,idf1ce9a0f,right_ankle,4.25773596763611,-1,0,11146,98
4047,99,0.152737432227626,idf1ce9a0f,left_wrist,4.72722697257996,-9,-8,4038,100
4038,100,0.245131026164664,idf1ce9a0f,left_hip,4.27627801895142,0,0,4038,100
4037,101,0.892921063531608,idf1ce9a0f,left_ankle,4.65261197090149,1,0,4038,100
4040,101,0.764904951995505,idf1ce9a0f,right_ankle,4.25773596763611,-2,-3,4038,100
11723,100,0.2435245777967,idf1ce9a0f,left_wrist,4.72722697257996,-4,-7,11719,97
11718,96,0.267070785077507,idf1ce9a0f,left_hip,4.27627801895142,1,2,11719,97
11719,96,0.918755268011158,idf1ce9a0f,left_ankle,4.65261197090149,0,1,11719,97
11721,97,0.725311252101514,idf1ce9a0f,right_ankle,4.25773596763611,-2,-2,11719,97
1717,65,0.163728580566777,idf1ce9a0f,left_wrist,4.72722697257996,-7,25,1710,97
1708,99,0.222038388902724,idf1ce9a0f,left_hip,4.27627801895142,2,0,1710,97
1709,99,0.933609332020166,idf1ce9a0f,left_ankle,4.65261197090149,1,-1,1710,97
1711,98,0.746177573015872,idf1ce9a0f,right_ankle,4.25773596763611,-1,-2,1710,97
6193,100,0.147025174080964,idf1ce9a0f,left_wrist,4.72722697257996,-4,-6,6189,98
6187,99,0.230803173522606,idf1ce9a0f,left_hip,4.27627801895142,2,1,6189,98
6187,99,0.936969034839856,idf1ce9a0f,left_ankle,4.65261197090149,2,1,6189,98
6188,100,0.66517906040607,idf1ce9a0f,right_ankle,4.25773596763611,1,-1,6189,98
4734,95,0.121864755767745,idf1ce9a0f,left_wrist,4.72722697257996,-6,-2,4728,99
4727,97,0.276572502527938,idf1ce9a0f,left_hip,4.27627801895142,1,3,4728,99
4727,97,0.878475127832314,idf1ce9a0f,left_ankle,4.65261197090149,1,3,4728,99
4729,97,0.758571689620312,idf1ce9a0f,right_ankle,4.25773596763611,-1,1,4728,99
6145,117,0.15153717814389,idecc9265e,left_wrist,3.70260190963745,6,3,6151,114
6149,115,0.243317189097017,idecc9265e,left_hip,3.59471487998962,2,1,6151,114
6146,115,0.618286920645257,idecc9265e,left_ankle,3.80265402793884,5,4,6151,114
6145,115,0.672905029686522,idecc9265e,right_ankle,3.4446439743042,6,5,6151,114
18996,113,0.189539535389013,idecc9265e,left_wrist,3.70260190963745,-8,-9,18988,112
18995,112,0.259330365733792,idecc9265e,left_hip,3.59471487998962,-7,-7,18988,112
18992,112,0.627272813349313,idecc9265e,left_ankle,3.80265402793884,-4,-4,18988,112
18992,112,0.73080114775539,idecc9265e,right_ankle,3.4446439743042,-4,-4,18988,112
9602,58,0.141885815286675,idecc9265e,left_wrist,3.70260190963745,-14,49,9588,121
9593,123,0.189326612277997,idecc9265e,left_hip,3.59471487998962,-5,-7,9588,121
9594,118,0.587278211649259,idecc9265e,left_ankle,3.80265402793884,-6,-3,9588,121
9588,122,0.558961799173549,idecc9265e,right_ankle,3.4446439743042,0,-1,9588,121
16638,117,0.233547458173258,idecc9265e,left_wrist,3.70260190963745,-10,-14,16628,113
16635,113,0.22930734965779,idecc9265e,left_hip,3.59471487998962,-7,-7,16628,113
16631,119,0.634297510274717,idecc9265e,left_ankle,3.80265402793884,-3,-9,16628,113
16631,114,0.758279939820466,idecc9265e,right_ankle,3.4446439743042,-3,-4,16628,113
18886,111,0.234432474185631,idecc9265e,left_wrist,3.70260190963745,-9,-8,18877,112
18883,113,0.254420948688021,idecc9265e,left_hip,3.59471487998962,-6,-7,18877,112
18880,113,0.64450814469905,idecc9265e,left_ankle,3.80265402793884,-3,-4,18877,112
18880,113,0.650686531943421,idecc9265e,right_ankle,3.4446439743042,-3,-4,18877,112
8887,123,0.214382967314702,idecc9265e,left_wrist,3.70260190963745,-2,-8,8885,117
8889,118,0.232766067932325,idecc9265e,left_hip,3.59471487998962,-4,-5,8885,117
8889,117,0.660125272607711,idecc9265e,left_ankle,3.80265402793884,-4,-4,8885,117
8887,117,0.674891361978489,idecc9265e,right_ankle,3.4446439743042,-2,-2,8885,117
1374,112,0.176706826534305,idecc9265e,left_wrist,3.70260190963745,-13,-10,1361,115
1367,116,0.213726068414378,idecc9265e,left_hip,3.59471487998962,-6,-7,1361,115
1365,115,0.619796003217799,idecc9265e,left_ankle,3.80265402793884,-4,-4,1361,115
1366,114,0.699363863860356,idecc9265e,right_ankle,3.4446439743042,-5,-4,1361,115
7185,117,0.154974424187286,idecc9265e,left_wrist,3.70260190963745,-9,-11,7176,115
7183,114,0.236532004660173,idecc9265e,left_hip,3.59471487998962,-7,-6,7176,115
7179,116,0.63995777229149,idecc9265e,left_ankle,3.80265402793884,-3,-4,7176,115
7179,115,0.733570576292982,idecc9265e,right_ankle,3.4446439743042,-3,-3,7176,115
15502,115,0.212002956047241,idecc9265e,left_wrist,3.70260190963745,-9,-9,15493,115
15499,117,0.243834075500689,idecc9265e,left_hip,3.59471487998962,-6,-8,15493,115
15497,115,0.65081879771298,idecc9265e,left_ankle,3.80265402793884,-4,-4,15493,115
15496,116,0.733624475273666,idecc9265e,right_ankle,3.4446439743042,-3,-4,15493,115
7301,115,0.136017674216843,idecc9265e,left_wrist,3.70260190963745,-11,-11,7290,115
7296,116,0.202301240677145,idecc9265e,left_hip,3.59471487998962,-6,-7,7290,115
7294,116,0.62479933123002,idecc9265e,left_ankle,3.80265402793884,-4,-5,7290,115
7293,116,0.708232168006251,idecc9265e,right_ankle,3.4446439743042,-3,-4,7290,115
13593,111,0.189323393367801,idecc9265e,left_wrist,3.70260190963745,-11,-7,13582,115
13587,116,0.232631395704126,idecc9265e,left_hip,3.59471487998962,-5,-6,13582,115
13586,115,0.659382088560379,idecc9265e,left_ankle,3.80265402793884,-4,-4,13582,115
13584,115,0.637644814128379,idecc9265e,right_ankle,3.4446439743042,-2,-2,13582,115
17875,114,0.230237282842459,idecc9265e,left_wrist,3.70260190963745,-8,-9,17867,113
17874,113,0.2602146953048,idecc9265e,left_hip,3.59471487998962,-7,-7,17867,113
17870,113,0.662316973507995,idecc9265e,left_ankle,3.80265402793884,-3,-3,17867,113
17871,113,0.720899120161702,idecc9265e,right_ankle,3.4446439743042,-4,-4,17867,113
18209,116,0.178029046755235,idecc9265e,left_wrist,3.70260190963745,-7,-9,18202,114
18209,112,0.241976051644949,idecc9265e,left_hip,3.59471487998962,-7,-5,18202,114
18205,117,0.636667390280478,idecc9265e,left_ankle,3.80265402793884,-3,-6,18202,114
18206,113,0.723494914726497,idecc9265e,right_ankle,3.4446439743042,-4,-3,18202,114
8325,110,0.181296464743777,idecc9265e,left_wrist,3.70260190963745,-9,-5,8316,114
8321,116,0.249849397346397,idecc9265e,left_hip,3.59471487998962,-5,-7,8316,114
8319,114,0.595711925266559,idecc9265e,left_ankle,3.80265402793884,-3,-3,8316,114
8319,114,0.669429449760579,idecc9265e,right_ankle,3.4446439743042,-3,-3,8316,114
8208,118,0.143269325908485,idecc9265e,left_wrist,3.70260190963745,-7,-9,8201,116
8207,115,0.218221732329344,idecc9265e,left_hip,3.59471487998962,-6,-5,8201,116
8205,115,0.64187913188325,idecc9265e,left_ankle,3.80265402793884,-4,-3,8201,116
8203,117,0.725780042211618,idecc9265e,right_ankle,3.4446439743042,-2,-3,8201,116
19108,118,0.204918191666542,idecc9265e,left_wrist,3.70260190963745,-9,-11,19099,116
19106,115,0.231238829554009,idecc9265e,left_hip,3.59471487998962,-7,-6,19099,116
19103,116,0.607645804336104,idecc9265e,left_ankle,3.80265402793884,-4,-4,19099,116
19103,114,0.683678929860213,idecc9265e,right_ankle,3.4446439743042,-4,-2,19099,116
13703,109,0.146922618882003,idecc9265e,left_wrist,3.70260190963745,-7,-4,13696,112
13702,112,0.221427387255933,idecc9265e,left_hip,3.59471487998962,-6,-6,13696,112
13700,110,0.593941517720189,idecc9265e,left_ankle,3.80265402793884,-4,-2,13696,112
13698,114,0.706055718260139,idecc9265e,right_ankle,3.4446439743042,-2,-4,13696,112
15841,115,0.204810088829476,idecc9265e,left_wrist,3.70260190963745,-9,-10,15832,114
15840,114,0.237036276885601,idecc9265e,left_hip,3.59471487998962,-8,-8,15832,114
15836,114,0.576029627336365,idecc9265e,left_ankle,3.80265402793884,-4,-4,15832,114
15836,115,0.675115077348754,idecc9265e,right_ankle,3.4446439743042,-4,-5,15832,114
12910,116,0.164043117896553,idecc9265e,left_wrist,3.70260190963745,-11,-11,12899,116
12907,114,0.233173011047036,idecc9265e,left_hip,3.59471487998962,-8,-6,12899,116
12903,116,0.625781831530231,idecc9265e,left_ankle,3.80265402793884,-4,-4,12899,116
12903,116,0.674038224450087,idecc9265e,right_ankle,3.4446439743042,-4,-4,12899,116
19225,113,0.178465764344317,idecc9265e,left_wrist,3.70260190963745,-11,-10,19214,114
19220,114,0.245001510565002,idecc9265e,left_hip,3.59471487998962,-6,-6,19214,114
19218,113,0.641521742534278,idecc9265e,left_ankle,3.80265402793884,-4,-3,19214,114
19216,115,0.659832496307053,idecc9265e,right_ankle,3.4446439743042,-2,-3,19214,114
5804,102,0.131511706292361,id687ab496,left_wrist,3.51325106620789,-4,-4,5800,102
5791,109,0.281904594248442,id687ab496,left_hip,3.80509305000305,9,2,5800,102
5796,103,0.750287848691574,id687ab496,left_ankle,3.39648008346558,4,3,5800,102
5797,103,0.724743175466827,id687ab496,right_ankle,3.32333207130432,3,2,5800,102
3786,104,0.130596915703485,id687ab496,left_wrist,3.51325106620789,4,1,3790,101
3787,103,0.276948591970261,id687ab496,left_hip,3.80509305000305,3,1,3790,101
3784,103,0.756997734468092,id687ab496,left_ankle,3.39648008346558,6,4,3790,101
3787,100,0.670901157744728,id687ab496,right_ankle,3.32333207130432,3,4,3790,101
17425,106,0.330184323633625,id687ab496,left_wrist,3.51325106620789,45,40,17470,101
17469,102,0.277609525896147,id687ab496,left_hip,3.80509305000305,1,0,17470,101
17469,102,0.738620012213339,id687ab496,left_ankle,3.39648008346558,1,0,17470,101
17469,101,0.686521637611071,id687ab496,right_ankle,3.32333207130432,1,1,17470,101
9959,99,0.222873032764328,id687ab496,left_wrist,3.51325106620789,-3,-1,9956,101
9956,100,0.328109492233342,id687ab496,left_hip,3.80509305000305,0,1,9956,101
9952,104,0.724377374993904,id687ab496,left_ankle,3.39648008346558,4,1,9956,101
9954,99,0.609432932964694,id687ab496,right_ankle,3.32333207130432,2,4,9956,101
17228,104,0.209375923897037,id687ab496,left_wrist,3.51325106620789,44,39,17272,99
17271,101,0.329729733449395,id687ab496,left_hip,3.80509305000305,1,-1,17272,99
17271,100,0.759665809681359,id687ab496,left_ankle,3.39648008346558,1,0,17272,99
17270,98,0.682178631863264,id687ab496,right_ankle,3.32333207130432,2,3,17272,99
3786,104,0.130596915703485,id687ab496,left_wrist,3.51325106620789,3,1,3789,102
3787,103,0.276948591970261,id687ab496,left_hip,3.80509305000305,2,1,3789,102
3784,103,0.756997734468092,id687ab496,left_ankle,3.39648008346558,5,4,3789,102
3787,100,0.670901157744728,id687ab496,right_ankle,3.32333207130432,2,4,3789,102
14916,99,0.247042099911704,id687ab496,left_wrist,3.51325106620789,44,45,14960,100
14961,99,0.313178075279205,id687ab496,left_hip,3.80509305000305,-1,0,14960,100
14959,101,0.704772554641591,id687ab496,left_ankle,3.39648008346558,1,0,14960,100
14957,100,0.702413899437344,id687ab496,right_ankle,3.32333207130432,3,3,14960,100
14264,56,0.130165777944792,id687ab496,left_wrist,3.51325106620789,2,45,14266,99
14265,100,0.295450511084787,id687ab496,left_hip,3.80509305000305,1,0,14266,99
14265,101,0.793100353366188,id687ab496,left_ankle,3.39648008346558,1,-1,14266,99
14262,99,0.674467276776284,id687ab496,right_ankle,3.32333207130432,4,4,14266,99
18524,100,0.244013721892226,id687ab496,left_wrist,3.51325106620789,45,46,18569,101
18569,101,0.334593345950234,id687ab496,left_hip,3.80509305000305,0,0,18569,101
18569,100,0.791433819122403,id687ab496,left_ankle,3.39648008346558,0,1,18569,101
18566,101,0.589205963123798,id687ab496,right_ankle,3.32333207130432,3,3,18569,101
10858,106,0.186043799250399,id687ab496,left_wrist,3.51325106620789,2,-2,10860,102
10858,102,0.254909455498444,id687ab496,left_hip,3.80509305000305,2,2,10860,102
10858,101,0.734119097467171,id687ab496,left_ankle,3.39648008346558,2,3,10860,102
10856,103,0.636906805909754,id687ab496,right_ankle,3.32333207130432,4,3,10860,102
14072,99,0.12771543076523,id687ab496,left_wrist,3.51325106620789,-3,-2,14069,100
14069,99,0.30501304774344,id687ab496,left_hip,3.80509305000305,0,1,14069,100
14069,99,0.775733800976634,id687ab496,left_ankle,3.39648008346558,0,1,14069,100
14065,99,0.666708266175406,id687ab496,right_ankle,3.32333207130432,4,5,14069,100
7729,60,0.182590139315548,id687ab496,left_wrist,3.51325106620789,-4,38,7725,102
7725,102,0.305363874424859,id687ab496,left_hip,3.80509305000305,0,0,7725,102
7722,102,0.77705510497902,id687ab496,left_ankle,3.39648008346558,3,3,7725,102
7723,101,0.611969107787716,id687ab496,right_ankle,3.32333207130432,2,3,7725,102
2176,104,0.180302267144971,id687ab496,left_wrist,3.51325106620789,1,0,2177,103
2176,102,0.287866973269563,id687ab496,left_hip,3.80509305000305,1,2,2177,103
2173,102,0.714782780290498,id687ab496,left_ankle,3.39648008346558,4,5,2177,103
2174,101,0.64429928793029,id687ab496,right_ankle,3.32333207130432,3,5,2177,103
18228,98,0.274384373988918,id687ab496,left_wrist,3.51325106620789,45,46,18273,99
18272,101,0.305528806873862,id687ab496,left_hip,3.80509305000305,1,-1,18273,99
18271,101,0.754008675198033,id687ab496,left_ankle,3.39648008346558,2,0,18273,99
18268,102,0.701503086705795,id687ab496,right_ankle,3.32333207130432,5,2,18273,99
5700,105,0.149501114310383,id687ab496,left_wrist,3.51325106620789,-3,-4,5697,104
5688,104,0.239769716380382,id687ab496,left_hip,3.80509305000305,9,9,5697,104
5693,104,0.798487215128928,id687ab496,left_ankle,3.39648008346558,4,4,5697,104
5696,102,0.645104536908321,id687ab496,right_ankle,3.32333207130432,1,3,5697,104
11756,103,0.147898580961112,id687ab496,left_wrist,3.51325106620789,2,1,11758,102
11758,102,0.266483388456928,id687ab496,left_hip,3.80509305000305,0,0,11758,102
11758,101,0.769624982165843,id687ab496,left_ankle,3.39648008346558,0,1,11758,102
11756,102,0.581680396410906,id687ab496,right_ankle,3.32333207130432,2,2,11758,102
2176,104,0.180302267144971,id687ab496,left_wrist,3.51325106620789,-5,-7,2171,102
2176,102,0.287866973269563,id687ab496,left_hip,3.80509305000305,-5,-5,2171,102
2173,102,0.714782780290498,id687ab496,left_ankle,3.39648008346558,-2,-2,2171,102
2174,101,0.64429928793029,id687ab496,right_ankle,3.32333207130432,-3,-2,2171,102
16520,107,0.247795116563635,id687ab496,left_wrist,3.51325106620789,43,39,16563,103
16564,102,0.281625406814181,id687ab496,left_hip,3.80509305000305,-1,0,16563,103
16560,103,0.738916538499626,id687ab496,left_ankle,3.39648008346558,3,3,16563,103
16561,103,0.684622447626815,id687ab496,right_ankle,3.32333207130432,2,2,16563,103
6265,105,0.266292842759827,id687ab496,left_wrist,3.51325106620789,50,46,6315,101
6312,103,0.305030165239336,id687ab496,left_hip,3.80509305000305,3,1,6315,101
6313,99,0.677163422863732,id687ab496,left_ankle,3.39648008346558,2,4,6315,101
6311,101,0.655070360643543,id687ab496,right_ankle,3.32333207130432,4,4,6315,101
15457,105,0.186887869242749,id687ab496,left_wrist,3.51325106620789,1,1,15458,105
15458,104,0.261630365604516,id687ab496,left_hip,3.80509305000305,0,1,15458,105
15455,105,0.672984896314717,id687ab496,left_ankle,3.39648008346558,3,3,15458,105
15458,100,0.654348010984137,id687ab496,right_ankle,3.32333207130432,0,5,15458,105
6046,103,0.201773304661548,id1f372081,left_wrist,3.81302690505981,-1,3,6045,107
6044,107,0.263371131161467,id1f372081,left_hip,4.23632788658142,1,1,6045,107
6044,107,0.608716096939204,id1f372081,left_ankle,3.89179611206055,1,1,6045,107
6044,105,0.557828416239146,id1f372081,right_ankle,3.89143013954163,1,3,6045,107
4787,101,0.218374251066448,id1f372081,left_wrist,3.81302690505981,-2,5,4785,108
4785,107,0.27155730793002,id1f372081,left_hip,4.23632788658142,0,1,4785,108
4784,108,0.673365389441731,id1f372081,left_ankle,3.89179611206055,1,1,4785,108
4784,107,0.534860754238157,id1f372081,right_ankle,3.89143013954163,1,2,4785,108
11299,104,0.284812016427759,id1f372081,left_wrist,3.81302690505981,-12,-13,11287,103
11296,104,0.28637118968272,id1f372081,left_hip,4.23632788658142,-9,-10,11287,103
11294,103,0.544011120663443,id1f372081,left_ankle,3.89179611206055,-7,-7,11287,103
11291,106,0.49622767024213,id1f372081,right_ankle,3.89143013954163,-4,-7,11287,103
5940,107,0.213160193370776,id1f372081,left_wrist,3.81302690505981,-1,-1,5939,107
5937,108,0.256882865311539,id1f372081,left_hip,4.23632788658142,2,1,5939,107
5937,108,0.645628081851708,id1f372081,left_ankle,3.89179611206055,2,1,5939,107
5937,108,0.520269083920641,id1f372081,right_ankle,3.89143013954163,2,1,5939,107
4060,100,0.130290429296528,id1f372081,left_wrist,3.81302690505981,-14,-6,4046,108
4045,107,0.274012399368829,id1f372081,left_hip,4.23632788658142,1,2,4046,108
4046,106,0.658347775712211,id1f372081,left_ankle,3.89179611206055,0,2,4046,108
4046,103,0.552428799131539,id1f372081,right_ankle,3.89143013954163,0,5,4046,108
11402,108,0.27405983852215,id1f372081,left_wrist,3.81302690505981,-13,-14,11389,107
11399,105,0.257526159460334,id1f372081,left_hip,4.23632788658142,-10,-8,11389,107
11396,106,0.587977459551239,id1f372081,left_ankle,3.89179611206055,-7,-6,11389,107
11396,104,0.504704724811407,id1f372081,right_ankle,3.89143013954163,-7,-4,11389,107
12335,106,0.159240681836567,id1f372081,left_wrist,3.81302690505981,-7,-9,12328,104
12333,105,0.242172754658984,id1f372081,left_hip,4.23632788658142,-5,-6,12328,104
12334,106,0.552669467504746,id1f372081,left_ankle,3.89179611206055,-6,-8,12328,104
12334,104,0.557558813971077,id1f372081,right_ankle,3.89143013954163,-6,-6,12328,104
2873,113,0.164998430960644,id1f372081,left_wrist,3.81302690505981,0,-6,2873,107
2871,106,0.266348505649977,id1f372081,left_hip,4.23632788658142,2,3,2873,107
2872,104,0.620966654361333,id1f372081,left_ankle,3.89179611206055,1,4,2873,107
2871,106,0.558478679970165,id1f372081,right_ankle,3.89143013954163,2,3,2873,107
5729,106,0.2318078812721,id1f372081,left_wrist,3.81302690505981,0,0,5729,106
5728,106,0.272028698746255,id1f372081,left_hip,4.23632788658142,1,1,5729,106
5728,105,0.711248434318102,id1f372081,left_ankle,3.89179611206055,1,2,5729,106
5727,105,0.606835815402451,id1f372081,right_ankle,3.89143013954163,2,3,5729,106
15687,104,0.289477464619292,id1f372081,left_wrist,3.81302690505981,-11,-13,15676,102
15684,106,0.24938128180119,id1f372081,left_hip,4.23632788658142,-8,-12,15676,102
15682,102,0.51349941421793,id1f372081,left_ankle,3.89179611206055,-6,-6,15676,102
15680,106,0.534473795432728,id1f372081,right_ankle,3.89143013954163,-4,-8,15676,102
20985,103,0.271652596277449,id1f372081,left_wrist,3.81302690505981,-10,-10,20975,103
20983,104,0.26001608148515,id1f372081,left_hip,4.23632788658142,-8,-9,20975,103
20982,102,0.649790851217119,id1f372081,left_ankle,3.89179611206055,-7,-6,20975,103
20980,105,0.54963872732986,id1f372081,right_ankle,3.89143013954163,-5,-7,20975,103
2230,113,0.225781548136058,id1f372081,left_wrist,3.81302690505981,-2,-7,2228,108
2232,109,0.268030492535182,id1f372081,left_hip,4.23632788658142,-4,-5,2228,108
2232,108,0.623599375691706,id1f372081,left_ankle,3.89179611206055,-4,-4,2228,108
2229,108,0.560465723069287,id1f372081,right_ankle,3.89143013954163,-1,-1,2228,108
16737,107,0.277648042958218,id1f372081,left_wrist,3.81302690505981,-14,-17,16723,104
16732,111,0.247675856969061,id1f372081,left_hip,4.23632788658142,-9,-16,16723,104
16729,106,0.578434434283935,id1f372081,left_ankle,3.89179611206055,-6,-8,16723,104
16731,105,0.551496196142584,id1f372081,right_ankle,3.89143013954163,-8,-9,16723,104
20783,97,0.307575010886416,id1f372081,left_wrist,3.81302690505981,-6,-1,20777,102
20781,100,0.302358031682215,id1f372081,left_hip,4.23632788658142,-4,-2,20777,102
20779,99,0.671464967212099,id1f372081,left_ankle,3.89179611206055,-2,1,20777,102
20775,105,0.55825434735715,id1f372081,right_ankle,3.89143013954163,2,-1,20777,102
17892,104,0.291108719247786,id1f372081,left_wrist,3.81302690505981,-14,-12,17878,106
17886,106,0.258796493490654,id1f372081,left_hip,4.23632788658142,-8,-8,17878,106
17885,104,0.646689413801848,id1f372081,left_ankle,3.89179611206055,-7,-5,17878,106
17886,106,0.511914523286835,id1f372081,right_ankle,3.89143013954163,-8,-8,17878,106
6790,105,0.221878883242403,id1f372081,left_wrist,3.81302690505981,-7,-6,6783,106
6788,106,0.27708169692685,id1f372081,left_hip,4.23632788658142,-5,-5,6783,106
6784,107,0.642928740258135,id1f372081,left_ankle,3.89179611206055,-1,-2,6783,106
6787,107,0.600600732754439,id1f372081,right_ankle,3.89143013954163,-4,-5,6783,106
14210,103,0.216073503049983,id1f372081,left_wrist,3.81302690505981,-11,-10,14199,104
14206,104,0.22505886613358,id1f372081,left_hip,4.23632788658142,-7,-7,14199,104
14204,104,0.639308796989348,id1f372081,left_ankle,3.89179611206055,-5,-5,14199,104
14202,103,0.51692118490071,id1f372081,right_ankle,3.89143013954163,-3,-2,14199,104
20783,97,0.307575010886416,id1f372081,left_wrist,3.81302690505981,-6,-1,20777,102
20781,100,0.302358031682215,id1f372081,left_hip,4.23632788658142,-4,-2,20777,102
20779,99,0.671464967212099,id1f372081,left_ankle,3.89179611206055,-2,1,20777,102
20775,105,0.55825434735715,id1f372081,right_ankle,3.89143013954163,2,-1,20777,102
20985,103,0.271652596277449,id1f372081,left_wrist,3.81302690505981,-3,-2,20982,104
20983,104,0.26001608148515,id1f372081,left_hip,4.23632788658142,-1,-1,20982,104
20982,102,0.649790851217119,id1f372081,left_ankle,3.89179611206055,0,2,20982,104
20980,105,0.54963872732986,id1f372081,right_ankle,3.89143013954163,2,1,20982,104
7527,104,0.237735525285617,id1f372081,left_wrist,3.81302690505981,-8,-8,7519,104
7525,104,0.268996816954343,id1f372081,left_hip,4.23632788658142,-6,-6,7519,104
7524,104,0.649986800924229,id1f372081,left_ankle,3.89179611206055,-5,-5,7519,104
7523,104,0.560654502549806,id1f372081,right_ankle,3.89143013954163,-4,-4,7519,104
5555,101,0.0920434413375794,id079c763c,left_wrist,4.05806684494019,8,10,5563,103
5564,102,0.254276118493067,id079c763c,left_hip,3.84882998466492,-1,0,5563,103
5566,102,0.619931941127046,id079c763c,left_ankle,3.74024200439453,-3,-2,5563,103
5563,104,0.713051178145833,id079c763c,right_ankle,4.1053421497345,0,-1,5563,103
3590,59,0.0644893188717271,id079c763c,left_wrist,4.05806684494019,-31,10,3559,100
3560,101,0.27906312629611,id079c763c,left_hip,3.84882998466492,-1,-2,3559,100
3562,100,0.724163708163696,id079c763c,left_ankle,3.74024200439453,-3,-3,3559,100
3562,99,0.784375974870527,id079c763c,right_ankle,4.1053421497345,-3,-2,3559,100
6778,106,0.163791697470223,id079c763c,left_wrist,4.05806684494019,9,7,6787,104
6789,104,0.239238020869365,id079c763c,left_hip,3.84882998466492,-2,-2,6787,104
6789,106,0.64130766343286,id079c763c,left_ankle,3.74024200439453,-2,-4,6787,104
6787,103,0.622106461690702,id079c763c,right_ankle,4.1053421497345,0,1,6787,104
10751,95,0.178851249132641,id079c763c,left_wrist,4.05806684494019,7,6,10758,94
10759,96,0.347249998767645,id079c763c,left_hip,3.84882998466492,-1,-3,10758,94
10760,97,0.747871042005663,id079c763c,left_ankle,3.74024200439453,-2,-5,10758,94
10761,96,0.666632397672822,id079c763c,right_ankle,4.1053421497345,-3,-5,10758,94
19308,95,0.181806731568321,id079c763c,left_wrist,4.05806684494019,-5,-5,19303,95
19309,93,0.373481327927973,id079c763c,left_hip,3.84882998466492,-6,-4,19303,95
19307,95,0.7879824769426,id079c763c,left_ankle,3.74024200439453,-4,-4,19303,95
19309,94,0.719050887943988,id079c763c,right_ankle,4.1053421497345,-6,-5,19303,95
10751,95,0.178851249132641,id079c763c,left_wrist,4.05806684494019,7,6,10758,94
10759,96,0.347249998767645,id079c763c,left_hip,3.84882998466492,-1,-3,10758,94
10760,97,0.747871042005663,id079c763c,left_ankle,3.74024200439453,-2,-5,10758,94
10761,96,0.666632397672822,id079c763c,right_ankle,4.1053421497345,-3,-5,10758,94
5454,102,0.136949969024655,id079c763c,left_wrist,4.05806684494019,8,8,5462,102
5464,101,0.284166284409507,id079c763c,left_hip,3.84882998466492,-2,-1,5462,102
5465,102,0.681181715645463,id079c763c,left_ankle,3.74024200439453,-3,-3,5462,102
5462,102,0.651200772550809,id079c763c,right_ankle,4.1053421497345,0,0,5462,102
1048,77,0.100037741977801,id079c763c,left_wrist,4.05806684494019,9,26,1057,94
1058,94,0.313465226039038,id079c763c,left_hip,3.84882998466492,-1,-1,1057,94
1059,93,0.714968548701301,id079c763c,left_ankle,3.74024200439453,-2,-1,1057,94
1062,95,0.767669128112714,id079c763c,right_ankle,4.1053421497345,-5,-6,1057,94
8835,98,0.16489980355378,id079c763c,left_wrist,4.05806684494019,8,7,8843,97
8844,97,0.290204540852765,id079c763c,left_hip,3.84882998466492,-1,-1,8843,97
8846,96,0.723839302502667,id079c763c,left_ankle,3.74024200439453,-3,-2,8843,97
8848,94,0.673137439293106,id079c763c,right_ankle,4.1053421497345,-5,-2,8843,97
17924,88,0.171809177040261,id079c763c,left_wrist,4.05806684494019,-6,-3,17918,91
17924,91,0.391136682593019,id079c763c,left_hip,3.84882998466492,-6,-6,17918,91
17920,92,0.773595133966856,id079c763c,left_ankle,3.74024200439453,-2,-3,17918,91
17923,91,0.730713828876482,id079c763c,right_ankle,4.1053421497345,-5,-5,17918,91
7284,100,0.13271887831078,id079c763c,left_wrist,4.05806684494019,7,6,7291,99
7293,99,0.28634534993407,id079c763c,left_hip,3.84882998466492,-2,-2,7291,99
7295,99,0.708860202212299,id079c763c,left_ankle,3.74024200439453,-4,-4,7291,99
7294,99,0.635636113567275,id079c763c,right_ankle,4.1053421497345,-3,-3,7291,99
2763,102,0.173971976622928,id079c763c,left_wrist,4.05806684494019,8,6,2771,100
2771,101,0.330367187449717,id079c763c,left_hip,3.84882998466492,0,-1,2771,100
2772,101,0.742713409921456,id079c763c,left_ankle,3.74024200439453,-1,-2,2771,100
2771,100,0.691904142026545,id079c763c,right_ankle,4.1053421497345,0,0,2771,100
7866,100,0.0532913275198026,id079c763c,left_wrist,4.05806684494019,9,8,7875,99
7877,98,0.308345010540594,id079c763c,left_hip,3.84882998466492,-2,-1,7875,99
7879,98,0.747665631925292,id079c763c,left_ankle,3.74024200439453,-4,-3,7875,99
7880,97,0.741577469018341,id079c763c,right_ankle,4.1053421497345,-5,-3,7875,99
13417,97,0.0893712715707766,id079c763c,left_wrist,4.05806684494019,7,8,13424,98
13427,95,0.307969888073574,id079c763c,left_hip,3.84882998466492,-3,0,13424,98
13428,97,0.763230437920937,id079c763c,left_ankle,3.74024200439453,-4,-3,13424,98
13429,96,0.752422781957062,id079c763c,right_ankle,4.1053421497345,-5,-3,13424,98
8255,99,0.141464152999477,id079c763c,left_wrist,4.05806684494019,10,8,8265,97
8267,95,0.281872849112733,id079c763c,left_hip,3.84882998466492,-2,0,8265,97
8267,97,0.700026476951603,id079c763c,left_ankle,3.74024200439453,-2,-2,8265,97
8268,97,0.635974455080669,id079c763c,right_ankle,4.1053421497345,-3,-3,8265,97
14484,85,0.117192788287579,id079c763c,left_wrist,4.05806684494019,-5,8,14479,98
14478,100,0.255491043455286,id079c763c,left_hip,3.84882998466492,1,-1,14479,98
14481,100,0.755286103769497,id079c763c,left_ankle,3.74024200439453,-2,-4,14479,98
14482,96,0.709750696116776,id079c763c,right_ankle,4.1053421497345,-3,-1,14479,98
14665,110,0.146835261204498,id079c763c,left_wrist,4.05806684494019,8,-3,14673,99
14677,97,0.243563189006937,id079c763c,left_hip,3.84882998466492,-4,-2,14673,99
14675,100,0.754076406465178,id079c763c,left_ankle,3.74024200439453,-2,-3,14673,99
14676,98,0.724480310099688,id079c763c,right_ankle,4.1053421497345,-3,-2,14673,99
11630,91,0.240992809590326,id079c763c,left_wrist,4.05806684494019,-10,-4,11620,97
11622,99,0.336498528082362,id079c763c,left_hip,3.84882998466492,-2,-4,11620,97
11624,96,0.710478061849137,id079c763c,left_ankle,3.74024200439453,-4,-3,11620,97
11623,97,0.725061847336935,id079c763c,right_ankle,4.1053421497345,-3,-3,11620,97
9026,98,0.141571534680665,id079c763c,left_wrist,4.05806684494019,9,7,9035,96
9037,95,0.292065029449125,id079c763c,left_hip,3.84882998466492,-2,-1,9035,96
9037,97,0.74284115985855,id079c763c,left_ankle,3.74024200439453,-2,-3,9035,96
9038,97,0.736306293560219,id079c763c,right_ankle,4.1053421497345,-3,-4,9035,96
9605,93,0.104986319062896,id079c763c,left_wrist,4.05806684494019,6,8,9611,95
9611,96,0.263596794954469,id079c763c,left_hip,3.84882998466492,0,-1,9611,95
9614,95,0.713732633671327,id079c763c,left_ankle,3.74024200439453,-3,-3,9611,95
9613,97,0.751973451537716,id079c763c,right_ankle,4.1053421497345,-2,-4,9611,95
5465,98,0.188614263647646,idbae5a811,left_wrist,3.33876895904541,-2,-6,5463,94
5459,97,0.248911086724697,idbae5a811,left_hip,3.137775182724,4,1,5463,94
5462,99,0.646261904213013,idbae5a811,left_ankle,3.16446709632874,1,-4,5463,94
5460,99,0.589731700893749,idbae5a811,right_ankle,3.15220499038696,3,-2,5463,94
10342,90,0.188184982247254,idbae5a811,left_wrist,3.33876895904541,-4,-3,10338,91
10343,93,0.296227960544986,idbae5a811,left_hip,3.137775182724,-5,-7,10338,91
10340,91,0.651450713483317,idbae5a811,left_ankle,3.16446709632874,-2,-2,10338,91
10340,92,0.668791923089957,idbae5a811,right_ankle,3.15220499038696,-2,-3,10338,91
16240,92,0.157650987713065,idbae5a811,left_wrist,3.33876895904541,-2,0,16238,94
16238,96,0.275349311484239,idbae5a811,left_hip,3.137775182724,0,-2,16238,94
16237,93,0.640667294850789,idbae5a811,left_ankle,3.16446709632874,1,2,16238,94
16238,93,0.595440438560472,idbae5a811,right_ankle,3.15220499038696,0,1,16238,94
2597,91,0.19065493858102,idbae5a811,left_wrist,3.33876895904541,-3,2,2594,96
2598,91,0.305011727707032,idbae5a811,left_hip,3.137775182724,-4,1,2594,96
2595,94,0.72101572958425,idbae5a811,left_ankle,3.16446709632874,-1,1,2594,96
2598,91,0.675517027361527,idbae5a811,right_ankle,3.15220499038696,-4,1,2594,96
7496,95,0.17405938112753,idbae5a811,left_wrist,3.33876895904541,-4,-5,7492,94
7498,92,0.271338388944361,idbae5a811,left_hip,3.137775182724,-6,-4,7492,94
7496,94,0.637572807596558,idbae5a811,left_ankle,3.16446709632874,-4,-4,7492,94
7496,93,0.577802351213,idbae5a811,right_ankle,3.15220499038696,-4,-3,7492,94
3771,91,0.240251413053246,idbae5a811,left_wrist,3.33876895904541,2,1,3773,90
3773,91,0.278937969610442,idbae5a811,left_hip,3.137775182724,0,-1,3773,90
3771,91,0.734088242856043,idbae5a811,left_ankle,3.16446709632874,2,1,3773,90
3772,91,0.604477408379725,idbae5a811,right_ankle,3.15220499038696,1,0,3773,90
7685,90,0.163447733143987,idbae5a811,left_wrist,3.33876895904541,-5,-4,7680,91
7683,96,0.2669145549669,idbae5a811,left_hip,3.137775182724,-3,-8,7680,91
7682,92,0.707092453850502,idbae5a811,left_ankle,3.16446709632874,-2,-3,7680,91
7683,93,0.646774018184794,idbae5a811,right_ankle,3.15220499038696,-3,-5,7680,91
2506,92,0.215373397074841,idbae5a811,left_wrist,3.33876895904541,-4,-3,2502,93
2505,94,0.276964527676663,idbae5a811,left_hip,3.137775182724,-3,-4,2502,93
2506,90,0.728247437861143,idbae5a811,left_ankle,3.16446709632874,-4,-1,2502,93
2506,93,0.638032781665314,idbae5a811,right_ankle,3.15220499038696,-4,-4,2502,93
8284,50,0.144371325481342,idbae5a811,left_wrist,3.33876895904541,-51,-2,8233,99
8236,94,0.260969447987343,idbae5a811,left_hip,3.137775182724,-3,2,8233,99
8235,95,0.625635913020008,idbae5a811,left_ankle,3.16446709632874,-2,2,8233,99
8234,95,0.600317337989628,idbae5a811,right_ankle,3.15220499038696,-1,3,8233,99
16835,90,0.114898726279831,idbae5a811,left_wrist,3.33876895904541,-49,-45,16786,94
16791,91,0.294687962708209,idbae5a811,left_hip,3.137775182724,-5,-2,16786,94
16785,94,0.664358473638377,idbae5a811,left_ankle,3.16446709632874,1,1,16786,94
16787,92,0.574337711627911,idbae5a811,right_ankle,3.15220499038696,-1,1,16786,94
13599,92,0.152437080088357,idbae5a811,left_wrist,3.33876895904541,0,0,13599,92
13599,94,0.291098680113188,idbae5a811,left_hip,3.137775182724,0,-2,13599,92
13597,92,0.687927536474244,idbae5a811,left_ankle,3.16446709632874,2,2,13599,92
13597,93,0.598553065824675,idbae5a811,right_ankle,3.15220499038696,2,1,13599,92
16560,101,0.161638478935923,idbae5a811,left_wrist,3.33876895904541,45,36,16605,92
16607,92,0.323703610909278,idbae5a811,left_hip,3.137775182724,-2,-2,16605,92
16604,92,0.656155830759328,idbae5a811,left_ankle,3.16446709632874,1,1,16605,92
16605,92,0.595487694903378,idbae5a811,right_ankle,3.15220499038696,0,0,16605,92
8424,94,0.143610237579391,idbae5a811,left_wrist,3.33876895904541,1,1,8425,94
8424,94,0.273680072094542,idbae5a811,left_hip,3.137775182724,1,1,8425,94
8424,93,0.67888754186584,idbae5a811,left_ankle,3.16446709632874,1,2,8425,94
8424,94,0.581299639319975,idbae5a811,right_ankle,3.15220499038696,1,1,8425,94
10787,91,0.198317099708146,idbae5a811,left_wrist,3.33876895904541,3,-3,10790,85
10791,92,0.261231120812581,idbae5a811,left_hip,3.137775182724,-1,-8,10790,85
10789,89,0.719817880047308,idbae5a811,left_ankle,3.16446709632874,1,-3,10790,85
10790,89,0.593873143940315,idbae5a811,right_ankle,3.15220499038696,0,-4,10790,85
8702,91,0.180031920059878,idbae5a811,left_wrist,3.33876895904541,0,-5,8702,86
8702,93,0.282509819048533,idbae5a811,left_hip,3.137775182724,0,-7,8702,86
8701,91,0.652059882042015,idbae5a811,left_ankle,3.16446709632874,1,-4,8702,86
8699,93,0.633598053103246,idbae5a811,right_ankle,3.15220499038696,3,-4,8702,86
1953,93,0.163928401604707,idbae5a811,left_wrist,3.33876895904541,0,-5,1953,88
1951,94,0.326561097078949,idbae5a811,left_hip,3.137775182724,2,-4,1953,88
1951,94,0.720220566549767,idbae5a811,left_ankle,3.16446709632874,2,-4,1953,88
1951,94,0.683918784243368,idbae5a811,right_ankle,3.15220499038696,2,-4,1953,88
4412,97,0.192342381172669,idbae5a811,left_wrist,3.33876895904541,-1,-6,4411,92
4412,93,0.284672803230898,idbae5a811,left_hip,3.137775182724,-1,-2,4411,92
4410,97,0.664155052207758,idbae5a811,left_ankle,3.16446709632874,1,-4,4411,92
4411,95,0.608604545603551,idbae5a811,right_ankle,3.15220499038696,0,-3,4411,92
8886,96,0.121432547826537,idbae5a811,left_wrist,3.33876895904541,-2,-1,8884,97
8884,94,0.267243534824719,idbae5a811,left_hip,3.137775182724,0,3,8884,97
8883,97,0.689405295288251,idbae5a811,left_ankle,3.16446709632874,1,1,8884,97
8883,94,0.539181625762392,idbae5a811,right_ankle,3.15220499038696,1,4,8884,97
6679,95,0.18264626850557,idbae5a811,left_wrist,3.33876895904541,5,-1,6684,89
6682,92,0.238733041889914,idbae5a811,left_hip,3.137775182724,2,-1,6684,89
6680,93,0.660520108668179,idbae5a811,left_ankle,3.16446709632874,4,0,6684,89
6679,91,0.532402393784488,idbae5a811,right_ankle,3.15220499038696,5,3,6684,89
16560,101,0.161638478935923,idbae5a811,left_wrist,3.33876895904541,45,36,16605,92
16607,92,0.323703610909278,idbae5a811,left_hip,3.137775182724,-2,-2,16605,92
16604,92,0.656155830759328,idbae5a811,left_ankle,3.16446709632874,1,1,16605,92
16605,92,0.595487694903378,idbae5a811,right_ankle,3.15220499038696,0,0,16605,92
11757,119,0.226555725765209,id7c20ee7a,left_wrist,4.3776478767395,1,-15,11758,103
11752,110,0.176493872162152,id7c20ee7a,left_hip,4.46118211746216,6,-1,11758,103
11758,102,0.613649371329022,id7c20ee7a,left_ankle,4.49347615242004,0,1,11758,103
11760,101,0.650685993318543,id7c20ee7a,right_ankle,4.49975109100342,-2,0,11758,103
7325,109,0.173519630882333,id7c20ee7a,left_wrist,4.3776478767395,-50,-50,7275,109
7268,111,0.159934851132246,id7c20ee7a,left_hip,4.46118211746216,7,5,7275,109
7273,110,0.673231047184469,id7c20ee7a,left_ankle,4.49347615242004,2,1,7275,109
7272,110,0.605731644404894,id7c20ee7a,right_ankle,4.49975109100342,3,2,7275,109
6332,109,0.198746492650877,id7c20ee7a,left_wrist,4.3776478767395,-49,-50,6283,108
6277,110,0.176137418243392,id7c20ee7a,left_hip,4.46118211746216,6,4,6283,108
6280,110,0.612766421634295,id7c20ee7a,left_ankle,4.49347615242004,3,1,6283,108
6280,109,0.584599243123345,id7c20ee7a,right_ankle,4.49975109100342,3,2,6283,108
17722,105,0.103513131516503,id7c20ee7a,left_wrist,4.3776478767395,-1,1,17721,107
17719,106,0.187092588734728,id7c20ee7a,left_hip,4.46118211746216,2,3,17721,107
17722,105,0.614459096998886,id7c20ee7a,left_ankle,4.49347615242004,-1,1,17721,107
17719,108,0.552423992155122,id7c20ee7a,right_ankle,4.49975109100342,2,1,17721,107
15827,98,0.107653904308743,id7c20ee7a,left_wrist,4.3776478767395,-4,4,15823,106
15823,106,0.171952945200179,id7c20ee7a,left_hip,4.46118211746216,0,0,15823,106
15825,105,0.64232646203606,id7c20ee7a,left_ankle,4.49347615242004,-2,-1,15823,106
15823,106,0.664337608051115,id7c20ee7a,right_ankle,4.49975109100342,0,0,15823,106
3831,111,0.191152265402751,id7c20ee7a,left_wrist,4.3776478767395,-51,-51,3780,111
3775,112,0.177720162679891,id7c20ee7a,left_hip,4.46118211746216,5,4,3780,111
3778,110,0.547934789128616,id7c20ee7a,left_ankle,4.49347615242004,2,3,3780,111
3778,109,0.561927723553581,id7c20ee7a,right_ankle,4.49975109100342,2,4,3780,111
1634,107,0.145993082260609,id7c20ee7a,left_wrist,4.3776478767395,5,4,1639,106
1632,105,0.14865477092639,id7c20ee7a,left_hip,4.46118211746216,7,8,1639,106
1637,106,0.576192288381611,id7c20ee7a,left_ankle,4.49347615242004,2,2,1639,106
1637,106,0.557704457157536,id7c20ee7a,right_ankle,4.49975109100342,2,2,1639,106
17086,101,0.0996992894940491,id7c20ee7a,left_wrist,4.3776478767395,-2,4,17084,107
17087,104,0.211251739809882,id7c20ee7a,left_hip,4.46118211746216,-3,0,17084,107
17085,105,0.664585858885707,id7c20ee7a,left_ankle,4.49347615242004,-1,1,17084,107
17084,106,0.607867468324035,id7c20ee7a,right_ankle,4.49975109100342,0,1,17084,107
13937,105,0.114235766969797,id7c20ee7a,left_wrist,4.3776478767395,4,5,13941,106
13937,105,0.146186027566094,id7c20ee7a,left_hip,4.46118211746216,4,5,13941,106
13940,105,0.593443766173468,id7c20ee7a,left_ankle,4.49347615242004,1,2,13941,106
13940,106,0.677194596783451,id7c20ee7a,right_ankle,4.49975109100342,1,1,13941,106
3941,111,0.166863757036224,id7c20ee7a,left_wrist,4.3776478767395,-51,-52,3890,110
3886,109,0.17918841192056,id7c20ee7a,left_hip,4.46118211746216,4,5,3890,110
3887,112,0.507334984621625,id7c20ee7a,left_ankle,4.49347615242004,3,1,3890,110
3886,112,0.535689760524585,id7c20ee7a,right_ankle,4.49975109100342,4,2,3890,110
1428,101,0.103161781344547,id7c20ee7a,left_wrist,4.3776478767395,4,0,1432,97
1426,103,0.127231917029269,id7c20ee7a,left_hip,4.46118211746216,6,0,1432,97
1430,103,0.675035231571176,id7c20ee7a,left_ankle,4.49347615242004,2,-4,1432,97
1432,102,0.630221052165962,id7c20ee7a,right_ankle,4.49975109100342,0,-5,1432,97
2529,109,0.198920982323302,id7c20ee7a,left_wrist,4.3776478767395,-45,-47,2484,107
2478,106,0.169050893747716,id7c20ee7a,left_hip,4.46118211746216,6,7,2484,107
2482,106,0.625620709162606,id7c20ee7a,left_ankle,4.49347615242004,2,3,2484,107
2482,107,0.582671681173267,id7c20ee7a,right_ankle,4.49975109100342,2,2,2484,107
8722,118,0.136555684457656,id7c20ee7a,left_wrist,4.3776478767395,-49,-58,8673,109
8667,108,0.149820055695961,id7c20ee7a,left_hip,4.46118211746216,6,7,8673,109
8671,109,0.665608662423935,id7c20ee7a,left_ankle,4.49347615242004,2,2,8673,109
8670,109,0.632974540194542,id7c20ee7a,right_ankle,4.49975109100342,3,3,8673,109
3941,111,0.166863757036224,id7c20ee7a,left_wrist,4.3776478767395,-51,-52,3890,110
3886,109,0.17918841192056,id7c20ee7a,left_hip,4.46118211746216,4,5,3890,110
3887,112,0.507334984621625,id7c20ee7a,left_ankle,4.49347615242004,3,1,3890,110
3886,112,0.535689760524585,id7c20ee7a,right_ankle,4.49975109100342,4,2,3890,110
6881,113,0.188775132868559,id7c20ee7a,left_wrist,4.3776478767395,-52,-52,6829,113
6823,110,0.133930883193011,id7c20ee7a,left_hip,4.46118211746216,6,9,6829,113
6827,112,0.5584975545573,id7c20ee7a,left_ankle,4.49347615242004,2,3,6829,113
6826,111,0.558445548697233,id7c20ee7a,right_ankle,4.49975109100342,3,5,6829,113
4491,112,0.18276444266443,id7c20ee7a,left_wrist,4.3776478767395,-51,-52,4440,111
4435,112,0.17389702784358,id7c20ee7a,left_hip,4.46118211746216,5,4,4440,111
4437,112,0.526746661667496,id7c20ee7a,left_ankle,4.49347615242004,3,2,4440,111
4437,111,0.588624247226713,id7c20ee7a,right_ankle,4.49975109100342,3,3,4440,111
5901,107,0.224154197594732,id7c20ee7a,left_wrist,4.3776478767395,-50,-49,5851,108
5842,110,0.195933106640459,id7c20ee7a,left_hip,4.46118211746216,9,7,5851,108
5848,109,0.571621827299624,id7c20ee7a,left_ankle,4.49347615242004,3,2,5851,108
5848,111,0.547428850344972,id7c20ee7a,right_ankle,4.49975109100342,3,0,5851,108
4272,110,0.201612172033474,id7c20ee7a,left_wrist,4.3776478767395,-50,-50,4222,110
4218,108,0.169808803251267,id7c20ee7a,left_hip,4.46118211746216,4,6,4222,110
4219,111,0.567401016365509,id7c20ee7a,left_ankle,4.49347615242004,3,2,4222,110
4219,110,0.500800550127446,id7c20ee7a,right_ankle,4.49975109100342,3,3,4222,110
10810,104,0.176078801723167,id7c20ee7a,left_wrist,4.3776478767395,-1,3,10809,108
10804,107,0.130622114629524,id7c20ee7a,left_hip,4.46118211746216,5,6,10809,108
10807,108,0.562936739365298,id7c20ee7a,left_ankle,4.49347615242004,2,2,10809,108
10806,109,0.627644566229583,id7c20ee7a,right_ankle,4.49975109100342,3,2,10809,108
17408,98,0.142533192344427,id7c20ee7a,left_wrist,4.3776478767395,-6,3,17402,107
17396,113,0.185575017262626,id7c20ee7a,left_hip,4.46118211746216,6,0,17402,107
17403,107,0.640445810157311,id7c20ee7a,left_ankle,4.49347615242004,-1,-1,17402,107
17400,106,0.561709968445616,id7c20ee7a,right_ankle,4.49975109100342,2,3,17402,107
686,80,0.173612695402961,id00b70b13,left_wrist,3.45464587211609,7,25,693,98
696,98,0.270185660965213,id00b70b13,left_hip,3.53198313713074,-3,-3,693,98
696,98,0.662776869232742,id00b70b13,left_ankle,3.32245206832886,-3,-3,693,98
694,99,0.622574982173271,id00b70b13,right_ankle,3.49158883094788,-1,-2,693,98
10243,66,0.193565985974705,id00b70b13,left_wrist,3.45464587211609,7,42,10250,101
10252,102,0.320246950100788,id00b70b13,left_hip,3.53198313713074,-2,-3,10250,101
10252,101,0.677346105671201,id00b70b13,left_ankle,3.32245206832886,-2,-2,10250,101
10253,100,0.679169941646123,id00b70b13,right_ankle,3.49158883094788,-3,-2,10250,101
17100,67,0.207449401211118,id00b70b13,left_wrist,3.45464587211609,8,42,17108,101
17111,101,0.304584519142631,id00b70b13,left_hip,3.53198313713074,-3,-3,17108,101
17110,102,0.688916882950669,id00b70b13,left_ankle,3.32245206832886,-2,-3,17108,101
17111,101,0.65254941757142,id00b70b13,right_ankle,3.49158883094788,-3,-3,17108,101
7295,99,0.188428312996234,id00b70b13,left_wrist,3.45464587211609,41,40,7336,98
7337,101,0.311893932615396,id00b70b13,left_hip,3.53198313713074,-1,-4,7336,98
7338,99,0.658120360930472,id00b70b13,left_ankle,3.32245206832886,-2,-3,7336,98
7336,102,0.678977340390364,id00b70b13,right_ankle,3.49158883094788,0,-4,7336,98
1054,82,0.0915205399698364,id00b70b13,left_wrist,3.45464587211609,29,45,1083,98
1085,99,0.282923867686595,id00b70b13,left_hip,3.53198313713074,-2,-3,1083,98
1086,98,0.651736725615607,id00b70b13,left_ankle,3.32245206832886,-3,-3,1083,98
1083,98,0.661469599870409,id00b70b13,right_ankle,3.49158883094788,0,0,1083,98
2760,102,0.136327825226174,id00b70b13,left_wrist,3.45464587211609,27,29,2787,104
2789,103,0.301394646660822,id00b70b13,left_hip,3.53198313713074,-2,-1,2787,104
2788,104,0.695850223567289,id00b70b13,left_ankle,3.32245206832886,-1,-1,2787,104
2790,103,0.609779913771617,id00b70b13,right_ankle,3.49158883094788,-3,-2,2787,104
6434,172,0.158422231078679,id00b70b13,left_wrist,3.45464587211609,-6,-76,6428,102
6431,103,0.29179017436935,id00b70b13,left_hip,3.53198313713074,-3,-4,6428,102
6433,100,0.744674545191002,id00b70b13,left_ankle,3.32245206832886,-5,-3,6428,102
6431,103,0.671899837170335,id00b70b13,right_ankle,3.49158883094788,-3,-4,6428,102
3064,102,0.128096919709932,id00b70b13,left_wrist,3.45464587211609,29,28,3093,101
3094,101,0.272192464162193,id00b70b13,left_hip,3.53198313713074,-1,-1,3093,101
3095,101,0.769076110950402,id00b70b13,left_ankle,3.32245206832886,-2,-2,3093,101
3094,100,0.566862633042349,id00b70b13,right_ankle,3.49158883094788,-1,0,3093,101
2654,107,0.259339805603146,id00b70b13,left_wrist,3.45464587211609,29,28,2683,106
2685,105,0.268728310098794,id00b70b13,left_hip,3.53198313713074,-2,-1,2683,106
2685,104,0.603084728038533,id00b70b13,left_ankle,3.32245206832886,-2,0,2683,106
2687,104,0.688447351489743,id00b70b13,right_ankle,3.49158883094788,-4,-2,2683,106
4406,62,0.098494049439441,id00b70b13,left_wrist,3.45464587211609,-11,29,4395,102
4398,102,0.250482600989927,id00b70b13,left_hip,3.53198313713074,-3,-3,4395,102
4398,101,0.703150599067219,id00b70b13,left_ankle,3.32245206832886,-3,-2,4395,102
4398,101,0.721178355928034,id00b70b13,right_ankle,3.49158883094788,-3,-2,4395,102
4600,63,0.183093623507123,id00b70b13,left_wrist,3.45464587211609,-5,36,4595,104
4598,102,0.262702242641404,id00b70b13,left_hip,3.53198313713074,-3,-1,4595,104
4597,103,0.712806361936469,id00b70b13,left_ankle,3.32245206832886,-2,-1,4595,104
4598,103,0.622454749080157,id00b70b13,right_ankle,3.49158883094788,-3,-2,4595,104
2654,107,0.259339805603146,id00b70b13,left_wrist,3.45464587211609,29,27,2683,105
2685,105,0.268728310098794,id00b70b13,left_hip,3.53198313713074,-2,-2,2683,105
2685,104,0.603084728038533,id00b70b13,left_ankle,3.32245206832886,-2,-1,2683,105
2687,104,0.688447351489743,id00b70b13,right_ankle,3.49158883094788,-4,-3,2683,105
19050,98,0.190006905263842,id00b70b13,left_wrist,3.45464587211609,42,43,19092,99
19096,99,0.274431448610254,id00b70b13,left_hip,3.53198313713074,-4,-4,19092,99
19096,98,0.753608470026636,id00b70b13,left_ankle,3.32245206832886,-4,-3,19092,99
19094,100,0.712082336254877,id00b70b13,right_ankle,3.49158883094788,-2,-3,19092,99
6605,86,0.191350179960722,id00b70b13,left_wrist,3.45464587211609,-76,-61,6529,101
6533,101,0.277130158372476,id00b70b13,left_hip,3.53198313713074,-4,-4,6529,101
6532,102,0.691860532268216,id00b70b13,left_ankle,3.32245206832886,-3,-4,6529,101
6533,101,0.631423538045207,id00b70b13,right_ankle,3.49158883094788,-4,-4,6529,101
9920,84,0.179813972153803,id00b70b13,left_wrist,3.45464587211609,25,44,9945,103
9948,103,0.308705310267312,id00b70b13,left_hip,3.53198313713074,-3,-3,9945,103
9948,103,0.7773127345197,id00b70b13,left_ankle,3.32245206832886,-3,-3,9945,103
9949,102,0.690553980059856,id00b70b13,right_ankle,3.49158883094788,-4,-3,9945,103
13206,70,0.268251788790394,id00b70b13,left_wrist,3.45464587211609,7,36,13213,99
13217,100,0.30120118699706,id00b70b13,left_hip,3.53198313713074,-4,-5,13213,99
13216,100,0.76184783554314,id00b70b13,left_ankle,3.32245206832886,-3,-4,13213,99
13215,99,0.63626485824957,id00b70b13,right_ankle,3.49158883094788,-2,-2,13213,99
1952,92,0.145826798933197,id00b70b13,left_wrist,3.45464587211609,28,36,1980,100
1980,101,0.28729143394578,id00b70b13,left_hip,3.53198313713074,0,-1,1980,100
1981,101,0.71808834728155,id00b70b13,left_ankle,3.32245206832886,-1,-2,1980,100
1978,104,0.682262789251529,id00b70b13,right_ankle,3.49158883094788,2,-2,1980,100
2552,103,0.195013333841156,id00b70b13,left_wrist,3.45464587211609,31,29,2583,101
2585,101,0.282030447208099,id00b70b13,left_hip,3.53198313713074,-2,-2,2583,101
2584,102,0.651712287704069,id00b70b13,left_ankle,3.32245206832886,-1,-2,2583,101
2585,103,0.680238686289569,id00b70b13,right_ankle,3.49158883094788,-2,-4,2583,101
1054,82,0.0915205399698364,id00b70b13,left_wrist,3.45464587211609,29,45,1083,98
1085,99,0.282923867686595,id00b70b13,left_hip,3.53198313713074,-2,-3,1083,98
1086,98,0.651736725615607,id00b70b13,left_ankle,3.32245206832886,-3,-3,1083,98
1083,98,0.661469599870409,id00b70b13,right_ankle,3.49158883094788,0,0,1083,98
17969,93,0.308801665959432,id00b70b13,left_wrist,3.45464587211609,38,44,18007,99
18012,98,0.284966077821566,id00b70b13,left_hip,3.53198313713074,-5,-4,18007,99
18010,100,0.77644998028346,id00b70b13,left_ankle,3.32245206832886,-3,-4,18007,99
18009,101,0.694912759988993,id00b70b13,right_ankle,3.49158883094788,-2,-4,18007,99
14657,105,0.11910048398629,id1165e00c,left_wrist,4.02771615982056,-2,-3,14655,104
14655,104,0.270000525945985,id1165e00c,left_hip,3.86032199859619,0,0,14655,104
14654,106,0.6945780755429,id1165e00c,left_ankle,4.18556904792786,1,-1,14655,104
14653,106,0.795179953523318,id1165e00c,right_ankle,3.94140005111694,2,0,14655,104
2133,112,0.205274075978942,id1165e00c,left_wrist,4.02771615982056,1,-2,2134,109
2131,109,0.280616903481205,id1165e00c,left_hip,3.86032199859619,3,3,2134,109
2132,109,0.645392970559178,id1165e00c,left_ankle,4.18556904792786,2,2,2134,109
2132,109,0.629886206810616,id1165e00c,right_ankle,3.94140005111694,2,2,2134,109
10819,97,0.0687757649348997,id1165e00c,left_wrist,4.02771615982056,-9,2,10810,108
10808,110,0.226184301825281,id1165e00c,left_hip,3.86032199859619,2,0,10810,108
10810,109,0.628948739402521,id1165e00c,left_ankle,4.18556904792786,0,-1,10810,108
10809,111,0.715413891350365,id1165e00c,right_ankle,3.94140005111694,1,-2,10810,108
10074,100,0.098257331819422,id1165e00c,left_wrist,4.02771615982056,-7,-1,10067,106
10062,110,0.225233670016645,id1165e00c,left_hip,3.86032199859619,5,1,10067,106
10064,109,0.582703629009044,id1165e00c,left_ankle,4.18556904792786,3,0,10067,106
10064,107,0.693495066902556,id1165e00c,right_ankle,3.94140005111694,3,2,10067,106
8254,105,0.0901989472631137,id1165e00c,left_wrist,4.02771615982056,0,3,8254,108
8253,108,0.226076415243051,id1165e00c,left_hip,3.86032199859619,1,1,8254,108
8255,107,0.647681059663173,id1165e00c,left_ankle,4.18556904792786,-1,0,8254,108
8253,107,0.742986080151827,id1165e00c,right_ankle,3.94140005111694,1,2,8254,108
21528,105,0.103125142448558,id1165e00c,left_wrist,4.02771615982056,0,2,21528,107
21526,108,0.251637268733231,id1165e00c,left_hip,3.86032199859619,2,1,21528,107
21528,108,0.675945121215481,id1165e00c,left_ankle,4.18556904792786,0,-1,21528,107
21527,108,0.76503198211659,id1165e00c,right_ankle,3.94140005111694,1,0,21528,107
3990,110,0.134157230363717,id1165e00c,left_wrist,4.02771615982056,-2,-2,3988,110
3985,114,0.241175805862015,id1165e00c,left_hip,3.86032199859619,3,-1,3988,110
3985,112,0.539352762125582,id1165e00c,left_ankle,4.18556904792786,3,1,3988,110
3985,112,0.634122969703949,id1165e00c,right_ankle,3.94140005111694,3,1,3988,110
17685,107,0.153933201825741,id1165e00c,left_wrist,4.02771615982056,-3,-4,17682,106
17683,104,0.234805463327516,id1165e00c,left_hip,3.86032199859619,-1,1,17682,106
17682,106,0.591453072215032,id1165e00c,left_ankle,4.18556904792786,0,0,17682,106
17680,106,0.694562395992061,id1165e00c,right_ankle,3.94140005111694,2,2,17682,106
1543,107,0.160302711687821,id1165e00c,left_wrist,4.02771615982056,51,52,1594,108
1592,108,0.250800856263298,id1165e00c,left_hip,3.86032199859619,2,2,1594,108
1593,108,0.614865936110821,id1165e00c,left_ankle,4.18556904792786,1,1,1594,108
1592,108,0.697671549620495,id1165e00c,right_ankle,3.94140005111694,2,2,1594,108
8784,94,0.0964881991709912,id1165e00c,left_wrist,4.02771615982056,-6,6,8778,106
8779,104,0.240147051572358,id1165e00c,left_hip,3.86032199859619,-1,1,8778,106
8779,104,0.611134416436617,id1165e00c,left_ankle,4.18556904792786,-1,1,8778,106
8776,105,0.788272820314549,id1165e00c,right_ankle,3.94140005111694,2,3,8778,106
3116,107,0.155625230335624,id1165e00c,left_wrist,4.02771615982056,1,1,3117,107
3116,107,0.24335941317345,id1165e00c,left_hip,3.86032199859619,1,1,3117,107
3114,108,0.600939520534801,id1165e00c,left_ankle,4.18556904792786,3,2,3117,107
3114,108,0.637751512149286,id1165e00c,right_ankle,3.94140005111694,3,2,3117,107
4441,108,0.118873024640376,id1165e00c,left_wrist,4.02771615982056,-10,-3,4431,115
4432,114,0.226091582299742,id1165e00c,left_hip,3.86032199859619,-1,0,4431,115
4429,112,0.550673251071277,id1165e00c,left_ankle,4.18556904792786,2,5,4431,115
4433,112,0.594784281173374,id1165e00c,right_ankle,3.94140005111694,-2,1,4431,115
18318,101,0.194268568059286,id1165e00c,left_wrist,4.02771615982056,-11,-4,18307,108
18310,105,0.236045082067097,id1165e00c,left_hip,3.86032199859619,-3,0,18307,108
18308,108,0.632409210849694,id1165e00c,left_ankle,4.18556904792786,-1,-1,18307,108
18307,107,0.720032874286592,id1165e00c,right_ankle,3.94140005111694,0,1,18307,108
15713,107,0.147760993253395,id1165e00c,left_wrist,4.02771615982056,-10,-8,15703,109
15705,108,0.250849980876164,id1165e00c,left_hip,3.86032199859619,-2,-1,15703,109
15705,106,0.612842780693542,id1165e00c,left_ankle,4.18556904792786,-2,1,15703,109
15704,106,0.712398671706872,id1165e00c,right_ankle,3.94140005111694,-1,2,15703,109
5867,112,0.104650610763164,id1165e00c,left_wrist,4.02771615982056,0,-3,5867,109
5866,108,0.241496005979038,id1165e00c,left_hip,3.86032199859619,1,2,5867,109
5864,111,0.568081640743928,id1165e00c,left_ankle,4.18556904792786,3,1,5867,109
5864,110,0.632259197080646,id1165e00c,right_ankle,3.94140005111694,3,2,5867,109
10819,97,0.0687757649348997,id1165e00c,left_wrist,4.02771615982056,-9,2,10810,108
10808,110,0.226184301825281,id1165e00c,left_hip,3.86032199859619,2,0,10810,108
10810,109,0.628948739402521,id1165e00c,left_ankle,4.18556904792786,0,-1,10810,108
10809,111,0.715413891350365,id1165e00c,right_ankle,3.94140005111694,1,-2,10810,108
1917,112,0.211668468889358,id1165e00c,left_wrist,4.02771615982056,1,-2,1918,109
1917,106,0.264158262599006,id1165e00c,left_hip,3.86032199859619,1,4,1918,109
1915,110,0.587817336752953,id1165e00c,left_ankle,4.18556904792786,3,2,1918,109
1918,109,0.728439113877139,id1165e00c,right_ankle,3.94140005111694,0,0,1918,109
7728,103,0.113955225121586,id1165e00c,left_wrist,4.02771615982056,-6,-1,7722,108
7721,110,0.241824435669697,id1165e00c,left_hip,3.86032199859619,1,-1,7722,108
7722,108,0.647375292682754,id1165e00c,left_ankle,4.18556904792786,0,0,7722,108
7721,110,0.694646898740576,id1165e00c,right_ankle,3.94140005111694,1,-1,7722,108
21113,104,0.126201188943192,id1165e00c,left_wrist,4.02771615982056,-6,-4,21107,106
21109,104,0.249848838776439,id1165e00c,left_hip,3.86032199859619,-2,0,21107,106
21109,105,0.724758981679009,id1165e00c,left_ankle,4.18556904792786,-2,-1,21107,106
21106,106,0.795103507142815,id1165e00c,right_ankle,3.94140005111694,1,1,21107,106
13615,97,0.108931158639373,id1165e00c,left_wrist,4.02771615982056,-4,2,13611,103
13610,106,0.27224636482433,id1165e00c,left_hip,3.86032199859619,1,-2,13611,103
13611,105,0.686518302041539,id1165e00c,left_ankle,4.18556904792786,0,-2,13611,103
13609,105,0.77541556485886,id1165e00c,right_ankle,3.94140005111694,2,0,13611,103
14015,103,0.231639365416961,id5308a7d6,left_wrist,3.64278507232666,-2,-4,14013,101
14012,103,0.299277056134379,id5308a7d6,left_hip,3.98599290847778,1,-1,14013,101
14011,103,0.716909473510726,id5308a7d6,left_ankle,3.76148891448975,2,0,14013,101
14012,101,0.759756649347345,id5308a7d6,right_ankle,3.81520700454712,1,1,14013,101
6642,108,0.175000896339875,id5308a7d6,left_wrist,3.64278507232666,-4,-4,6638,108
6638,107,0.2336644316148,id5308a7d6,left_hip,3.98599290847778,0,1,6638,108
6637,108,0.664340832395592,id5308a7d6,left_ankle,3.76148891448975,1,1,6638,108
6636,105,0.672529539737392,id5308a7d6,right_ankle,3.81520700454712,2,5,6638,108
8568,100,0.255890413411511,id5308a7d6,left_wrist,3.64278507232666,-2,-2,8566,100
8565,100,0.314377939343856,id5308a7d6,left_hip,3.98599290847778,1,1,8566,100
8564,101,0.713973423483466,id5308a7d6,left_ankle,3.76148891448975,2,1,8566,100
8564,100,0.659673255429133,id5308a7d6,right_ankle,3.81520700454712,2,2,8566,100
20869,103,0.170380583853033,id5308a7d6,left_wrist,3.64278507232666,-4,-4,20865,103
20866,101,0.269208511937363,id5308a7d6,left_hip,3.98599290847778,-1,1,20865,103
20864,102,0.789181545532051,id5308a7d6,left_ankle,3.76148891448975,1,2,20865,103
20864,102,0.699059786829448,id5308a7d6,right_ankle,3.81520700454712,1,2,20865,103
17981,101,0.267169311120269,id5308a7d6,left_wrist,3.64278507232666,-4,-4,17977,101
17977,102,0.306236259094547,id5308a7d6,left_hip,3.98599290847778,0,-1,17977,101
17976,101,0.741714183308053,id5308a7d6,left_ankle,3.76148891448975,1,1,17977,101
17977,100,0.765472149250977,id5308a7d6,right_ankle,3.81520700454712,0,1,17977,101
20076,99,0.206456076545267,id5308a7d6,left_wrist,3.64278507232666,-4,-4,20072,99
20072,100,0.30876868291415,id5308a7d6,left_hip,3.98599290847778,0,-1,20072,99
20071,98,0.800925330707354,id5308a7d6,left_ankle,3.76148891448975,1,2,20072,99
20070,102,0.722601485563676,id5308a7d6,right_ankle,3.81520700454712,2,-1,20072,99
17073,102,0.241460836966151,id5308a7d6,left_wrist,3.64278507232666,-3,-2,17070,103
17070,103,0.292203461682984,id5308a7d6,left_hip,3.98599290847778,0,0,17070,103
17069,102,0.74369604831159,id5308a7d6,left_ankle,3.76148891448975,1,2,17070,103
17067,104,0.691608954177625,id5308a7d6,right_ankle,3.81520700454712,3,2,17070,103
16553,105,0.239892858392784,id5308a7d6,left_wrist,3.64278507232666,-6,-5,16547,106
16549,105,0.244252897766354,id5308a7d6,left_hip,3.98599290847778,-2,-1,16547,106
16548,105,0.769979793559435,id5308a7d6,left_ankle,3.76148891448975,-1,0,16547,106
16545,106,0.791780410601308,id5308a7d6,right_ankle,3.81520700454712,2,2,16547,106
5721,103,0.229659078711114,id5308a7d6,left_wrist,3.64278507232666,-1,-1,5720,103
5718,103,0.287851788872412,id5308a7d6,left_hip,3.98599290847778,2,2,5720,103
5717,103,0.744212678361834,id5308a7d6,left_ankle,3.76148891448975,3,3,5720,103
5718,100,0.602117998288256,id5308a7d6,right_ankle,3.81520700454712,2,5,5720,103
16046,103,0.248667568786808,id5308a7d6,left_wrist,3.64278507232666,-5,-4,16041,104
16041,104,0.271843272501117,id5308a7d6,left_hip,3.98599290847778,0,0,16041,104
16040,104,0.777565819310641,id5308a7d6,left_ankle,3.76148891448975,1,1,16041,104
16039,104,0.703213028686108,id5308a7d6,right_ankle,3.81520700454712,2,2,16041,104
20670,100,0.206629143118469,id5308a7d6,left_wrist,3.64278507232666,-5,-3,20665,102
20666,101,0.31752236298757,id5308a7d6,left_hip,3.98599290847778,-1,0,20665,102
20665,101,0.810252644405218,id5308a7d6,left_ankle,3.76148891448975,0,1,20665,102
20665,101,0.787127955222641,id5308a7d6,right_ankle,3.81520700454712,0,1,20665,102
6232,102,0.256249363338563,id5308a7d6,left_wrist,3.64278507232666,-3,-1,6229,104
6229,102,0.285527251219211,id5308a7d6,left_hip,3.98599290847778,0,2,6229,104
6227,102,0.633166094274642,id5308a7d6,left_ankle,3.76148891448975,2,4,6229,104
6225,105,0.633595493748244,id5308a7d6,right_ankle,3.81520700454712,4,3,6229,104
8469,100,0.250099350653014,id5308a7d6,left_wrist,3.64278507232666,-1,-2,8468,99
8466,100,0.301827053113319,id5308a7d6,left_hip,3.98599290847778,2,1,8468,99
8465,100,0.829247147013646,id5308a7d6,left_ankle,3.76148891448975,3,2,8468,99
8466,99,0.747307344291502,id5308a7d6,right_ankle,3.81520700454712,2,2,8468,99
17073,102,0.241460836966151,id5308a7d6,left_wrist,3.64278507232666,-3,-2,17070,103
17070,103,0.292203461682984,id5308a7d6,left_hip,3.98599290847778,0,0,17070,103
17069,102,0.74369604831159,id5308a7d6,left_ankle,3.76148891448975,1,2,17070,103
17067,104,0.691608954177625,id5308a7d6,right_ankle,3.81520700454712,3,2,17070,103
1696,104,0.245996393234048,id5308a7d6,left_wrist,3.64278507232666,0,-3,1696,101
1694,102,0.288086631576625,id5308a7d6,left_hip,3.98599290847778,2,1,1696,101
1693,103,0.697431145711974,id5308a7d6,left_ankle,3.76148891448975,3,1,1696,101
1693,102,0.751629595350379,id5308a7d6,right_ankle,3.81520700454712,3,2,1696,101
7669,101,0.234900975034746,id5308a7d6,left_wrist,3.64278507232666,-4,-2,7665,103
7666,101,0.286132669010774,id5308a7d6,left_hip,3.98599290847778,-1,1,7665,103
7664,102,0.769765252953729,id5308a7d6,left_ankle,3.76148891448975,1,2,7665,103
7664,102,0.689031675061545,id5308a7d6,right_ankle,3.81520700454712,1,2,7665,103
9382,105,0.213922515559401,id5308a7d6,left_wrist,3.64278507232666,-2,-3,9380,104
9380,103,0.270604741523282,id5308a7d6,left_hip,3.98599290847778,0,1,9380,104
9379,102,0.72578632812106,id5308a7d6,left_ankle,3.76148891448975,1,3,9380,104
9375,106,0.573012982457898,id5308a7d6,right_ankle,3.81520700454712,5,3,9380,104
3398,101,0.246764816400735,id5308a7d6,left_wrist,3.64278507232666,-1,-2,3397,100
3395,100,0.295414707871684,id5308a7d6,left_hip,3.98599290847778,2,2,3397,100
3394,100,0.734665196505361,id5308a7d6,left_ankle,3.76148891448975,3,3,3397,100
3394,102,0.752116499851133,id5308a7d6,right_ankle,3.81520700454712,3,1,3397,100
12270,104,0.182427585758335,id5308a7d6,left_wrist,3.64278507232666,-3,-5,12267,102
12267,103,0.257723297164109,id5308a7d6,left_hip,3.98599290847778,0,-1,12267,102
12266,103,0.786731237380586,id5308a7d6,left_ankle,3.76148891448975,1,0,12267,102
12265,102,0.748301818304494,id5308a7d6,right_ankle,3.81520700454712,2,2,12267,102
20468,101,0.213440696962381,id5308a7d6,left_wrist,3.64278507232666,-3,-2,20465,102
20465,102,0.280604670982188,id5308a7d6,left_hip,3.98599290847778,0,0,20465,102
20463,102,0.782180733640397,id5308a7d6,left_ankle,3.76148891448975,2,2,20465,102
20465,100,0.7231348875081,id5308a7d6,right_ankle,3.81520700454712,0,2,20465,102
17624,110,0.30746112464695,ida61e8ddf,left_wrist,2.79099988937378,-1,-3,17623,108
17622,109,0.351810107345259,ida61e8ddf,left_hip,2.97989106178284,1,0,17623,108
17622,108,0.874347148198552,ida61e8ddf,left_ankle,2.86370491981506,1,1,17623,108
17622,110,0.846395381999679,ida61e8ddf,right_ankle,2.93950891494751,1,-1,17623,108
3207,113,0.282967920357663,ida61e8ddf,left_wrist,2.79099988937378,0,1,3207,114
3205,114,0.305763145143648,ida61e8ddf,left_hip,2.97989106178284,2,2,3207,114
3205,114,0.918963602294846,ida61e8ddf,left_ankle,2.86370491981506,2,2,3207,114
3208,110,0.711480976703657,ida61e8ddf,right_ankle,2.93950891494751,-1,3,3207,114
9745,104,0.358935372067382,ida61e8ddf,left_wrist,2.79099988937378,-1,0,9744,105
9742,105,0.40558087318975,ida61e8ddf,left_hip,2.97989106178284,2,2,9744,105
9741,106,0.895585421182895,ida61e8ddf,left_ankle,2.86370491981506,3,2,9744,105
9740,106,0.936553214223962,ida61e8ddf,right_ankle,2.93950891494751,4,3,9744,105
6841,109,0.298223918549351,ida61e8ddf,left_wrist,2.79099988937378,-2,-2,6839,109
6840,108,0.313121740705806,ida61e8ddf,left_hip,2.97989106178284,-1,0,6839,109
6842,109,0.990465177364615,ida61e8ddf,left_ankle,2.86370491981506,-3,-3,6839,109
6839,109,0.869987727437574,ida61e8ddf,right_ankle,2.93950891494751,0,0,6839,109
12098,110,0.320735951883801,ida61e8ddf,left_wrist,2.79099988937378,0,-1,12098,109
12096,111,0.353027010273911,ida61e8ddf,left_hip,2.97989106178284,2,0,12098,109
12095,111,0.993337457854652,ida61e8ddf,left_ankle,2.86370491981506,3,1,12098,109
12096,111,0.793780343453149,ida61e8ddf,right_ankle,2.93950891494751,2,0,12098,109
4877,107,0.280317069820511,ida61e8ddf,left_wrist,2.79099988937378,1,4,4878,110
4875,111,0.327240241729768,ida61e8ddf,left_hip,2.97989106178284,3,2,4878,110
4877,109,0.94471617819822,ida61e8ddf,left_ankle,2.86370491981506,1,2,4878,110
4875,111,0.853681354656258,ida61e8ddf,right_ankle,2.93950891494751,3,2,4878,110
8471,99,0.138818406974107,ida61e8ddf,left_wrist,2.79099988937378,-8,0,8463,107
8464,103,0.312184338319855,ida61e8ddf,left_hip,2.97989106178284,-1,3,8463,107
8462,106,0.697959197543455,ida61e8ddf,left_ankle,2.86370491981506,1,2,8463,107
8464,103,0.775463779779452,ida61e8ddf,right_ankle,2.93950891494751,-1,3,8463,107
3207,113,0.282967920357663,ida61e8ddf,left_wrist,2.79099988937378,0,1,3207,114
3205,114,0.305763145143648,ida61e8ddf,left_hip,2.97989106178284,2,2,3207,114
3205,114,0.918963602294846,ida61e8ddf,left_ankle,2.86370491981506,2,2,3207,114
3208,110,0.711480976703657,ida61e8ddf,right_ankle,2.93950891494751,-1,3,3207,114
6625,110,0.298125785518176,ida61e8ddf,left_wrist,2.79099988937378,-2,-1,6623,111
6622,110,0.341934238946151,ida61e8ddf,left_hip,2.97989106178284,1,2,6623,111
6622,110,0.981025828081161,ida61e8ddf,left_ankle,2.86370491981506,1,2,6623,111
6622,109,0.883531783607605,ida61e8ddf,right_ankle,2.93950891494751,1,3,6623,111
12975,109,0.26544553044159,ida61e8ddf,left_wrist,2.79099988937378,-2,-1,12973,110
12971,110,0.33709637441678,ida61e8ddf,left_hip,2.97989106178284,2,2,12973,110
12972,108,0.847473554286217,ida61e8ddf,left_ankle,2.86370491981506,1,3,12973,110
12971,109,0.903916807348645,ida61e8ddf,right_ankle,2.93950891494751,2,3,12973,110
8676,107,0.3125369045862,ida61e8ddf,left_wrist,2.79099988937378,0,-1,8676,106
8673,108,0.361199345814865,ida61e8ddf,left_hip,2.97989106178284,3,1,8676,106
8673,108,0.950836849373208,ida61e8ddf,left_ankle,2.86370491981506,3,1,8676,106
8672,108,0.890076146286,ida61e8ddf,right_ankle,2.93950891494751,4,2,8676,106
1204,109,0.314895582470634,ida61e8ddf,left_wrist,2.79099988937378,1,1,1205,109
1203,109,0.289981841511217,ida61e8ddf,left_hip,2.97989106178284,2,2,1205,109
1203,109,0.982289101192757,ida61e8ddf,left_ankle,2.86370491981506,2,2,1205,109
1203,108,0.844594574643109,ida61e8ddf,right_ankle,2.93950891494751,2,3,1205,109
14042,110,0.31292354929897,ida61e8ddf,left_wrist,2.79099988937378,0,-3,14042,107
14040,107,0.401191122950079,ida61e8ddf,left_hip,2.97989106178284,2,2,14042,107
14043,104,0.854999737631807,ida61e8ddf,left_ankle,2.86370491981506,-1,2,14042,107
14038,111,0.824719851918683,ida61e8ddf,right_ankle,2.93950891494751,4,0,14042,107
7587,107,0.32870725285541,ida61e8ddf,left_wrist,2.79099988937378,1,2,7588,108
7587,106,0.365131372110024,ida61e8ddf,left_hip,2.97989106178284,1,3,7588,108
7586,106,0.889481183256899,ida61e8ddf,left_ankle,2.86370491981506,2,4,7588,108
7585,108,0.869335616104809,ida61e8ddf,right_ankle,2.93950891494751,3,3,7588,108
17517,108,0.334611065613297,ida61e8ddf,left_wrist,2.79099988937378,-1,-1,17516,108
17515,108,0.38790879562419,ida61e8ddf,left_hip,2.97989106178284,1,1,17516,108
17515,108,0.950283915608892,ida61e8ddf,left_ankle,2.86370491981506,1,1,17516,108
17515,108,0.879741457312052,ida61e8ddf,right_ankle,2.93950891494751,1,1,17516,108
5202,110,0.267967952277041,ida61e8ddf,left_wrist,2.79099988937378,0,0,5202,110
5201,110,0.290477283877551,ida61e8ddf,left_hip,2.97989106178284,1,1,5202,110
5201,109,0.904376293126357,ida61e8ddf,left_ankle,2.86370491981506,1,2,5202,110
5201,110,0.85818442799055,ida61e8ddf,right_ankle,2.93950891494751,1,1,5202,110
15225,108,0.34017979492482,ida61e8ddf,left_wrist,2.79099988937378,-3,-3,15222,108
15220,110,0.362906174108072,ida61e8ddf,left_hip,2.97989106178284,2,0,15222,108
15220,109,0.929808599774776,ida61e8ddf,left_ankle,2.86370491981506,2,1,15222,108
15219,111,0.871013071951649,ida61e8ddf,right_ankle,2.93950891494751,3,0,15222,108
1637,111,0.306766960534976,ida61e8ddf,left_wrist,2.79099988937378,1,1,1638,111
1637,111,0.29493177924601,ida61e8ddf,left_hip,2.97989106178284,1,1,1638,111
1637,110,0.912974414201718,ida61e8ddf,left_ankle,2.86370491981506,1,2,1638,111
1637,111,0.791182437348141,ida61e8ddf,right_ankle,2.93950891494751,1,1,1638,111
15770,108,0.33502169184737,ida61e8ddf,left_wrist,2.79099988937378,-3,-3,15767,108
15765,109,0.396138919540431,ida61e8ddf,left_hip,2.97989106178284,2,1,15767,108
15766,108,0.896908993188627,ida61e8ddf,left_ankle,2.86370491981506,1,1,15767,108
15764,110,0.885508284088111,ida61e8ddf,right_ankle,2.93950891494751,3,1,15767,108
8569,108,0.265273566492532,ida61e8ddf,left_wrist,2.79099988937378,0,0,8569,108
8566,108,0.357550067234095,ida61e8ddf,left_hip,2.97989106178284,3,3,8569,108
8567,107,0.861476285565043,ida61e8ddf,left_ankle,2.86370491981506,2,3,8569,108
8566,107,0.869645631098929,ida61e8ddf,right_ankle,2.93950891494751,3,4,8569,108
1983,102,0.230264039431179,id9603e9c3,left_wrist,3.08390307426453,-2,-3,1981,101
1983,101,0.341466454056903,id9603e9c3,left_hip,2.849524974823,-2,-2,1981,101
1981,102,0.83480985683789,id9603e9c3,left_ankle,3.18590402603149,0,-1,1981,101
1981,101,0.744614000366754,id9603e9c3,right_ankle,3.03113508224487,0,0,1981,101
5942,102,0.309341141680477,id9603e9c3,left_wrist,3.08390307426453,-1,-2,5941,101
5943,100,0.386153226272437,id9603e9c3,left_hip,2.849524974823,-2,-1,5941,101
5942,100,0.79946460986093,id9603e9c3,left_ankle,3.18590402603149,-1,0,5941,101
5940,102,0.811176673695258,id9603e9c3,right_ankle,3.03113508224487,1,0,5941,101
14785,97,0.372702705592752,id9603e9c3,left_wrist,3.08390307426453,-4,-3,14781,98
14784,97,0.459386488280715,id9603e9c3,left_hip,2.849524974823,-3,-2,14781,98
14783,97,0.883748336556752,id9603e9c3,left_ankle,3.18590402603149,-2,-1,14781,98
14780,98,0.855597646019032,id9603e9c3,right_ankle,3.03113508224487,1,1,14781,98
4942,102,0.247996154381764,id9603e9c3,left_wrist,3.08390307426453,-1,-1,4941,102
4942,101,0.335175040731522,id9603e9c3,left_hip,2.849524974823,-1,0,4941,102
4940,102,0.838066446665003,id9603e9c3,left_ankle,3.18590402603149,1,1,4941,102
4940,99,0.66207046900585,id9603e9c3,right_ankle,3.03113508224487,1,4,4941,102
10349,100,0.306128444559386,id9603e9c3,left_wrist,3.08390307426453,-2,-1,10347,101
10349,100,0.383124535506201,id9603e9c3,left_hip,2.849524974823,-2,-1,10347,101
10348,100,0.797424903937865,id9603e9c3,left_ankle,3.18590402603149,-1,0,10347,101
10346,102,0.784310062340278,id9603e9c3,right_ankle,3.03113508224487,1,0,10347,101
14785,97,0.372702705592752,id9603e9c3,left_wrist,3.08390307426453,-4,-3,14781,98
14784,97,0.459386488280715,id9603e9c3,left_hip,2.849524974823,-3,-2,14781,98
14783,97,0.883748336556752,id9603e9c3,left_ankle,3.18590402603149,-2,-1,14781,98
14780,98,0.855597646019032,id9603e9c3,right_ankle,3.03113508224487,1,1,14781,98
1299,98,0.24824691429533,id9603e9c3,left_wrist,3.08390307426453,-3,-1,1296,100
1296,101,0.348970590083747,id9603e9c3,left_hip,2.849524974823,0,-1,1296,100
1296,99,0.75986983567185,id9603e9c3,left_ankle,3.18590402603149,0,1,1296,100
1295,97,0.721329910636211,id9603e9c3,right_ankle,3.03113508224487,1,4,1296,100
12443,102,0.280022200049192,id9603e9c3,left_wrist,3.08390307426453,-2,-4,12441,100
12443,101,0.423206632164541,id9603e9c3,left_hip,2.849524974823,-2,-3,12441,100
12442,100,0.853231680437757,id9603e9c3,left_ankle,3.18590402603149,-1,-1,12441,100
12441,101,0.814201017422829,id9603e9c3,right_ankle,3.03113508224487,0,-1,12441,100
12343,101,0.338271254735078,id9603e9c3,left_wrist,3.08390307426453,-1,-2,12342,100
12344,100,0.435776099962445,id9603e9c3,left_hip,2.849524974823,-2,-2,12342,100
12342,101,0.815454224710005,id9603e9c3,left_ankle,3.18590402603149,0,-1,12342,100
12341,101,0.781771370975719,id9603e9c3,right_ankle,3.03113508224487,1,0,12342,100
8149,101,0.281725017141235,id9603e9c3,left_wrist,3.08390307426453,-2,-1,8147,102
8148,102,0.351655423437587,id9603e9c3,left_hip,2.849524974823,-1,-1,8147,102
8147,102,0.802679445557366,id9603e9c3,left_ankle,3.18590402603149,0,0,8147,102
8148,101,0.753284415105093,id9603e9c3,right_ankle,3.03113508224487,-1,0,8147,102
7740,103,0.267079204498413,id9603e9c3,left_wrist,3.08390307426453,-2,-2,7738,103
7740,103,0.329596207329755,id9603e9c3,left_hip,2.849524974823,-2,-2,7738,103
7738,103,0.70557124187393,id9603e9c3,left_ankle,3.18590402603149,0,0,7738,103
7738,102,0.667674875489998,id9603e9c3,right_ankle,3.03113508224487,0,1,7738,103
9952,99,0.36045366940096,id9603e9c3,left_wrist,3.08390307426453,-4,-3,9948,100
9952,98,0.387889912854986,id9603e9c3,left_hip,2.849524974823,-4,-2,9948,100
9949,101,0.778042627833323,id9603e9c3,left_ankle,3.18590402603149,-1,-2,9948,100
9949,99,0.740417785987864,id9603e9c3,right_ankle,3.03113508224487,-1,0,9948,100
16415,99,0.357278378047838,id9603e9c3,left_wrist,3.08390307426453,-3,-4,16412,98
16414,98,0.434013506935048,id9603e9c3,left_hip,2.849524974823,-2,-2,16412,98
16414,97,0.851127690213121,id9603e9c3,left_ankle,3.18590402603149,-2,-1,16412,98
16411,97,0.845539535512764,id9603e9c3,right_ankle,3.03113508224487,1,2,16412,98
4155,100,0.256568079326272,id9603e9c3,left_wrist,3.08390307426453,-3,-1,4152,102
4154,100,0.375956652483552,id9603e9c3,left_hip,2.849524974823,-2,0,4152,102
4153,101,0.801286685394723,id9603e9c3,left_ankle,3.18590402603149,-1,0,4152,102
4153,99,0.765897771195722,id9603e9c3,right_ankle,3.03113508224487,-1,2,4152,102
3956,102,0.285752854969302,id9603e9c3,left_wrist,3.08390307426453,-1,-2,3955,101
3955,102,0.343165171232657,id9603e9c3,left_hip,2.849524974823,0,-1,3955,101
3954,101,0.829339174504459,id9603e9c3,left_ankle,3.18590402603149,1,1,3955,101
3954,100,0.77581351266837,id9603e9c3,right_ankle,3.03113508224487,1,2,3955,101
7541,99,0.272622142505866,id9603e9c3,left_wrist,3.08390307426453,-2,-2,7539,99
7541,97,0.364107596764456,id9603e9c3,left_hip,2.849524974823,-2,0,7539,99
7539,100,0.809764492314057,id9603e9c3,left_ankle,3.18590402603149,0,-1,7539,99
7538,99,0.771204166652762,id9603e9c3,right_ankle,3.03113508224487,1,1,7539,99
5942,102,0.309341141680477,id9603e9c3,left_wrist,3.08390307426453,-1,-2,5941,101
5943,100,0.386153226272437,id9603e9c3,left_hip,2.849524974823,-2,-1,5941,101
5942,100,0.79946460986093,id9603e9c3,left_ankle,3.18590402603149,-1,0,5941,101
5940,102,0.811176673695258,id9603e9c3,right_ankle,3.03113508224487,1,0,5941,101
15264,98,0.37398293370186,id9603e9c3,left_wrist,3.08390307426453,-3,-4,15261,97
15262,98,0.444161583754614,id9603e9c3,left_hip,2.849524974823,-1,-2,15261,97
15261,97,0.873140775282925,id9603e9c3,left_ankle,3.18590402603149,0,0,15261,97
15259,97,0.838604123607351,id9603e9c3,right_ankle,3.03113508224487,2,2,15261,97
3165,100,0.267411380239872,id9603e9c3,left_wrist,3.08390307426453,-2,-1,3163,101
3164,101,0.340368847127241,id9603e9c3,left_hip,2.849524974823,-1,-1,3163,101
3163,100,0.770558416265246,id9603e9c3,left_ankle,3.18590402603149,0,1,3163,101
3163,100,0.751096157597763,id9603e9c3,right_ankle,3.03113508224487,0,1,3163,101
8762,100,0.305393651490084,id9603e9c3,left_wrist,3.08390307426453,-5,-2,8757,103
8761,102,0.389907926155312,id9603e9c3,left_hip,2.849524974823,-4,-3,8757,103
8759,101,0.791593331417781,id9603e9c3,left_ankle,3.18590402603149,-2,0,8757,103
8758,102,0.779914686487778,id9603e9c3,right_ankle,3.03113508224487,-1,0,8757,103
6698,86,0.197019664038118,idfc5f05e4,left_wrist,2.83215498924255,2,1,6700,85
6699,85,0.288870912273944,idfc5f05e4,left_hip,2.76758790016174,1,1,6700,85
6695,87,0.925030309560281,idfc5f05e4,left_ankle,2.48929381370544,5,3,6700,85
6697,84,0.807065668629354,idfc5f05e4,right_ankle,2.99256300926208,3,4,6700,85
8870,85,0.21568460769722,idfc5f05e4,left_wrist,2.83215498924255,0,0,8870,85
8870,86,0.322089385111691,idfc5f05e4,left_hip,2.76758790016174,0,-1,8870,85
8871,84,0.933059009791997,idfc5f05e4,left_ankle,2.48929381370544,-1,0,8870,85
8869,83,0.93175940548183,idfc5f05e4,right_ankle,2.99256300926208,1,3,8870,85
10210,84,0.179622959638587,idfc5f05e4,left_wrist,2.83215498924255,1,1,10211,84
10212,84,0.295019548101349,idfc5f05e4,left_hip,2.76758790016174,-1,-1,10211,84
10208,87,0.974082233415778,idfc5f05e4,left_ankle,2.48929381370544,3,0,10211,84
10209,80,0.82480239590661,idfc5f05e4,right_ankle,2.99256300926208,2,6,10211,84
15296,85,0.245100841664565,idfc5f05e4,left_wrist,2.83215498924255,42,41,15338,84
15380,50,0.203907300679347,idfc5f05e4,left_wrist,2.83215498924255,-42,-8,15338,84
15338,84,0.312407152944557,idfc5f05e4,left_hip,2.76758790016174,0,0,15338,84
15337,84,0.957602853526212,idfc5f05e4,left_ankle,2.48929381370544,1,1,15338,84
15334,87,0.946313341856102,idfc5f05e4,right_ankle,2.99256300926208,4,1,15338,84
3641,89,0.175976085737225,idfc5f05e4,left_wrist,2.83215498924255,2,0,3643,87
3642,87,0.275769330468703,idfc5f05e4,left_hip,2.76758790016174,1,1,3643,87
3640,89,0.967110628343925,idfc5f05e4,left_ankle,2.48929381370544,3,1,3643,87
3642,87,0.900865664591295,idfc5f05e4,right_ankle,2.99256300926208,1,1,3643,87
3815,88,0.169438340202054,idfc5f05e4,left_wrist,2.83215498924255,1,0,3816,87
3814,88,0.256330898361157,idfc5f05e4,left_hip,2.76758790016174,2,1,3816,87
3813,88,0.926685039734065,idfc5f05e4,left_ankle,2.48929381370544,3,2,3816,87
3814,89,0.81834877357081,idfc5f05e4,right_ankle,2.99256300926208,2,0,3816,87
12450,83,0.197763091807596,idfc5f05e4,left_wrist,2.83215498924255,0,1,12450,84
12452,83,0.320981326060227,idfc5f05e4,left_hip,2.76758790016174,-2,-1,12450,84
12449,84,0.964241951627392,idfc5f05e4,left_ankle,2.48929381370544,1,1,12450,84
12448,83,0.87694251125036,idfc5f05e4,right_ankle,2.99256300926208,2,3,12450,84
12950,84,0.212052007281399,idfc5f05e4,left_wrist,2.83215498924255,0,-1,12950,83
12952,83,0.355867300277088,idfc5f05e4,left_hip,2.76758790016174,-2,-2,12950,83
12950,83,1.00572988725579,idfc5f05e4,left_ankle,2.48929381370544,0,0,12950,83
12949,80,0.940319207776857,idfc5f05e4,right_ankle,2.99256300926208,1,4,12950,83
1923,89,0.216751373651249,idfc5f05e4,left_wrist,2.83215498924255,3,2,1926,88
1923,88,0.310245050205618,idfc5f05e4,left_hip,2.76758790016174,3,3,1926,88
1921,89,0.851645897802253,idfc5f05e4,left_ankle,2.48929381370544,5,4,1926,88
1924,87,0.908537819807559,idfc5f05e4,right_ankle,2.99256300926208,2,3,1926,88
15006,84,0.179795770503906,idfc5f05e4,left_wrist,2.83215498924255,1,0,15007,83
15008,83,0.350963642578801,idfc5f05e4,left_hip,2.76758790016174,-1,-1,15007,83
15007,79,0.869248976944175,idfc5f05e4,left_ankle,2.48929381370544,0,4,15007,83
15005,85,0.965486212942344,idfc5f05e4,right_ankle,2.99256300926208,2,0,15007,83
2394,85,0.251774500176851,idfc5f05e4,left_wrist,2.83215498924255,46,45,2440,84
2438,85,0.325733069898728,idfc5f05e4,left_hip,2.76758790016174,2,1,2440,84
2434,90,0.950087016911016,idfc5f05e4,left_ankle,2.48929381370544,6,0,2440,84
2436,86,0.93117809103326,idfc5f05e4,right_ankle,2.99256300926208,4,2,2440,84
2394,85,0.251774500176851,idfc5f05e4,left_wrist,2.83215498924255,-40,-38,2354,87
2353,86,0.309665657758435,idfc5f05e4,left_hip,2.76758790016174,1,2,2354,87
2352,83,0.853563932102378,idfc5f05e4,left_ankle,2.48929381370544,2,6,2354,87
2352,85,0.833321755292723,idfc5f05e4,right_ankle,2.99256300926208,2,4,2354,87
14432,83,0.209195522450196,idfc5f05e4,left_wrist,2.83215498924255,0,1,14432,84
14434,84,0.382077923191536,idfc5f05e4,left_hip,2.76758790016174,-2,-2,14432,84
14431,84,0.97749892167632,idfc5f05e4,left_ankle,2.48929381370544,1,1,14432,84
14430,84,0.966209796165369,idfc5f05e4,right_ankle,2.99256300926208,2,2,14432,84
8047,82,0.145468719579972,idfc5f05e4,left_wrist,2.83215498924255,-1,1,8046,84
8048,84,0.325807509567698,idfc5f05e4,left_hip,2.76758790016174,-2,-2,8046,84
8046,80,0.854386133079126,idfc5f05e4,left_ankle,2.48929381370544,0,4,8046,84
8043,83,0.965579318892337,idfc5f05e4,right_ankle,2.99256300926208,3,4,8046,84
2394,85,0.251774500176851,idfc5f05e4,left_wrist,2.83215498924255,46,45,2440,84
2438,85,0.325733069898728,idfc5f05e4,left_hip,2.76758790016174,2,1,2440,84
2434,90,0.950087016911016,idfc5f05e4,left_ankle,2.48929381370544,6,0,2440,84
2436,86,0.93117809103326,idfc5f05e4,right_ankle,2.99256300926208,4,2,2440,84
5447,85,0.1608304637752,idfc5f05e4,left_wrist,2.83215498924255,-1,0,5446,86
5447,85,0.278757125534906,idfc5f05e4,left_hip,2.76758790016174,-1,0,5446,86
5444,85,0.928469025148716,idfc5f05e4,left_ankle,2.48929381370544,2,3,5446,86
5445,85,0.908356784680391,idfc5f05e4,right_ankle,2.99256300926208,1,2,5446,86
10293,82,0.199852542120654,idfc5f05e4,left_wrist,2.83215498924255,1,2,10294,83
10295,82,0.323167912307791,idfc5f05e4,left_hip,2.76758790016174,-1,0,10294,83
10294,82,0.909751606834801,idfc5f05e4,left_ankle,2.48929381370544,0,1,10294,83
10288,83,0.938385548519305,idfc5f05e4,right_ankle,2.99256300926208,6,6,10294,83
4931,87,0.205729002319041,idfc5f05e4,left_wrist,2.83215498924255,1,1,4932,87
4930,86,0.288075748073569,idfc5f05e4,left_hip,2.76758790016174,2,3,4932,87
4929,87,0.840897832159243,idfc5f05e4,left_ankle,2.48929381370544,3,3,4932,87
4928,88,0.877244009412629,idfc5f05e4,right_ankle,2.99256300926208,4,3,4932,87
5531,85,0.193024240700378,idfc5f05e4,left_wrist,2.83215498924255,0,0,5531,85
5531,87,0.292842845721571,idfc5f05e4,left_hip,2.76758790016174,0,-2,5531,85
5528,85,0.859723965006756,idfc5f05e4,left_ankle,2.48929381370544,3,3,5531,85
5529,86,0.855595024723782,idfc5f05e4,right_ankle,2.99256300926208,2,1,5531,85
2394,85,0.251774500176851,idfc5f05e4,left_wrist,2.83215498924255,-40,-38,2354,87
2353,86,0.309665657758435,idfc5f05e4,left_hip,2.76758790016174,1,2,2354,87
2352,83,0.853563932102378,idfc5f05e4,left_ankle,2.48929381370544,2,6,2354,87
2352,85,0.833321755292723,idfc5f05e4,right_ankle,2.99256300926208,2,4,2354,87
15149,100,0.307298130864209,idf540d82b,left_wrist,4.5942268371582,12,10,15161,98
15155,98,0.271377736402577,idf540d82b,left_hip,4.75236415863037,6,6,15161,98
15150,99,0.535184190363303,idf540d82b,left_ankle,4.65533304214478,11,10,15161,98
15150,101,0.474161139074215,idf540d82b,right_ankle,4.48691010475159,11,8,15161,98
4326,99,0.32691768478788,idf540d82b,left_wrist,4.5942268371582,10,12,4336,101
4334,96,0.2737508453865,idf540d82b,left_hip,4.75236415863037,2,7,4336,101
4326,101,0.549302290222618,idf540d82b,left_ankle,4.65533304214478,10,10,4336,101
4326,101,0.488127719350604,idf540d82b,right_ankle,4.48691010475159,10,10,4336,101
21855,96,0.362772741402717,idf540d82b,left_wrist,4.5942268371582,50,53,21905,99
21906,96,0.341264603164081,idf540d82b,left_hip,4.75236415863037,-1,2,21905,99
21899,98,0.663065086301024,idf540d82b,left_ankle,4.65533304214478,6,7,21905,99
21898,97,0.613644475416877,idf540d82b,right_ankle,4.48691010475159,7,9,21905,99
20554,52,0.184708764291819,idf540d82b,left_wrist,4.5942268371582,11,52,20565,93
20561,100,0.359809511248619,idf540d82b,left_hip,4.75236415863037,4,-3,20565,93
20555,97,0.649082846070025,idf540d82b,left_ankle,4.65533304214478,10,6,20565,93
20553,99,0.481337933497481,idf540d82b,right_ankle,4.48691010475159,12,6,20565,93
21712,94,0.366598224005344,idf540d82b,left_wrist,4.5942268371582,1,3,21713,96
21716,95,0.345657395827201,idf540d82b,left_hip,4.75236415863037,-3,-2,21713,96
21706,97,0.600462496508655,idf540d82b,left_ankle,4.65533304214478,7,6,21713,96
21706,97,0.581952115168118,idf540d82b,right_ankle,4.48691010475159,7,6,21713,96
16609,96,0.324218481373492,idf540d82b,left_wrist,4.5942268371582,3,5,16612,98
16614,96,0.339713848001906,idf540d82b,left_hip,4.75236415863037,-2,0,16612,98
16605,98,0.650461350655933,idf540d82b,left_ankle,4.65533304214478,7,7,16612,98
16605,98,0.553439719303777,idf540d82b,right_ankle,4.48691010475159,7,7,16612,98
8574,99,0.259573136441196,idf540d82b,left_wrist,4.5942268371582,11,11,8585,99
8581,96,0.260927458711661,idf540d82b,left_hip,4.75236415863037,4,7,8585,99
8574,100,0.467467387948157,idf540d82b,left_ankle,4.65533304214478,11,10,8585,99
8575,98,0.519982589463067,idf540d82b,right_ankle,4.48691010475159,10,11,8585,99
17949,50,0.166867504205613,idf540d82b,left_wrist,4.5942268371582,4,50,17953,96
17955,94,0.380292671627404,idf540d82b,left_hip,4.75236415863037,-2,0,17953,96
17947,96,0.60489646830178,idf540d82b,left_ankle,4.65533304214478,6,6,17953,96
17947,94,0.648730182854195,idf540d82b,right_ankle,4.48691010475159,6,8,17953,96
372,95,0.262324063091979,idf540d82b,left_wrist,4.5942268371582,-46,-41,326,100
322,98,0.299533653686933,idf540d82b,left_hip,4.75236415863037,4,6,326,100
316,98,0.58367427950106,idf540d82b,left_ankle,4.65533304214478,10,12,326,100
317,98,0.536076069324121,idf540d82b,right_ankle,4.48691010475159,9,11,326,100
21712,94,0.366598224005344,idf540d82b,left_wrist,4.5942268371582,1,7,21713,100
21716,95,0.345657395827201,idf540d82b,left_hip,4.75236415863037,-3,2,21713,100
21706,97,0.600462496508655,idf540d82b,left_ankle,4.65533304214478,7,10,21713,100
21706,97,0.581952115168118,idf540d82b,right_ankle,4.48691010475159,7,10,21713,100
22759,100,0.328335412570206,idf540d82b,left_wrist,4.5942268371582,12,9,22771,97
22768,97,0.280195190929378,idf540d82b,left_hip,4.75236415863037,3,3,22771,97
22761,98,0.588438828378725,idf540d82b,left_ankle,4.65533304214478,10,9,22771,97
22760,99,0.552037291885757,idf540d82b,right_ankle,4.48691010475159,11,9,22771,97
8280,99,0.26363332069384,idf540d82b,left_wrist,4.5942268371582,9,6,8289,96
8286,100,0.276968167265313,idf540d82b,left_hip,4.75236415863037,3,-1,8289,96
8281,97,0.600164145799356,idf540d82b,left_ankle,4.65533304214478,8,7,8289,96
8280,98,0.524566241805967,idf540d82b,right_ankle,4.48691010475159,9,7,8289,96
17234,99,0.348255360830746,idf540d82b,left_wrist,4.5942268371582,-45,-44,17189,100
17190,98,0.347810017882889,idf540d82b,left_hip,4.75236415863037,-1,1,17189,100
17183,96,0.579406131775282,idf540d82b,left_ankle,4.65533304214478,6,10,17189,100
17182,101,0.664603172106639,idf540d82b,right_ankle,4.48691010475159,7,6,17189,100
18233,96,0.325749068688177,idf540d82b,left_wrist,4.5942268371582,2,3,18235,97
18237,98,0.354630626608694,idf540d82b,left_hip,4.75236415863037,-2,-3,18235,97
18229,97,0.676147144156341,idf540d82b,left_ankle,4.65533304214478,6,6,18235,97
18232,95,0.62307124767663,idf540d82b,right_ankle,4.48691010475159,3,5,18235,97
16267,96,0.295536675700474,idf540d82b,left_wrist,4.5942268371582,-43,-40,16224,99
16222,97,0.311644016762845,idf540d82b,left_hip,4.75236415863037,2,4,16224,99
16213,99,0.537716599755356,idf540d82b,left_ankle,4.65533304214478,11,11,16224,99
16211,101,0.595195001746492,idf540d82b,right_ankle,4.48691010475159,13,11,16224,99
11098,95,0.330246797012022,idf540d82b,left_wrist,4.5942268371582,5,7,11103,97
11102,95,0.318509640028414,idf540d82b,left_hip,4.75236415863037,1,3,11103,97
11093,97,0.535697839889161,idf540d82b,left_ankle,4.65533304214478,10,10,11103,97
11095,95,0.605506330182034,idf540d82b,right_ankle,4.48691010475159,8,10,11103,97
11382,101,0.296752161763913,idf540d82b,left_wrist,4.5942268371582,7,3,11389,97
11388,99,0.325217640765107,idf540d82b,left_hip,4.75236415863037,1,-1,11389,97
11382,94,0.631757338432443,idf540d82b,left_ankle,4.65533304214478,7,10,11389,97
11382,94,0.554254765953337,idf540d82b,right_ankle,4.48691010475159,7,10,11389,97
7091,101,0.275866994756526,idf540d82b,left_wrist,4.5942268371582,16,15,7107,100
7099,102,0.256513628602618,idf540d82b,left_hip,4.75236415863037,8,6,7107,100
7096,100,0.52254055647659,idf540d82b,left_ankle,4.65533304214478,11,11,7107,100
7094,102,0.473144273859345,idf540d82b,right_ankle,4.48691010475159,13,11,7107,100
15922,98,0.287453279686266,idf540d82b,left_wrist,4.5942268371582,10,8,15932,96
15927,99,0.270247837974829,idf540d82b,left_hip,4.75236415863037,5,2,15932,96
15921,97,0.550840704417547,idf540d82b,left_ankle,4.65533304214478,11,10,15932,96
15922,97,0.533200909571643,idf540d82b,right_ankle,4.48691010475159,10,9,15932,96
18909,95,0.41034526089564,idf540d82b,left_wrist,4.5942268371582,4,7,18913,98
18913,95,0.355562588030059,idf540d82b,left_hip,4.75236415863037,0,3,18913,98
18902,98,0.597019473234435,idf540d82b,left_ankle,4.65533304214478,11,11,18913,98
18906,94,0.549183867923584,idf540d82b,right_ankle,4.48691010475159,7,11,18913,98
7970,93,0.194133443619639,idb221f542,left_wrist,3.12630796432495,-2,-2,7968,93
7977,95,0.251334122682291,idb221f542,left_hip,3.12558317184448,-9,-11,7968,93
7967,93,0.762646110729513,idb221f542,left_ankle,3.16369485855103,1,1,7968,93
7971,94,0.796732580519846,idb221f542,right_ankle,3.11015510559082,-3,-4,7968,93
9417,97,0.284895766875004,idb221f542,left_wrist,3.12630796432495,-3,-3,9414,97
9422,97,0.323157035930923,idb221f542,left_hip,3.12558317184448,-8,-8,9414,97
9413,100,0.871735545423309,idb221f542,left_ankle,3.16369485855103,1,-2,9414,97
9416,98,0.801037554695828,idb221f542,right_ankle,3.11015510559082,-2,-3,9414,97
12125,99,0.236064608047586,idb221f542,left_wrist,3.12630796432495,-1,-2,12124,98
12131,98,0.289598632036731,idb221f542,left_hip,3.12558317184448,-7,-7,12124,98
12122,99,0.759958556401664,idb221f542,left_ankle,3.16369485855103,2,1,12124,98
12126,99,0.837519056981826,idb221f542,right_ankle,3.11015510559082,-2,-3,12124,98
2710,100,0.227787078020501,idb221f542,left_wrist,3.12630796432495,-4,-3,2706,101
2706,100,0.289375003285542,idb221f542,left_hip,3.12558317184448,0,1,2706,101
2706,100,0.789974215742719,idb221f542,left_ankle,3.16369485855103,0,1,2706,101
2704,99,0.827862668965029,idb221f542,right_ankle,3.11015510559082,2,4,2706,101
6321,99,0.25817165161122,idb221f542,left_wrist,3.12630796432495,-2,-2,6319,99
6326,98,0.310670607266551,idb221f542,left_hip,3.12558317184448,-7,-6,6319,99
6319,98,0.792271404494084,idb221f542,left_ankle,3.16369485855103,0,1,6319,99
6321,98,0.815454779292738,idb221f542,right_ankle,3.11015510559082,-2,-1,6319,99
7488,98,0.277690751069665,idb221f542,left_wrist,3.12630796432495,-1,-1,7487,98
7488,98,0.307117821018829,idb221f542,left_hip,3.12558317184448,-1,-1,7487,98
7486,97,0.800111100697785,idb221f542,left_ankle,3.16369485855103,1,2,7487,98
7486,97,0.843299658206656,idb221f542,right_ankle,3.11015510559082,1,2,7487,98
1628,100,0.193864409016693,idb221f542,left_wrist,3.12630796432495,-2,-3,1626,99
1625,100,0.274559335531284,idb221f542,left_hip,3.12558317184448,1,0,1626,99
1624,99,0.756133566605965,idb221f542,left_ankle,3.16369485855103,2,2,1626,99
1624,99,0.811912070513489,idb221f542,right_ankle,3.11015510559082,2,2,1626,99
17010,100,0.307373104317856,idb221f542,left_wrist,3.12630796432495,-3,-3,17007,100
17013,100,0.33966913949415,idb221f542,left_hip,3.12558317184448,-6,-6,17007,100
17008,101,0.83562974326172,idb221f542,left_ankle,3.16369485855103,-1,-2,17007,100
17009,99,0.801062240407294,idb221f542,right_ankle,3.11015510559082,-2,-1,17007,100
15347,99,0.296004789430652,idb221f542,left_wrist,3.12630796432495,-3,-3,15344,99
15352,97,0.321684242930749,idb221f542,left_hip,3.12558317184448,-8,-6,15344,99
15346,100,0.80551757126994,idb221f542,left_ankle,3.16369485855103,-2,-3,15344,99
15346,100,0.834707338797499,idb221f542,right_ankle,3.11015510559082,-2,-3,15344,99
16029,100,0.293189536544535,idb221f542,left_wrist,3.12630796432495,-2,-3,16027,99
16033,99,0.323069396895127,idb221f542,left_hip,3.12558317184448,-6,-6,16027,99
16028,100,0.767007966358273,idb221f542,left_ankle,3.16369485855103,-1,-2,16027,99
16029,99,0.779366879697796,idb221f542,right_ankle,3.11015510559082,-2,-2,16027,99
17109,98,0.280156045423081,idb221f542,left_wrist,3.12630796432495,-3,-2,17106,99
17112,99,0.341621483304062,idb221f542,left_hip,3.12558317184448,-6,-6,17106,99
17108,98,0.770192369524136,idb221f542,left_ankle,3.16369485855103,-2,-1,17106,99
17107,100,0.808294571963853,idb221f542,right_ankle,3.11015510559082,-1,-2,17106,99
1431,99,0.185459104053059,idb221f542,left_wrist,3.12630796432495,-3,-3,1428,99
1429,97,0.28495810125697,idb221f542,left_hip,3.12558317184448,-1,1,1428,99
1427,99,0.761714702549659,idb221f542,left_ankle,3.16369485855103,1,1,1428,99
1426,102,0.853995064987021,idb221f542,right_ankle,3.11015510559082,2,-1,1428,99
7005,96,0.26149669536871,idb221f542,left_wrist,3.12630796432495,-2,-1,7003,97
7009,98,0.302407377257524,idb221f542,left_hip,3.12558317184448,-6,-7,7003,97
7002,98,0.801078495539519,idb221f542,left_ankle,3.16369485855103,1,0,7003,97
7004,99,0.837362748875486,idb221f542,right_ankle,3.11015510559082,-1,-3,7003,97
9899,99,0.29423282303022,idb221f542,left_wrist,3.12630796432495,-2,-2,9897,99
9905,97,0.301093104774788,idb221f542,left_hip,3.12558317184448,-8,-6,9897,99
9897,98,0.829839995816442,idb221f542,left_ankle,3.16369485855103,0,1,9897,99
9899,99,0.854019923465339,idb221f542,right_ankle,3.11015510559082,-2,-2,9897,99
2021,100,0.177003056260145,idb221f542,left_wrist,3.12630796432495,-3,-3,2018,100
2018,99,0.297132811583838,idb221f542,left_hip,3.12558317184448,0,1,2018,100
2016,101,0.752890076835055,idb221f542,left_ankle,3.16369485855103,2,1,2018,100
2016,100,0.808688298477414,idb221f542,right_ankle,3.11015510559082,2,2,2018,100
14664,99,0.327528450846248,idb221f542,left_wrist,3.12630796432495,-2,-2,14662,99
14667,100,0.319566679126864,idb221f542,left_hip,3.12558317184448,-5,-6,14662,99
14661,102,0.778329756218709,idb221f542,left_ankle,3.16369485855103,1,-2,14662,99
14664,99,0.756229974837374,idb221f542,right_ankle,3.11015510559082,-2,-2,14662,99
13488,99,0.237763313383166,idb221f542,left_wrist,3.12630796432495,-4,-4,13484,99
13490,99,0.3100501571807,idb221f542,left_hip,3.12558317184448,-6,-6,13484,99
13486,99,0.749425245956282,idb221f542,left_ankle,3.16369485855103,-2,-2,13484,99
13487,99,0.796768422623447,idb221f542,right_ankle,3.11015510559082,-3,-3,13484,99
1141,98,0.19845844410031,idb221f542,left_wrist,3.12630796432495,-4,-3,1137,99
1139,96,0.272877323835529,idb221f542,left_hip,3.12558317184448,-2,1,1137,99
1136,98,0.810972183930648,idb221f542,left_ankle,3.16369485855103,1,2,1137,99
1136,98,0.840835599118996,idb221f542,right_ankle,3.11015510559082,1,2,1137,99
8836,99,0.298938685069433,idb221f542,left_wrist,3.12630796432495,-1,-2,8835,98
8844,95,0.308598834649609,idb221f542,left_hip,3.12558317184448,-9,-6,8835,98
8835,97,0.824417194257557,idb221f542,left_ankle,3.16369485855103,0,1,8835,98
8838,98,0.82006543756138,idb221f542,right_ankle,3.11015510559082,-3,-3,8835,98
16814,98,0.282155886992713,idb221f542,left_wrist,3.12630796432495,-4,-2,16810,100
16817,99,0.340873396727041,idb221f542,left_hip,3.12558317184448,-7,-6,16810,100
16812,99,0.798247865500506,idb221f542,left_ankle,3.16369485855103,-2,-1,16810,100
16811,100,0.761990970411906,idb221f542,right_ankle,3.11015510559082,-1,-1,16810,100
